,A,Age,Full Name,G,GP,PTS,Pos,Season
0,1,20,A.J. Greer,0,5,1,LW,2016
1,3,21,A.J. Greer,0,17,3,LW,2017
2,0,20,Aaron Broten,0,2,0,LW,1980
3,24,21,Aaron Broten,15,58,39,LW,1981
4,39,22,Aaron Broten,16,73,55,C,1982
5,23,23,Aaron Broten,13,80,36,C,1983
6,35,24,Aaron Broten,22,80,57,LW,1984
7,25,25,Aaron Broten,18,66,43,LW,1985
8,53,26,Aaron Broten,26,80,79,LW,1986
9,57,27,Aaron Broten,26,80,83,LW,1987
10,43,28,Aaron Broten,16,80,59,C,1988
11,17,29,Aaron Broten,19,77,36,C,1989
12,8,30,Aaron Broten,11,47,19,LW,1990
13,5,31,Aaron Broten,4,25,9,LW,1991
14,0,25,Aaron Downey,0,1,0,RW,1999
15,0,26,Aaron Downey,0,3,0,RW,2000
16,0,27,Aaron Downey,1,36,1,RW,2001
17,1,28,Aaron Downey,1,43,2,RW,2002
18,1,29,Aaron Downey,1,37,2,RW,2003
19,4,31,Aaron Downey,3,42,7,RW,2005
20,0,32,Aaron Downey,1,21,1,RW,2006
21,3,33,Aaron Downey,0,56,3,RW,2007
22,1,34,Aaron Downey,1,4,2,RW,2008
23,27,18,Aaron Ekblad,12,81,39,D,2014
24,21,19,Aaron Ekblad,15,78,36,D,2015
25,11,20,Aaron Ekblad,10,68,21,D,2016
26,22,21,Aaron Ekblad,16,82,38,D,2017
27,0,23,Aaron Gagnon,0,2,0,C,2009
28,2,24,Aaron Gagnon,0,19,2,C,2010
29,0,25,Aaron Gagnon,0,7,0,C,2011
30,0,26,Aaron Gagnon,3,10,3,C,2012
31,4,21,Aaron Gavey,8,73,12,C,1995
32,11,22,Aaron Gavey,8,57,19,C,1996
33,3,23,Aaron Gavey,2,26,5,C,1997
34,0,24,Aaron Gavey,0,7,0,C,1998
35,6,25,Aaron Gavey,7,41,13,C,1999
36,14,26,Aaron Gavey,10,75,24,C,2000
37,11,27,Aaron Gavey,6,71,17,LW,2001
38,1,28,Aaron Gavey,0,5,1,C,2002
39,0,31,Aaron Gavey,0,5,0,C,2005
40,6,20,Aaron Johnson,2,29,8,D,2003
41,6,22,Aaron Johnson,2,26,8,D,2005
42,7,23,Aaron Johnson,3,61,10,D,2006
43,2,24,Aaron Johnson,0,30,2,D,2007
44,5,25,Aaron Johnson,3,38,8,D,2008
45,6,26,Aaron Johnson,4,41,10,D,2009
46,13,28,Aaron Johnson,3,56,16,D,2011
47,0,29,Aaron Johnson,0,10,0,D,2012
48,0,27,Aaron MacKenzie,0,5,0,D,2008
49,0,22,Aaron Miller,0,1,0,D,1993
50,3,23,Aaron Miller,0,9,3,D,1994
51,0,24,Aaron Miller,0,5,0,D,1995
52,12,25,Aaron Miller,5,56,17,D,1996
53,2,26,Aaron Miller,2,55,4,D,1997
54,13,27,Aaron Miller,5,76,18,D,1998
55,7,28,Aaron Miller,1,53,8,D,1999
56,14,29,Aaron Miller,4,69,18,D,2000
57,12,30,Aaron Miller,5,74,17,D,2001
58,5,31,Aaron Miller,1,49,6,D,2002
59,2,32,Aaron Miller,1,35,3,D,2003
60,8,34,Aaron Miller,0,56,8,D,2005
61,8,35,Aaron Miller,0,82,8,D,2006
62,8,36,Aaron Miller,1,57,9,D,2007
63,0,21,Aaron Ness,0,9,0,D,2011
64,2,23,Aaron Ness,1,20,3,D,2013
65,2,25,Aaron Ness,0,8,2,D,2015
66,0,26,Aaron Ness,0,2,0,D,2016
67,1,27,Aaron Ness,0,8,1,D,2017
68,0,21,Aaron Palushaj,0,3,0,RW,2010
69,4,22,Aaron Palushaj,1,38,5,RW,2011
70,7,23,Aaron Palushaj,2,25,9,RW,2012
71,0,24,Aaron Palushaj,0,2,0,RW,2013
72,0,23,Aaron Rome,0,1,0,D,2006
73,1,24,Aaron Rome,1,17,2,D,2007
74,1,25,Aaron Rome,0,8,1,D,2008
75,4,26,Aaron Rome,0,49,4,D,2009
76,4,27,Aaron Rome,1,56,5,D,2010
77,6,28,Aaron Rome,4,43,10,D,2011
78,5,29,Aaron Rome,0,27,5,D,2012
79,1,30,Aaron Rome,0,25,1,D,2013
80,1,25,Aaron Volpatti,1,15,2,RW,2010
81,0,26,Aaron Volpatti,1,23,1,RW,2011
82,1,27,Aaron Volpatti,1,33,2,RW,2012
83,0,28,Aaron Volpatti,2,41,2,LW,2013
84,0,29,Aaron Volpatti,0,2,0,LW,2014
85,7,26,Aaron Voros,7,55,14,LW,2007
86,8,27,Aaron Voros,8,54,16,LW,2008
87,4,28,Aaron Voros,3,41,7,LW,2009
88,0,29,Aaron Voros,0,12,0,LW,2010
89,0,21,Aaron Ward,1,5,1,D,1993
90,1,22,Aaron Ward,0,1,1,D,1994
91,5,24,Aaron Ward,2,49,7,D,1996
92,5,25,Aaron Ward,5,52,10,D,1997
93,8,26,Aaron Ward,3,60,11,D,1998
94,3,27,Aaron Ward,1,36,4,D,1999
95,5,28,Aaron Ward,4,73,9,D,2000
96,11,29,Aaron Ward,3,79,14,D,2001
97,6,30,Aaron Ward,3,77,9,D,2002
98,5,31,Aaron Ward,3,49,8,D,2003
99,19,33,Aaron Ward,6,71,25,D,2005
100,12,34,Aaron Ward,4,80,16,D,2006
101,8,35,Aaron Ward,5,65,13,D,2007
102,7,36,Aaron Ward,3,65,10,D,2008
103,12,37,Aaron Ward,1,77,13,D,2009
104,0,20,Ab DeMarco,0,3,0,D,1969
105,1,21,Ab DeMarco,0,2,1,D,1970
106,7,22,Ab DeMarco,4,48,11,D,1971
107,22,23,Ab DeMarco,8,65,30,D,1972
108,21,24,Ab DeMarco,10,57,31,D,1973
109,15,25,Ab DeMarco,12,69,27,D,1974
110,11,26,Ab DeMarco,7,64,18,D,1975
111,3,27,Ab DeMarco,3,33,6,D,1976
112,8,28,Ab DeMarco,6,47,14,D,1977
113,8,28,Ab DeMarco,6,47,14,D,1977
114,0,29,Ab DeMarco,0,3,0,D,1978
115,21,31,Ab McDonald,22,74,43,LW,1967
116,21,32,Ab McDonald,21,68,42,LW,1968
117,30,33,Ab McDonald,25,64,55,LW,1969
118,5,34,Ab McDonald,0,20,5,LW,1970
119,3,35,Ab McDonald,2,19,5,LW,1971
120,24,36,Ab McDonald,17,77,41,LW,1972
121,24,36,Ab McDonald,17,77,41,LW,1972
122,17,37,Ab McDonald,12,70,29,LW,1973
123,17,37,Ab McDonald,12,70,29,LW,1973
124,4,30,Ace Bailey,5,38,9,LW,1978
125,4,30,Ace Bailey,5,38,9,LW,1978
126,0,22,Adam Almqvist,1,2,1,D,2013
127,0,20,Adam Bennett,0,5,0,D,1991
128,2,21,Adam Bennett,0,16,2,D,1992
129,6,22,Adam Bennett,3,48,9,D,1993
130,0,21,Adam Berti,0,2,0,LW,2007
131,0,24,Adam Burish,0,9,0,RW,2006
132,4,25,Adam Burish,4,81,8,RW,2007
133,3,26,Adam Burish,6,66,9,RW,2008
134,3,27,Adam Burish,1,13,4,C,2009
135,6,28,Adam Burish,8,63,14,C,2010
136,13,29,Adam Burish,6,65,19,C,2011
137,2,30,Adam Burish,1,46,3,C,2012
138,0,31,Adam Burish,0,15,0,RW,2013
139,2,32,Adam Burish,1,20,3,RW,2014
140,0,20,Adam Burt,0,5,0,D,1988
141,8,21,Adam Burt,4,63,12,D,1989
142,7,22,Adam Burt,2,42,9,D,1990
143,15,23,Adam Burt,9,66,24,D,1991
144,14,24,Adam Burt,6,65,20,D,1992
145,17,25,Adam Burt,1,63,18,D,1993
146,11,26,Adam Burt,7,46,18,D,1994
147,9,27,Adam Burt,4,78,13,D,1995
148,11,28,Adam Burt,2,71,13,D,1996
149,11,29,Adam Burt,1,76,12,D,1997
150,4,30,Adam Burt,0,68,4,D,1998
151,6,31,Adam Burt,1,67,7,D,1999
152,2,32,Adam Burt,0,27,2,D,2000
153,3,22,Adam Clendening,1,21,4,D,2014
154,6,23,Adam Clendening,1,29,7,D,2015
155,9,24,Adam Clendening,2,31,11,D,2016
156,2,25,Adam Clendening,0,5,2,D,2017
157,4,25,Adam Cracknell,3,24,7,RW,2010
158,0,26,Adam Cracknell,1,2,1,RW,2011
159,4,27,Adam Cracknell,2,20,6,RW,2012
160,2,28,Adam Cracknell,0,19,2,RW,2013
161,1,29,Adam Cracknell,0,17,1,RW,2014
162,5,30,Adam Cracknell,5,52,10,RW,2015
163,6,31,Adam Cracknell,10,69,16,RW,2016
164,0,32,Adam Cracknell,0,1,0,RW,2017
165,2,18,Adam Creighton,2,7,4,C,1983
166,8,19,Adam Creighton,2,30,10,C,1984
167,1,20,Adam Creighton,1,19,2,C,1985
168,22,21,Adam Creighton,18,56,40,C,1986
169,17,22,Adam Creighton,10,36,27,C,1987
170,24,23,Adam Creighton,22,67,46,LW,1988
171,36,24,Adam Creighton,34,80,70,LW,1989
172,29,25,Adam Creighton,22,72,51,C,1990
173,15,26,Adam Creighton,21,77,36,C,1991
174,20,27,Adam Creighton,19,83,39,C,1992
175,10,28,Adam Creighton,10,53,20,LW,1993
176,20,29,Adam Creighton,14,48,34,C,1994
177,10,30,Adam Creighton,11,61,21,C,1995
178,2,31,Adam Creighton,1,19,3,C,1996
179,8,19,Adam Deadmarsh,9,48,17,RW,1994
180,27,20,Adam Deadmarsh,21,78,48,RW,1995
181,27,21,Adam Deadmarsh,33,78,60,RW,1996
182,21,22,Adam Deadmarsh,22,73,43,RW,1997
183,27,23,Adam Deadmarsh,22,66,49,RW,1998
184,27,24,Adam Deadmarsh,18,71,45,RW,1999
185,15,25,Adam Deadmarsh,17,57,32,RW,2000
186,33,26,Adam Deadmarsh,29,76,62,LW,2001
187,4,27,Adam Deadmarsh,13,20,17,LW,2002
188,0,21,Adam Erne,3,26,3,LW,2016
189,1,22,Adam Erne,3,23,4,LW,2017
190,5,20,Adam Foote,2,46,7,D,1991
191,12,21,Adam Foote,4,81,16,D,1992
192,6,22,Adam Foote,2,45,8,D,1993
193,7,23,Adam Foote,0,35,7,D,1994
194,11,24,Adam Foote,5,73,16,D,1995
195,19,25,Adam Foote,2,78,21,D,1996
196,14,26,Adam Foote,3,77,17,D,1997
197,16,27,Adam Foote,5,64,21,D,1998
198,13,28,Adam Foote,5,59,18,D,1999
199,12,29,Adam Foote,3,35,15,D,2000
200,22,30,Adam Foote,5,55,27,D,2001
201,20,31,Adam Foote,11,78,31,D,2002
202,22,32,Adam Foote,8,73,30,D,2003
203,16,34,Adam Foote,6,65,22,D,2005
204,9,35,Adam Foote,3,59,12,D,2006
205,15,36,Adam Foote,1,75,16,D,2007
206,6,37,Adam Foote,1,42,7,D,2008
207,9,38,Adam Foote,0,67,9,D,2009
208,8,39,Adam Foote,0,47,8,D,2010
209,0,21,Adam Gaudette,0,5,0,C,2017
210,1,19,Adam Graves,0,9,1,C,1987
211,5,20,Adam Graves,7,56,12,C,1988
212,13,21,Adam Graves,9,76,22,LW,1989
213,18,22,Adam Graves,7,76,25,C,1990
214,33,23,Adam Graves,26,80,59,LW,1991
215,29,24,Adam Graves,36,84,65,LW,1992
216,27,25,Adam Graves,52,84,79,LW,1993
217,14,26,Adam Graves,17,47,31,LW,1994
218,36,27,Adam Graves,22,82,58,LW,1995
219,28,28,Adam Graves,33,82,61,LW,1996
220,12,29,Adam Graves,23,72,35,LW,1997
221,15,30,Adam Graves,38,82,53,LW,1998
222,17,31,Adam Graves,23,77,40,LW,1999
223,16,32,Adam Graves,10,82,26,LW,2000
224,14,33,Adam Graves,17,81,31,LW,2001
225,9,34,Adam Graves,9,82,18,LW,2002
226,1,21,Adam Hall,0,1,1,RW,2001
227,12,22,Adam Hall,16,79,28,RW,2002
228,14,23,Adam Hall,13,79,27,RW,2003
229,15,25,Adam Hall,14,75,29,RW,2005
230,11,26,Adam Hall,6,72,17,RW,2006
231,4,27,Adam Hall,2,46,6,RW,2007
232,5,28,Adam Hall,5,74,10,RW,2008
233,11,30,Adam Hall,7,82,18,RW,2010
234,5,31,Adam Hall,2,57,7,RW,2011
235,4,32,Adam Hall,0,37,4,RW,2012
236,5,33,Adam Hall,4,80,9,RW,2013
237,0,20,Adam Henrique,0,1,0,C,2010
238,35,21,Adam Henrique,16,74,51,C,2011
239,5,22,Adam Henrique,11,42,16,C,2012
240,18,23,Adam Henrique,25,77,43,C,2013
241,27,24,Adam Henrique,16,75,43,C,2014
242,20,25,Adam Henrique,30,80,50,C,2015
243,20,26,Adam Henrique,20,82,40,C,2016
244,10,27,Adam Henrique,4,24,14,C,2017
245,16,19,Adam Larsson,2,65,18,D,2011
246,6,20,Adam Larsson,0,37,6,D,2012
247,2,21,Adam Larsson,1,26,3,D,2013
248,21,22,Adam Larsson,3,64,24,D,2014
249,15,23,Adam Larsson,3,82,18,D,2015
250,15,24,Adam Larsson,4,79,19,D,2016
251,9,25,Adam Larsson,4,63,13,D,2017
252,12,21,Adam Lowry,11,80,23,LW,2014
253,10,22,Adam Lowry,7,74,17,C,2015
254,14,23,Adam Lowry,15,82,29,C,2016
255,13,24,Adam Lowry,8,45,21,C,2017
256,0,20,Adam Mair,1,8,1,C,1999
257,2,21,Adam Mair,0,26,2,LW,2000
258,1,22,Adam Mair,1,18,2,C,2001
259,11,23,Adam Mair,6,79,17,C,2002
260,14,24,Adam Mair,6,81,20,RW,2003
261,5,26,Adam Mair,2,40,7,C,2005
262,9,27,Adam Mair,2,82,11,C,2006
263,12,28,Adam Mair,5,72,17,C,2007
264,11,29,Adam Mair,8,75,19,C,2008
265,8,30,Adam Mair,6,69,14,C,2009
266,3,31,Adam Mair,1,65,4,C,2010
267,0,23,Adam McQuaid,1,19,1,D,2009
268,12,24,Adam McQuaid,3,67,15,D,2010
269,8,25,Adam McQuaid,2,72,10,D,2011
270,3,26,Adam McQuaid,1,32,4,D,2012
271,5,27,Adam McQuaid,1,30,6,D,2013
272,6,28,Adam McQuaid,1,63,7,D,2014
273,8,29,Adam McQuaid,1,64,9,D,2015
274,8,30,Adam McQuaid,2,77,10,D,2016
275,3,31,Adam McQuaid,1,38,4,D,2017
276,11,23,Adam Oates,9,38,20,C,1985
277,32,24,Adam Oates,15,76,47,C,1986
278,40,25,Adam Oates,14,63,54,C,1987
279,62,26,Adam Oates,16,69,78,C,1988
280,79,27,Adam Oates,23,80,102,C,1989
281,90,28,Adam Oates,25,61,115,C,1990
282,79,29,Adam Oates,20,80,99,C,1991
283,97,30,Adam Oates,45,84,142,C,1992
284,80,31,Adam Oates,32,77,112,C,1993
285,41,32,Adam Oates,12,48,53,C,1994
286,67,33,Adam Oates,25,70,92,C,1995
287,60,34,Adam Oates,22,80,82,C,1996
288,58,35,Adam Oates,18,82,76,C,1997
289,42,36,Adam Oates,12,59,54,C,1998
290,56,37,Adam Oates,15,82,71,C,1999
291,69,38,Adam Oates,13,81,82,C,2000
292,64,39,Adam Oates,14,80,78,C,2001
293,36,40,Adam Oates,9,67,45,C,2002
294,16,41,Adam Oates,2,60,18,C,2003
295,9,24,Adam Pardy,1,60,10,D,2008
296,7,25,Adam Pardy,2,57,9,D,2009
297,6,26,Adam Pardy,1,30,7,D,2010
298,3,27,Adam Pardy,0,36,3,D,2011
299,4,28,Adam Pardy,0,17,4,D,2012
300,6,29,Adam Pardy,0,60,6,D,2013
301,9,30,Adam Pardy,0,55,9,D,2014
302,4,31,Adam Pardy,0,23,4,D,2015
303,0,32,Adam Pardy,0,4,0,D,2016
304,0,22,Adam Payerl,0,2,0,C,2013
305,2,21,Adam Pelech,0,9,2,D,2015
306,7,22,Adam Pelech,3,44,10,D,2016
307,16,23,Adam Pelech,3,78,19,D,2017
308,0,21,Adam Pineault,0,3,0,RW,2007
309,0,21,Adrian Aucoin,1,1,1,D,1994
310,14,22,Adrian Aucoin,4,49,18,D,1995
311,16,23,Adrian Aucoin,5,70,21,D,1996
312,3,24,Adrian Aucoin,3,35,6,D,1997
313,11,25,Adrian Aucoin,23,82,34,D,1998
314,14,26,Adrian Aucoin,10,57,24,D,1999
315,24,27,Adrian Aucoin,4,73,28,D,2000
316,22,28,Adrian Aucoin,12,81,34,D,2001
317,27,29,Adrian Aucoin,8,73,35,D,2002
318,31,30,Adrian Aucoin,13,81,44,D,2003
319,5,32,Adrian Aucoin,1,33,6,D,2005
320,12,33,Adrian Aucoin,4,59,16,D,2006
321,25,34,Adrian Aucoin,10,76,35,D,2007
322,24,35,Adrian Aucoin,10,81,34,D,2008
323,20,36,Adrian Aucoin,8,82,28,D,2009
324,19,37,Adrian Aucoin,3,75,22,D,2010
325,7,38,Adrian Aucoin,2,64,9,D,2011
326,4,39,Adrian Aucoin,0,36,4,D,2012
327,4,20,Adrian Kempe,2,25,6,LW,2016
328,21,21,Adrian Kempe,16,81,37,LW,2017
329,3,20,Adrien Plavsic,3,15,6,D,1989
330,10,21,Adrien Plavsic,2,48,12,D,1990
331,9,22,Adrien Plavsic,1,16,10,D,1991
332,21,23,Adrien Plavsic,6,57,27,D,1992
333,9,24,Adrien Plavsic,1,47,10,D,1993
334,2,25,Adrien Plavsic,2,18,4,D,1994
335,2,26,Adrien Plavsic,1,7,3,D,1995
336,0,27,Adrien Plavsic,0,6,0,D,1996
337,7,18,Aki Berg,0,51,7,D,1995
338,6,19,Aki Berg,2,41,8,D,1996
339,8,20,Aki Berg,0,72,8,D,1997
340,13,22,Aki Berg,3,70,16,D,1999
341,4,23,Aki Berg,3,59,7,D,2000
342,10,24,Aki Berg,1,81,11,D,2001
343,7,25,Aki Berg,4,78,11,D,2002
344,7,26,Aki Berg,2,79,9,D,2003
345,8,28,Aki Berg,0,75,8,D,2005
346,1,22,Akim Aliu,2,2,3,RW,2011
347,0,23,Akim Aliu,0,5,0,RW,2012
348,10,35,Al Arbour,1,74,11,D,1967
349,6,36,Al Arbour,1,67,7,D,1968
350,3,37,Al Arbour,0,68,3,D,1969
351,2,38,Al Arbour,0,22,2,D,1970
352,8,20,Al Cameron,2,38,10,D,1975
353,13,21,Al Cameron,3,80,16,D,1976
354,7,22,Al Cameron,2,63,9,D,1977
355,3,23,Al Cameron,0,9,3,D,1978
356,11,24,Al Cameron,3,63,14,D,1979
357,2,25,Al Cameron,1,29,3,D,1980
358,9,26,Al Conroy,2,31,11,C,1991
359,2,27,Al Conroy,3,21,5,C,1992
360,3,28,Al Conroy,4,62,7,LW,1993
361,0,21,Al Hamilton,0,2,0,D,1967
362,0,22,Al Hamilton,0,16,0,D,1968
363,5,23,Al Hamilton,0,59,5,D,1969
364,28,24,Al Hamilton,2,69,30,D,1970
365,30,25,Al Hamilton,4,76,34,D,1971
366,50,26,Al Hamilton,11,78,61,D,1972
367,50,26,Al Hamilton,11,78,61,D,1972
368,45,27,Al Hamilton,14,78,59,D,1973
369,45,27,Al Hamilton,14,78,59,D,1973
370,13,28,Al Hamilton,1,25,14,D,1974
371,13,28,Al Hamilton,1,25,14,D,1974
372,32,29,Al Hamilton,2,54,34,D,1975
373,37,30,Al Hamilton,8,81,45,D,1976
374,43,31,Al Hamilton,11,59,54,D,1977
375,43,31,Al Hamilton,11,59,54,D,1977
376,38,32,Al Hamilton,6,80,44,D,1978
377,38,32,Al Hamilton,6,80,44,D,1978
378,15,33,Al Hamilton,4,31,19,D,1979
379,4,21,Al Hangsleben,0,26,4,D,1974
380,4,21,Al Hangsleben,0,26,4,D,1974
381,23,22,Al Hangsleben,2,78,25,D,1975
382,23,22,Al Hangsleben,2,78,25,D,1975
383,9,23,Al Hangsleben,13,74,22,D,1976
384,9,23,Al Hangsleben,13,74,22,D,1976
385,18,24,Al Hangsleben,11,79,29,D,1977
386,18,24,Al Hangsleben,11,79,29,D,1977
387,19,25,Al Hangsleben,10,77,29,D,1978
388,19,25,Al Hangsleben,10,77,29,D,1978
389,22,26,Al Hangsleben,13,74,35,D,1979
390,19,27,Al Hangsleben,5,76,24,D,1980
391,7,28,Al Hangsleben,3,35,10,D,1981
392,4,21,Al Hill,2,9,6,LW,1976
393,0,22,Al Hill,0,3,0,LW,1977
394,11,23,Al Hill,5,31,16,LW,1978
395,10,24,Al Hill,16,61,26,LW,1979
396,15,25,Al Hill,10,57,25,LW,1980
397,13,26,Al Hill,6,41,19,LW,1981
398,2,31,Al Hill,0,7,2,LW,1986
399,0,32,Al Hill,1,12,1,LW,1987
400,16,18,Al Iafrate,5,68,21,D,1984
401,25,19,Al Iafrate,8,65,33,D,1985
402,21,20,Al Iafrate,9,80,30,D,1986
403,30,21,Al Iafrate,22,77,52,D,1987
404,20,22,Al Iafrate,13,65,33,D,1988
405,42,23,Al Iafrate,21,75,63,D,1989
406,23,24,Al Iafrate,9,72,32,D,1990
407,34,25,Al Iafrate,17,78,51,D,1991
408,41,26,Al Iafrate,25,81,66,D,1992
409,43,27,Al Iafrate,15,79,58,D,1993
410,9,30,Al Iafrate,6,38,15,D,1996
411,7,31,Al Iafrate,2,21,9,D,1997
412,10,23,Al Karlander,5,41,15,C,1969
413,4,24,Al Karlander,1,23,5,C,1970
414,20,25,Al Karlander,15,71,35,C,1971
415,22,26,Al Karlander,15,77,37,LW,1972
416,41,27,Al Karlander,20,77,61,C,1973
417,14,28,Al Karlander,7,48,21,LW,1974
418,14,28,Al Karlander,7,48,21,LW,1974
419,28,29,Al Karlander,16,79,44,C,1975
420,28,29,Al Karlander,16,79,44,C,1975
421,28,30,Al Karlander,17,65,45,C,1976
422,28,30,Al Karlander,17,65,45,C,1976
423,0,21,Al MacAdam,0,5,0,RW,1973
424,25,22,Al MacAdam,18,80,43,RW,1974
425,31,23,Al MacAdam,32,80,63,RW,1975
426,41,24,Al MacAdam,22,80,63,RW,1976
427,32,25,Al MacAdam,16,80,48,LW,1977
428,34,26,Al MacAdam,24,69,58,LW,1978
429,51,27,Al MacAdam,42,80,93,LW,1979
430,39,28,Al MacAdam,21,78,60,RW,1980
431,43,29,Al MacAdam,18,79,61,RW,1981
432,22,30,Al MacAdam,11,73,33,RW,1982
433,13,31,Al MacAdam,22,80,35,RW,1983
434,20,32,Al MacAdam,14,80,34,LW,1984
435,0,18,Al MacInnis,0,2,0,D,1981
436,3,19,Al MacInnis,1,14,4,D,1982
437,34,20,Al MacInnis,11,51,45,D,1983
438,52,21,Al MacInnis,14,67,66,D,1984
439,57,22,Al MacInnis,11,77,68,D,1985
440,56,23,Al MacInnis,20,79,76,D,1986
441,58,24,Al MacInnis,25,80,83,D,1987
442,58,25,Al MacInnis,16,79,74,D,1988
443,62,26,Al MacInnis,28,79,90,D,1989
444,75,27,Al MacInnis,28,78,103,D,1990
445,57,28,Al MacInnis,20,72,77,D,1991
446,43,29,Al MacInnis,11,50,54,D,1992
447,54,30,Al MacInnis,28,75,82,D,1993
448,20,31,Al MacInnis,8,32,28,D,1994
449,44,32,Al MacInnis,17,82,61,D,1995
450,30,33,Al MacInnis,13,72,43,D,1996
451,30,34,Al MacInnis,19,71,49,D,1997
452,42,35,Al MacInnis,20,82,62,D,1998
453,28,36,Al MacInnis,11,61,39,D,1999
454,42,37,Al MacInnis,12,59,54,D,2000
455,35,38,Al MacInnis,11,71,46,D,2001
456,52,39,Al MacInnis,16,80,68,D,2002
457,2,40,Al MacInnis,0,3,2,D,2003
458,0,21,Al MacKenzie,0,2,0,D,1973
459,10,32,Al MacNeil,2,74,12,D,1967
460,1,20,Al McDonough,2,6,3,RW,1970
461,13,21,Al McDonough,10,68,23,RW,1971
462,41,22,Al McDonough,35,78,76,RW,1972
463,31,23,Al McDonough,24,72,55,RW,1973
464,30,24,Al McDonough,34,78,64,RW,1974
465,30,24,Al McDonough,34,78,64,RW,1974
466,22,25,Al McDonough,23,80,45,RW,1975
467,22,25,Al McDonough,23,80,45,RW,1975
468,21,26,Al McDonough,9,42,30,RW,1976
469,21,26,Al McDonough,9,42,30,RW,1976
470,2,27,Al McDonough,2,13,4,RW,1977
471,2,24,Al McLeod,2,26,4,D,1973
472,16,25,Al McLeod,3,77,19,D,1974
473,16,25,Al McLeod,3,77,19,D,1974
474,18,26,Al McLeod,2,80,20,D,1975
475,18,26,Al McLeod,2,80,20,D,1975
476,26,27,Al McLeod,8,80,34,D,1976
477,26,27,Al McLeod,8,80,34,D,1976
478,22,28,Al McLeod,2,80,24,D,1977
479,22,28,Al McLeod,2,80,24,D,1977
480,11,29,Al McLeod,0,25,11,D,1978
481,11,29,Al McLeod,0,25,11,D,1978
482,2,23,Al Rycroft,0,7,2,RW,1972
483,2,23,Al Rycroft,0,7,2,RW,1972
484,7,20,Al Secord,16,71,23,LW,1978
485,16,21,Al Secord,23,77,39,LW,1979
486,12,22,Al Secord,13,59,25,LW,1980
487,31,23,Al Secord,44,80,75,LW,1981
488,32,24,Al Secord,54,80,86,LW,1982
489,4,25,Al Secord,4,14,8,LW,1983
490,11,26,Al Secord,15,51,26,LW,1984
491,36,27,Al Secord,40,80,76,LW,1985
492,29,28,Al Secord,29,77,58,LW,1986
493,27,29,Al Secord,15,74,42,LW,1987
494,10,30,Al Secord,6,60,16,RW,1988
495,7,31,Al Secord,14,43,21,LW,1989
496,0,20,Al Simmons,0,1,0,D,1971
497,0,22,Al Simmons,0,3,0,D,1973
498,1,24,Al Simmons,0,7,1,D,1975
499,9,20,Al Sims,3,76,12,D,1973
500,8,21,Al Sims,4,75,12,D,1974
501,3,22,Al Sims,4,48,7,D,1975
502,0,23,Al Sims,0,1,0,D,1976
503,8,24,Al Sims,2,43,10,D,1977
504,20,25,Al Sims,9,67,29,D,1978
505,31,26,Al Sims,10,76,41,D,1979
506,36,27,Al Sims,16,80,52,D,1980
507,1,28,Al Sims,1,8,2,D,1981
508,0,29,Al Sims,0,1,0,D,1982
509,36,27,Alain Beaule,4,78,40,D,1973
510,36,27,Alain Beaule,4,78,40,D,1973
511,21,28,Alain Beaule,4,76,25,D,1974
512,21,28,Alain Beaule,4,76,25,D,1974
513,1,22,Alain Belanger,0,9,1,RW,1977
514,13,29,Alain Caron,9,58,22,RW,1967
515,0,30,Alain Caron,0,2,0,RW,1968
516,27,34,Alain Caron,36,68,63,RW,1972
517,27,34,Alain Caron,36,68,63,RW,1972
518,15,35,Alain Caron,31,59,46,RW,1973
519,15,35,Alain Caron,31,59,46,RW,1973
520,8,36,Alain Caron,15,68,23,RW,1974
521,8,36,Alain Caron,15,68,23,RW,1974
522,5,20,Alain Cote,3,27,8,LW,1977
523,5,20,Alain Cote,3,27,8,LW,1977
524,13,21,Alain Cote,14,79,27,LW,1978
525,13,21,Alain Cote,14,79,27,LW,1978
526,11,22,Alain Cote,5,41,16,LW,1979
527,18,23,Alain Cote,8,51,26,LW,1980
528,16,24,Alain Cote,15,79,31,LW,1981
529,28,25,Alain Cote,12,79,40,LW,1982
530,24,26,Alain Cote,19,77,43,LW,1983
531,22,27,Alain Cote,13,80,35,LW,1984
532,21,28,Alain Cote,13,78,34,LW,1985
533,24,29,Alain Cote,12,80,36,RW,1986
534,18,30,Alain Cote,4,76,22,RW,1987
535,8,31,Alain Cote,2,55,10,LW,1988
536,4,20,Alain Daigle,5,52,9,RW,1974
537,9,21,Alain Daigle,15,71,24,RW,1975
538,8,22,Alain Daigle,12,73,20,RW,1976
539,6,23,Alain Daigle,6,53,12,RW,1977
540,14,24,Alain Daigle,11,74,25,RW,1978
541,9,25,Alain Daigle,7,66,16,RW,1979
542,3,23,Alain Langlais,3,14,6,LW,1973
543,1,24,Alain Langlais,1,11,2,LW,1974
544,1,20,Alain Lemieux,0,3,1,C,1981
545,25,21,Alain Lemieux,9,42,34,C,1982
546,5,22,Alain Lemieux,4,17,9,C,1983
547,13,23,Alain Lemieux,15,49,28,C,1984
548,0,24,Alain Lemieux,0,7,0,C,1985
549,0,25,Alain Lemieux,0,1,0,C,1986
550,0,23,Alain Nasreddine,0,15,0,D,1998
551,0,27,Alain Nasreddine,0,3,0,D,2002
552,0,30,Alain Nasreddine,0,6,0,D,2005
553,4,31,Alain Nasreddine,1,44,5,D,2006
554,0,32,Alain Nasreddine,0,6,0,D,2007
555,6,18,Alain R Cote,0,32,6,D,1985
556,0,19,Alain R Cote,0,3,0,D,1986
557,0,20,Alain R Cote,0,2,0,D,1987
558,3,21,Alain R Cote,2,31,5,D,1988
559,0,22,Alain R Cote,0,2,0,D,1989
560,6,23,Alain R Cote,0,28,6,D,1990
561,3,24,Alain R Cote,0,13,3,D,1991
562,0,25,Alain R Cote,0,2,0,D,1992
563,0,26,Alain R Cote,0,6,0,D,1993
564,2,20,Alain Vigneault,1,14,3,D,1981
565,3,21,Alain Vigneault,1,28,4,D,1982
566,0,21,Alan Globensky,0,3,0,D,1972
567,0,21,Alan Globensky,0,3,0,D,1972
568,0,23,Alan Globensky,0,5,0,D,1974
569,0,23,Alan Globensky,0,5,0,D,1974
570,2,24,Alan Globensky,1,34,3,D,1975
571,2,24,Alan Globensky,1,34,3,D,1975
572,20,20,Alan Haworth,16,49,36,C,1980
573,18,21,Alan Haworth,21,57,39,RW,1981
574,27,22,Alan Haworth,23,74,50,RW,1982
575,31,23,Alan Haworth,24,75,55,C,1983
576,26,24,Alan Haworth,23,76,49,LW,1984
577,39,25,Alan Haworth,34,71,73,C,1985
578,16,26,Alan Haworth,25,50,41,C,1986
579,34,27,Alan Haworth,23,72,57,C,1987
580,0,20,Alan Hepple,0,1,0,D,1983
581,0,21,Alan Hepple,0,1,0,D,1984
582,0,22,Alan Hepple,0,1,0,D,1985
583,1,20,Alan Kerr,3,19,4,RW,1984
584,1,21,Alan Kerr,0,7,1,LW,1985
585,10,22,Alan Kerr,7,72,17,LW,1986
586,34,23,Alan Kerr,24,80,58,RW,1987
587,18,24,Alan Kerr,20,71,38,RW,1988
588,21,25,Alan Kerr,15,75,36,RW,1989
589,0,26,Alan Kerr,0,2,0,RW,1990
590,8,27,Alan Kerr,3,58,11,RW,1991
591,1,28,Alan Kerr,0,7,1,RW,1992
592,0,24,Alan Letang,0,8,0,D,1999
593,0,26,Alan Letang,0,2,0,D,2001
594,0,27,Alan Letang,0,4,0,D,2002
595,0,23,Alan May,0,3,0,RW,1987
596,0,24,Alan May,1,3,1,RW,1988
597,10,25,Alan May,7,77,17,LW,1989
598,6,26,Alan May,4,67,10,RW,1990
599,9,27,Alan May,6,75,15,C,1991
600,10,28,Alan May,6,83,16,LW,1992
601,7,29,Alan May,5,51,12,LW,1993
602,3,30,Alan May,2,34,5,LW,1994
603,0,22,Alan Quine,1,2,1,C,2015
604,13,23,Alan Quine,5,61,18,C,2016
605,3,24,Alan Quine,0,21,3,C,2017
606,0,22,Alec Martinez,0,4,0,D,2009
607,11,23,Alec Martinez,5,60,16,D,2010
608,6,24,Alec Martinez,6,51,12,D,2011
609,4,25,Alec Martinez,1,27,5,D,2012
610,11,26,Alec Martinez,11,61,22,D,2013
611,16,27,Alec Martinez,6,56,22,D,2014
612,21,28,Alec Martinez,10,78,31,D,2015
613,30,29,Alec Martinez,9,82,39,D,2016
614,16,30,Alec Martinez,9,77,25,D,2017
615,0,21,Alek Stojanov,0,4,0,RW,1994
616,1,22,Alek Stojanov,1,68,2,RW,1995
617,4,23,Alek Stojanov,1,35,5,RW,1996
618,16,18,Aleksander Barkov,8,54,24,C,2013
619,20,19,Aleksander Barkov,16,71,36,C,2014
620,31,20,Aleksander Barkov,28,66,59,C,2015
621,31,21,Aleksander Barkov,21,61,52,C,2016
622,51,22,Aleksander Barkov,27,79,78,C,2017
623,13,20,Aleksey Morozov,13,76,26,RW,1997
624,10,21,Aleksey Morozov,9,67,19,RW,1998
625,19,22,Aleksey Morozov,12,68,31,RW,1999
626,14,23,Aleksey Morozov,5,66,19,RW,2000
627,29,24,Aleksey Morozov,20,72,49,LW,2001
628,16,25,Aleksey Morozov,9,27,25,LW,2002
629,34,26,Aleksey Morozov,16,75,50,RW,2003
630,24,19,Ales Hemsky,6,59,30,RW,2002
631,22,20,Ales Hemsky,12,71,34,RW,2003
632,58,22,Ales Hemsky,19,81,77,RW,2005
633,40,23,Ales Hemsky,13,64,53,RW,2006
634,51,24,Ales Hemsky,20,74,71,RW,2007
635,43,25,Ales Hemsky,23,72,66,RW,2008
636,15,26,Ales Hemsky,7,22,22,RW,2009
637,28,27,Ales Hemsky,14,47,42,RW,2010
638,26,28,Ales Hemsky,10,69,36,RW,2011
639,11,29,Ales Hemsky,9,38,20,RW,2012
640,30,30,Ales Hemsky,13,75,43,RW,2013
641,21,31,Ales Hemsky,11,76,32,RW,2014
642,26,32,Ales Hemsky,13,75,39,RW,2015
643,3,33,Ales Hemsky,4,15,7,RW,2016
644,0,34,Ales Hemsky,0,7,0,RW,2017
645,3,23,Ales Kotalik,1,13,4,RW,2001
646,14,24,Ales Kotalik,21,68,35,RW,2002
647,11,25,Ales Kotalik,15,62,26,LW,2003
648,37,27,Ales Kotalik,25,82,62,RW,2005
649,22,28,Ales Kotalik,16,66,38,RW,2006
650,20,29,Ales Kotalik,23,79,43,RW,2007
651,23,30,Ales Kotalik,20,75,43,RW,2008
652,16,31,Ales Kotalik,11,71,27,RW,2009
653,2,32,Ales Kotalik,4,26,6,RW,2010
654,0,25,Ales Pisa,0,2,0,D,2001
655,3,26,Ales Pisa,1,51,4,D,2002
656,0,26,Alex Biega,1,7,1,D,2014
657,7,27,Alex Biega,0,51,7,D,2015
658,3,28,Alex Biega,0,36,3,D,2016
659,8,29,Alex Biega,1,44,9,D,2017
660,0,24,Alex Broadhurst,0,2,0,C,2017
661,1,30,Alex Brooks,0,19,1,D,2006
662,1,22,Alex Chiasson,6,7,7,RW,2012
663,22,23,Alex Chiasson,13,79,35,RW,2013
664,15,24,Alex Chiasson,11,76,26,RW,2014
665,6,25,Alex Chiasson,8,77,14,RW,2015
666,12,26,Alex Chiasson,12,81,24,RW,2016
667,9,27,Alex Chiasson,9,61,18,RW,2017
668,24,20,Alex DeBrincat,28,82,52,RW,2017
669,48,35,Alex Delvecchio,22,74,70,C,1967
670,58,36,Alex Delvecchio,25,72,83,C,1968
671,47,37,Alex Delvecchio,21,73,68,C,1969
672,34,38,Alex Delvecchio,21,77,55,C,1970
673,45,39,Alex Delvecchio,20,75,65,C,1971
674,53,40,Alex Delvecchio,18,77,71,C,1972
675,4,41,Alex Delvecchio,1,11,5,C,1973
676,0,18,Alex Formenton,0,1,0,LW,2017
677,0,22,Alex Forsyth,0,1,0,C,1976
678,0,23,Alex Foster,0,3,0,C,2007
679,0,25,Alex Friesen,0,1,0,C,2015
680,17,20,Alex Frolov,14,79,31,LW,2002
681,24,21,Alex Frolov,24,77,48,LW,2003
682,33,23,Alex Frolov,21,69,54,LW,2005
683,36,24,Alex Frolov,35,82,71,LW,2006
684,44,25,Alex Frolov,23,71,67,LW,2007
685,27,26,Alex Frolov,32,77,59,LW,2008
686,32,27,Alex Frolov,19,81,51,LW,2009
687,9,28,Alex Frolov,7,43,16,LW,2010
688,18,18,Alex Galchenyuk,9,48,27,C,2012
689,18,19,Alex Galchenyuk,13,65,31,C,2013
690,26,20,Alex Galchenyuk,20,80,46,C,2014
691,26,21,Alex Galchenyuk,30,82,56,C,2015
692,27,22,Alex Galchenyuk,17,61,44,C,2016
693,32,23,Alex Galchenyuk,19,82,51,LW,2017
694,2,22,Alex Goligoski,0,3,2,D,2007
695,14,23,Alex Goligoski,6,45,20,D,2008
696,29,24,Alex Goligoski,8,69,37,D,2009
697,32,25,Alex Goligoski,14,83,46,D,2010
698,21,26,Alex Goligoski,9,71,30,D,2011
699,24,27,Alex Goligoski,3,47,27,D,2012
700,36,28,Alex Goligoski,6,81,42,D,2013
701,32,29,Alex Goligoski,4,81,36,D,2014
702,32,30,Alex Goligoski,5,82,37,D,2015
703,30,31,Alex Goligoski,6,82,36,D,2016
704,23,32,Alex Goligoski,12,78,35,D,2017
705,0,25,Alex Grant,2,2,2,D,2013
706,0,27,Alex Grant,0,5,0,D,2015
707,0,23,Alex Henry,0,41,0,D,2002
708,4,24,Alex Henry,2,71,6,LW,2003
709,5,26,Alex Henry,0,63,5,D,2005
710,0,29,Alex Henry,0,2,0,D,2008
711,11,26,Alex Hicks,10,64,21,C,1995
712,21,27,Alex Hicks,7,73,28,C,1996
713,13,28,Alex Hicks,7,58,20,LW,1997
714,7,29,Alex Hicks,0,55,7,LW,1998
715,2,30,Alex Hicks,1,8,3,LW,1999
716,16,24,Alex Iafallo,9,75,25,C,2017
717,0,21,Alex Khokhlachev,0,3,0,LW,2014
718,12,23,Alex Killorn,7,38,19,C,2012
719,24,24,Alex Killorn,17,82,41,C,2013
720,23,25,Alex Killorn,15,71,38,C,2014
721,26,26,Alex Killorn,14,81,40,C,2015
722,17,27,Alex Killorn,19,81,36,LW,2016
723,32,28,Alex Killorn,15,82,47,LW,2017
724,18,19,Alex Kovalev,20,65,38,RW,1992
725,33,20,Alex Kovalev,23,76,56,C,1993
726,15,21,Alex Kovalev,13,48,28,C,1994
727,34,22,Alex Kovalev,24,81,58,RW,1995
728,22,23,Alex Kovalev,13,45,35,RW,1996
729,30,24,Alex Kovalev,23,73,53,LW,1997
730,30,25,Alex Kovalev,23,77,53,RW,1998
731,40,26,Alex Kovalev,26,82,66,RW,1999
732,51,27,Alex Kovalev,44,79,95,RW,2000
733,44,28,Alex Kovalev,32,67,76,RW,2001
734,40,29,Alex Kovalev,37,78,77,RW,2002
735,31,30,Alex Kovalev,14,78,45,RW,2003
736,42,32,Alex Kovalev,23,69,65,RW,2005
737,29,33,Alex Kovalev,18,73,47,RW,2006
738,49,34,Alex Kovalev,35,82,84,RW,2007
739,39,35,Alex Kovalev,26,78,65,RW,2008
740,31,36,Alex Kovalev,18,77,49,RW,2009
741,18,37,Alex Kovalev,16,74,34,RW,2010
742,3,39,Alex Kovalev,2,14,5,RW,2012
743,0,21,Alex McKendry,0,4,0,LW,1977
744,0,22,Alex McKendry,0,4,0,LW,1978
745,0,23,Alex McKendry,0,2,0,LW,1979
746,6,24,Alex McKendry,3,36,9,LW,1980
747,54,20,Alex Ovechkin,52,81,106,LW,2005
748,46,21,Alex Ovechkin,46,82,92,LW,2006
749,47,22,Alex Ovechkin,65,82,112,LW,2007
750,54,23,Alex Ovechkin,56,79,110,LW,2008
751,59,24,Alex Ovechkin,50,72,109,LW,2009
752,53,25,Alex Ovechkin,32,79,85,LW,2010
753,27,26,Alex Ovechkin,38,78,65,LW,2011
754,24,27,Alex Ovechkin,32,48,56,RW,2012
755,28,28,Alex Ovechkin,51,78,79,LW,2013
756,28,29,Alex Ovechkin,53,81,81,LW,2014
757,21,30,Alex Ovechkin,50,79,71,LW,2015
758,36,31,Alex Ovechkin,33,82,69,LW,2016
759,38,32,Alex Ovechkin,49,82,87,LW,2017
760,0,20,Alex Petrovic,0,6,0,D,2012
761,1,21,Alex Petrovic,0,7,1,D,2013
762,3,22,Alex Petrovic,0,33,3,D,2014
763,15,23,Alex Petrovic,2,66,17,D,2015
764,1,19,Alex Pietrangelo,0,8,1,D,2008
765,1,20,Alex Pietrangelo,1,9,2,D,2009
766,32,21,Alex Pietrangelo,11,79,43,D,2010
767,39,22,Alex Pietrangelo,12,81,51,D,2011
768,19,23,Alex Pietrangelo,5,47,24,D,2012
769,43,24,Alex Pietrangelo,8,81,51,D,2013
770,39,25,Alex Pietrangelo,7,81,46,D,2014
771,30,26,Alex Pietrangelo,7,73,37,D,2015
772,34,27,Alex Pietrangelo,14,80,48,D,2016
773,39,28,Alex Pietrangelo,15,78,54,D,2017
774,17,22,Alex Pirus,20,79,37,RW,1976
775,6,23,Alex Pirus,9,61,15,RW,1977
776,3,24,Alex Pirus,1,15,4,RW,1978
777,2,25,Alex Pirus,0,4,2,RW,1979
778,1,20,Alex Plante,0,4,1,D,2009
779,0,21,Alex Plante,0,3,0,D,2010
780,1,22,Alex Plante,0,3,1,D,2011
781,6,23,Alex Selivanov,10,43,16,RW,1994
782,21,24,Alex Selivanov,31,79,52,RW,1995
783,18,25,Alex Selivanov,15,69,33,RW,1996
784,19,26,Alex Selivanov,16,70,35,LW,1997
785,19,27,Alex Selivanov,14,72,33,RW,1998
786,20,28,Alex Selivanov,27,67,47,RW,1999
787,11,29,Alex Selivanov,8,59,19,RW,2000
788,27,21,Alex Steen,18,75,45,C,2005
789,20,22,Alex Steen,15,82,35,C,2006
790,27,23,Alex Steen,15,76,42,LW,2007
791,20,24,Alex Steen,8,81,28,C,2008
792,23,25,Alex Steen,24,68,47,C,2009
793,31,26,Alex Steen,20,72,51,C,2010
794,13,27,Alex Steen,15,43,28,C,2011
795,19,28,Alex Steen,8,40,27,C,2012
796,29,29,Alex Steen,33,68,62,LW,2013
797,35,31,Alex Steen,17,67,52,LW,2015
798,35,32,Alex Steen,16,76,51,LW,2016
799,31,33,Alex Steen,15,76,46,LW,2017
800,34,20,Alex Tanguay,17,76,51,C,1999
801,50,21,Alex Tanguay,27,82,77,LW,2000
802,35,22,Alex Tanguay,13,70,48,LW,2001
803,41,23,Alex Tanguay,26,82,67,LW,2002
804,54,24,Alex Tanguay,25,69,79,LW,2003
805,49,26,Alex Tanguay,29,71,78,LW,2005
806,59,27,Alex Tanguay,22,81,81,LW,2006
807,40,28,Alex Tanguay,18,78,58,LW,2007
808,25,29,Alex Tanguay,16,50,41,LW,2008
809,27,30,Alex Tanguay,10,80,37,LW,2009
810,47,31,Alex Tanguay,22,79,69,LW,2010
811,36,32,Alex Tanguay,13,64,49,LW,2011
812,16,33,Alex Tanguay,11,40,27,LW,2012
813,7,34,Alex Tanguay,4,16,11,LW,2013
814,33,35,Alex Tanguay,22,80,55,LW,2014
815,27,36,Alex Tanguay,8,70,35,LW,2015
816,11,21,Alex Tidey,16,74,27,RW,1975
817,11,21,Alex Tidey,16,74,27,RW,1975
818,0,22,Alex Tidey,0,3,0,RW,1976
819,0,23,Alex Tidey,0,1,0,RW,1977
820,0,25,Alex Tidey,0,5,0,RW,1979
821,0,20,Alex Tuch,0,6,0,RW,2016
822,22,21,Alex Tuch,15,78,37,RW,2017
823,47,22,Alex Zhamnov,25,68,72,C,1992
824,45,23,Alex Zhamnov,26,61,71,C,1993
825,35,24,Alex Zhamnov,30,48,65,C,1994
826,37,25,Alex Zhamnov,22,58,59,C,1995
827,42,26,Alex Zhamnov,20,74,62,C,1996
828,28,27,Alex Zhamnov,21,70,49,C,1997
829,41,28,Alex Zhamnov,20,76,61,C,1998
830,37,29,Alex Zhamnov,23,71,60,C,1999
831,36,30,Alex Zhamnov,13,63,49,C,2000
832,45,31,Alex Zhamnov,22,77,67,C,2001
833,43,32,Alex Zhamnov,15,74,58,C,2002
834,25,33,Alex Zhamnov,11,43,36,C,2003
835,9,35,Alex Zhamnov,1,24,10,C,2005
836,4,28,Alexander Andrevi,2,6,6,RW,1978
837,4,28,Alexander Andrevi,2,6,6,RW,1978
838,0,24,Alexander Andrievski,0,1,0,RW,1992
839,14,19,Alexander Burmistrov,6,74,20,C,2010
840,15,20,Alexander Burmistrov,13,76,28,C,2011
841,6,21,Alexander Burmistrov,4,44,10,C,2012
842,14,24,Alexander Burmistrov,7,81,21,C,2015
843,2,25,Alexander Burmistrov,0,23,2,C,2016
844,4,26,Alexander Burmistrov,2,24,6,C,2017
845,2,20,Alexander Edler,1,22,3,D,2006
846,12,21,Alexander Edler,8,75,20,D,2007
847,27,22,Alexander Edler,10,80,37,D,2008
848,37,23,Alexander Edler,5,76,42,D,2009
849,25,24,Alexander Edler,8,51,33,D,2010
850,38,25,Alexander Edler,11,82,49,D,2011
851,14,26,Alexander Edler,8,45,22,D,2012
852,15,27,Alexander Edler,7,63,22,D,2013
853,23,28,Alexander Edler,8,74,31,D,2014
854,14,29,Alexander Edler,6,52,20,D,2015
855,15,30,Alexander Edler,6,68,21,D,2016
856,28,31,Alexander Edler,6,70,34,D,2017
857,3,21,Alexander Godynyuk,0,18,3,D,1990
858,7,22,Alexander Godynyuk,3,37,10,D,1991
859,4,23,Alexander Godynyuk,3,27,7,D,1992
860,19,24,Alexander Godynyuk,3,69,22,D,1993
861,0,25,Alexander Godynyuk,0,14,0,D,1994
862,0,26,Alexander Godynyuk,0,3,0,D,1995
863,6,27,Alexander Godynyuk,1,55,7,D,1996
864,0,21,Alexander Kabanov,3,6,3,RW,1978
865,0,21,Alexander Kabanov,3,6,3,RW,1978
866,15,23,Alexander Karpovtsev,3,67,18,D,1993
867,8,24,Alexander Karpovtsev,4,47,12,D,1994
868,16,25,Alexander Karpovtsev,2,40,18,D,1995
869,29,26,Alexander Karpovtsev,9,77,38,D,1996
870,7,27,Alexander Karpovtsev,3,47,10,D,1997
871,25,28,Alexander Karpovtsev,3,58,28,D,1998
872,14,29,Alexander Karpovtsev,3,69,17,D,1999
873,13,30,Alexander Karpovtsev,2,53,15,D,2000
874,9,31,Alexander Karpovtsev,1,65,10,D,2001
875,10,32,Alexander Karpovtsev,4,40,14,D,2002
876,8,33,Alexander Karpovtsev,0,27,8,D,2003
877,0,35,Alexander Karpovtsev,0,6,0,D,2005
878,0,26,Alexander Kerch,0,5,0,LW,1993
879,24,23,Alexander Kerfoot,19,79,43,C,2017
880,15,24,Alexander Kharitonov,7,66,22,RW,2000
881,0,25,Alexander Kharitonov,0,5,0,LW,2001
882,16,29,Alexander Khavanov,7,74,23,D,2000
883,21,30,Alexander Khavanov,3,81,24,D,2001
884,25,31,Alexander Khavanov,8,81,33,D,2002
885,7,32,Alexander Khavanov,3,48,10,D,2003
886,6,34,Alexander Khavanov,6,64,12,D,2005
887,0,20,Alexander Khokhlachev,0,1,0,C,2013
888,0,22,Alexander Khokhlachev,0,5,0,C,2015
889,3,22,Alexander Korolyuk,2,19,5,C,1997
890,18,23,Alexander Korolyuk,12,55,30,RW,1998
891,21,24,Alexander Korolyuk,14,57,35,LW,1999
892,13,25,Alexander Korolyuk,12,70,25,RW,2000
893,7,26,Alexander Korolyuk,3,32,10,LW,2001
894,18,28,Alexander Korolyuk,19,63,37,LW,2003
895,6,26,Alexander Lobanov,2,6,8,RW,1978
896,6,26,Alexander Lobanov,2,6,8,RW,1978
897,28,20,Alexander Mogilny,15,65,43,LW,1989
898,34,21,Alexander Mogilny,30,62,64,RW,1990
899,45,22,Alexander Mogilny,39,67,84,RW,1991
900,51,23,Alexander Mogilny,76,77,127,RW,1992
901,47,24,Alexander Mogilny,32,66,79,RW,1993
902,28,25,Alexander Mogilny,19,44,47,RW,1994
903,52,26,Alexander Mogilny,55,79,107,RW,1995
904,42,27,Alexander Mogilny,31,76,73,LW,1996
905,27,28,Alexander Mogilny,18,51,45,RW,1997
906,31,29,Alexander Mogilny,14,59,45,RW,1998
907,20,30,Alexander Mogilny,24,59,44,RW,1999
908,40,31,Alexander Mogilny,43,75,83,RW,2000
909,33,32,Alexander Mogilny,24,66,57,RW,2001
910,46,33,Alexander Mogilny,33,73,79,RW,2002
911,22,34,Alexander Mogilny,8,37,30,RW,2003
912,13,36,Alexander Mogilny,12,34,25,RW,2005
913,0,22,Alexander Nikulin,0,2,0,C,2007
914,0,23,Alexander Nikulin,0,1,0,C,2008
915,1,18,Alexander Nylander,0,4,1,RW,2016
916,0,19,Alexander Nylander,1,3,1,RW,2017
917,10,22,Alexander Perezhogin,9,67,19,RW,2005
918,9,23,Alexander Perezhogin,6,61,15,RW,2006
919,13,24,Alexander Petrovic,1,49,14,D,2016
920,11,25,Alexander Petrovic,2,67,13,D,2017
921,19,20,Alexander Radulov,18,64,37,RW,2006
922,32,21,Alexander Radulov,26,81,58,RW,2007
923,4,25,Alexander Radulov,3,9,7,RW,2011
924,36,30,Alexander Radulov,18,76,54,RW,2016
925,45,31,Alexander Radulov,27,82,72,RW,2017
926,6,25,Alexander Semak,5,25,11,C,1991
927,42,26,Alexander Semak,37,82,79,C,1992
928,17,27,Alexander Semak,12,54,29,C,1993
929,11,28,Alexander Semak,7,41,18,C,1994
930,14,29,Alexander Semak,20,69,34,C,1995
931,1,30,Alexander Semak,2,18,3,C,1996
932,12,19,Alexander Semin,10,52,22,LW,2003
933,35,22,Alexander Semin,38,77,73,LW,2006
934,16,23,Alexander Semin,26,63,42,LW,2007
935,45,24,Alexander Semin,34,62,79,RW,2008
936,44,25,Alexander Semin,40,73,84,LW,2009
937,26,26,Alexander Semin,28,65,54,LW,2010
938,33,27,Alexander Semin,21,77,54,LW,2011
939,31,28,Alexander Semin,13,44,44,LW,2012
940,20,29,Alexander Semin,22,65,42,RW,2013
941,13,30,Alexander Semin,6,57,19,RW,2014
942,3,31,Alexander Semin,1,15,4,LW,2015
943,3,24,Alexander Skvortsov,4,6,7,RW,1978
944,3,24,Alexander Skvortsov,4,6,7,RW,1978
945,40,30,Alexander Steen,24,74,64,LW,2014
946,0,22,Alexander Suglobov,0,1,0,RW,2003
947,0,24,Alexander Suglobov,1,3,1,RW,2005
948,0,25,Alexander Suglobov,0,14,0,RW,2006
949,0,24,Alexander Sulzer,0,2,0,D,2008
950,2,25,Alexander Sulzer,0,20,2,D,2009
951,4,26,Alexander Sulzer,1,40,5,D,2010
952,6,27,Alexander Sulzer,3,27,9,D,2011
953,1,28,Alexander Sulzer,3,17,4,D,2012
954,2,29,Alexander Sulzer,0,25,2,D,2013
955,4,20,Alexander Svitov,4,63,8,C,2002
956,9,21,Alexander Svitov,2,40,11,C,2003
957,11,24,Alexander Svitov,7,76,18,C,2006
958,0,20,Alexander Urbom,1,8,1,D,2010
959,0,21,Alexander Urbom,1,5,1,D,2011
960,0,22,Alexander Urbom,0,1,0,D,2012
961,1,23,Alexander Urbom,1,20,2,D,2013
962,0,21,Alexander Vasilevski,0,1,0,RW,1995
963,0,22,Alexander Vasilevski,0,3,0,RW,1996
964,4,22,Alexander Vasyunov,1,18,5,LW,2010
965,16,20,Alexander Wennberg,4,68,20,C,2014
966,32,21,Alexander Wennberg,8,69,40,C,2015
967,46,22,Alexander Wennberg,13,80,59,C,2016
968,27,23,Alexander Wennberg,8,66,35,C,2017
969,0,24,Alexandre Boikov,0,2,0,D,1999
970,0,25,Alexandre Boikov,0,8,0,D,2000
971,1,23,Alexandre Bolduc,0,7,1,C,2008
972,0,24,Alexandre Bolduc,0,15,0,C,2009
973,2,25,Alexandre Bolduc,2,24,4,C,2010
974,0,26,Alexandre Bolduc,0,2,0,C,2011
975,0,27,Alexandre Bolduc,0,14,0,C,2012
976,0,29,Alexandre Bolduc,0,3,0,C,2014
977,5,24,Alexandre Burrows,7,43,12,LW,2005
978,6,25,Alexandre Burrows,3,81,9,LW,2006
979,19,26,Alexandre Burrows,12,82,31,LW,2007
980,23,27,Alexandre Burrows,28,82,51,LW,2008
981,32,28,Alexandre Burrows,35,82,67,LW,2009
982,22,29,Alexandre Burrows,26,72,48,LW,2010
983,24,30,Alexandre Burrows,28,80,52,LW,2011
984,11,31,Alexandre Burrows,13,47,24,LW,2012
985,10,32,Alexandre Burrows,5,49,15,LW,2013
986,15,33,Alexandre Burrows,18,70,33,LW,2014
987,13,34,Alexandre Burrows,9,79,22,RW,2015
988,5,35,Alexandre Burrows,6,20,11,LW,2016
989,8,36,Alexandre Burrows,6,71,14,RW,2017
990,0,20,Alexandre Carrier,0,2,0,D,2016
991,31,18,Alexandre Daigle,20,84,51,C,1993
992,21,19,Alexandre Daigle,16,47,37,C,1994
993,12,20,Alexandre Daigle,5,50,17,C,1995
994,25,21,Alexandre Daigle,26,82,51,RW,1996
995,26,22,Alexandre Daigle,16,75,42,RW,1997
996,8,23,Alexandre Daigle,9,63,17,C,1998
997,18,24,Alexandre Daigle,8,58,26,RW,1999
998,3,27,Alexandre Daigle,4,33,7,RW,2002
999,31,28,Alexandre Daigle,20,78,51,LW,2003
1000,23,30,Alexandre Daigle,5,46,28,RW,2005
1001,0,24,Alexandre Giroux,0,1,0,LW,2005
1002,2,25,Alexandre Giroux,2,9,4,C,2006
1003,1,27,Alexandre Giroux,1,12,2,LW,2008
1004,2,28,Alexandre Giroux,1,9,3,C,2009
1005,1,29,Alexandre Giroux,1,8,2,C,2010
1006,0,30,Alexandre Giroux,1,9,1,C,2011
1007,0,24,Alexandre Grenier,0,6,0,RW,2015
1008,0,25,Alexandre Grenier,0,3,0,RW,2016
1009,0,20,Alexandre Picard,0,17,0,LW,2005
1010,0,20,Alexandre Picard,0,6,0,D,2005
1012,1,21,Alexandre Picard,0,23,1,LW,2006
1011,19,21,Alexandre Picard,3,62,22,D,2006
1014,0,22,Alexandre Picard,0,3,0,LW,2007
1013,3,22,Alexandre Picard,3,24,6,D,2007
1016,1,23,Alexandre Picard,0,15,1,LW,2008
1015,8,23,Alexandre Picard,6,47,14,D,2008
1018,0,24,Alexandre Picard,0,9,0,LW,2009
1017,11,24,Alexandre Picard,4,54,15,D,2009
1019,5,25,Alexandre Picard,3,43,8,D,2010
1020,4,26,Alexandre Picard,0,17,4,D,2011
1021,0,22,Alexandre Volchkov,0,3,0,RW,1999
1022,4,25,Alexei Emelin,3,67,7,D,2011
1023,9,26,Alexei Emelin,3,38,12,D,2012
1024,14,27,Alexei Emelin,3,59,17,D,2013
1025,11,28,Alexei Emelin,3,68,14,D,2014
1026,12,29,Alexei Emelin,0,72,12,D,2015
1027,8,30,Alexei Emelin,2,76,10,D,2016
1028,8,31,Alexei Emelin,1,76,9,D,2017
1029,9,26,Alexei Gusarov,3,36,12,D,1990
1030,18,27,Alexei Gusarov,5,68,23,D,1991
1031,22,28,Alexei Gusarov,8,79,30,D,1992
1032,20,29,Alexei Gusarov,5,76,25,D,1993
1033,2,30,Alexei Gusarov,1,14,3,D,1994
1034,15,31,Alexei Gusarov,5,65,20,D,1995
1035,12,32,Alexei Gusarov,2,58,14,D,1996
1036,10,33,Alexei Gusarov,4,72,14,D,1997
1037,10,34,Alexei Gusarov,3,54,13,D,1998
1038,2,35,Alexei Gusarov,2,34,4,D,1999
1039,8,36,Alexei Gusarov,1,51,9,D,2000
1040,1,23,Alexei Kaigorodov,0,6,1,C,2006
1041,15,30,Alexei Kasatonov,6,39,21,D,1989
1042,31,31,Alexei Kasatonov,10,78,41,D,1990
1043,28,32,Alexei Kasatonov,12,76,40,D,1991
1044,14,33,Alexei Kasatonov,3,64,17,D,1992
1045,20,34,Alexei Kasatonov,4,63,24,D,1993
1046,14,35,Alexei Kasatonov,2,44,16,D,1994
1047,0,36,Alexei Kasatonov,1,19,1,D,1995
1048,0,,Alexei Kostylev,0,6,0,RW,1977
1049,0,,Alexei Kostylev,0,6,0,RW,1977
1050,0,22,Alexei Kudashov,1,25,1,C,1993
1051,0,24,Alexei Mikhnov,0,2,0,LW,2006
1052,3,20,Alexei Ponikarovsky,1,22,4,RW,2000
1053,0,21,Alexei Ponikarovsky,2,8,2,LW,2001
1054,3,22,Alexei Ponikarovsky,0,13,3,LW,2002
1055,19,23,Alexei Ponikarovsky,9,73,28,LW,2003
1056,17,25,Alexei Ponikarovsky,21,81,38,LW,2005
1057,24,26,Alexei Ponikarovsky,21,71,45,LW,2006
1058,17,27,Alexei Ponikarovsky,18,66,35,LW,2007
1059,38,28,Alexei Ponikarovsky,23,82,61,LW,2008
1060,29,29,Alexei Ponikarovsky,21,77,50,LW,2009
1061,10,30,Alexei Ponikarovsky,5,61,15,LW,2010
1062,19,31,Alexei Ponikarovsky,14,82,33,LW,2011
1063,5,32,Alexei Ponikarovsky,4,42,9,LW,2012
1064,6,21,Alexei Semenov,1,46,7,D,2002
1065,3,22,Alexei Semenov,2,46,5,D,2003
1066,2,24,Alexei Semenov,2,27,4,D,2005
1067,5,25,Alexei Semenov,0,23,5,D,2006
1068,3,26,Alexei Semenov,1,22,4,D,2007
1069,7,27,Alexei Semenov,1,47,8,D,2008
1070,2,21,Alexei Smirnov,3,44,5,LW,2002
1071,1,22,Alexei Smirnov,0,8,1,RW,2003
1072,0,20,Alexei Tezikov,0,5,0,D,1998
1073,1,21,Alexei Tezikov,1,23,2,D,1999
1074,0,23,Alexei Tezikov,0,2,0,D,2001
1075,0,22,Alexei Vasiliev,0,1,0,D,1999
1076,1,24,Alexei Volchenkov,3,8,4,D,1977
1077,1,24,Alexei Volchenkov,3,8,4,D,1977
1078,1,25,Alexei Volchenkov,0,6,1,RW,1978
1079,1,25,Alexei Volchenkov,0,6,1,RW,1978
1080,49,20,Alexei Yashin,30,83,79,C,1993
1081,23,21,Alexei Yashin,21,47,44,C,1994
1082,24,22,Alexei Yashin,15,46,39,C,1995
1083,40,23,Alexei Yashin,35,82,75,C,1996
1084,39,24,Alexei Yashin,33,82,72,C,1997
1085,50,25,Alexei Yashin,44,82,94,C,1998
1086,48,27,Alexei Yashin,40,82,88,C,2000
1087,43,28,Alexei Yashin,32,78,75,C,2001
1088,39,29,Alexei Yashin,26,81,65,C,2002
1089,19,30,Alexei Yashin,15,47,34,C,2003
1090,38,32,Alexei Yashin,28,82,66,C,2005
1091,32,33,Alexei Yashin,18,58,50,C,2006
1092,2,20,Alexei Yegorov,3,9,5,RW,1995
1093,1,21,Alexei Yegorov,0,2,1,RW,1996
1094,36,20,Alexei Zhitnik,12,78,48,D,1992
1095,40,21,Alexei Zhitnik,12,81,52,D,1993
1096,10,22,Alexei Zhitnik,4,32,14,D,1994
1097,30,23,Alexei Zhitnik,6,80,36,D,1995
1098,28,24,Alexei Zhitnik,7,80,35,D,1996
1099,30,25,Alexei Zhitnik,15,78,45,D,1997
1100,26,26,Alexei Zhitnik,7,81,33,D,1998
1101,11,27,Alexei Zhitnik,2,74,13,D,1999
1102,29,28,Alexei Zhitnik,8,78,37,D,2000
1103,33,29,Alexei Zhitnik,1,82,34,D,2001
1104,18,30,Alexei Zhitnik,3,70,21,D,2002
1105,24,31,Alexei Zhitnik,4,68,28,D,2003
1106,24,33,Alexei Zhitnik,5,59,29,D,2005
1107,31,34,Alexei Zhitnik,7,79,38,D,2006
1108,5,35,Alexei Zhitnik,3,65,8,D,2007
1109,0,22,Alexey Marchenko,0,1,0,D,2013
1110,1,23,Alexey Marchenko,1,13,2,D,2014
1111,9,24,Alexey Marchenko,2,66,11,D,2015
1112,1,25,Alexey Marchenko,1,11,2,D,2016
1113,2,26,Alexsandr Volchkov,3,8,5,LW,1977
1114,1,27,Alexsandr Volchkov,3,6,4,RW,1978
1115,3,28,Alf Handrahan,1,14,4,RW,1977
1116,3,28,Alf Handrahan,1,14,4,RW,1977
1117,7,18,Alfie Turcotte,7,30,14,C,1983
1118,16,19,Alfie Turcotte,8,53,24,C,1984
1119,0,20,Alfie Turcotte,0,2,0,C,1985
1120,0,22,Alfie Turcotte,0,3,0,C,1987
1121,3,23,Alfie Turcotte,1,14,4,C,1988
1122,2,24,Alfie Turcotte,0,4,2,C,1989
1123,1,25,Alfie Turcotte,1,6,2,C,1990
1124,0,23,Allan Egeland,0,5,0,C,1995
1125,0,24,Allan Egeland,0,4,0,C,1996
1126,0,25,Allan Egeland,0,8,0,C,1997
1127,2,23,Allan Rourke,1,25,3,D,2003
1128,1,25,Allan Rourke,0,6,1,D,2005
1129,1,26,Allan Rourke,0,11,1,D,2006
1130,0,27,Allan Rourke,0,13,0,D,2007
1131,13,41,Allan Stanley,1,64,14,D,1967
1132,13,42,Allan Stanley,4,64,17,D,1968
1133,0,22,Allan Stewart,0,4,0,LW,1985
1134,0,23,Allan Stewart,1,7,1,LW,1986
1135,0,24,Allan Stewart,0,1,0,LW,1987
1136,2,25,Allan Stewart,0,6,2,LW,1988
1137,2,27,Allan Stewart,5,41,7,LW,1990
1138,0,28,Allan Stewart,0,5,0,LW,1991
1139,1,22,Allan Tuer,0,45,1,D,1985
1140,0,24,Allan Tuer,1,6,1,D,1987
1141,0,25,Allan Tuer,0,4,0,D,1988
1142,0,26,Allan Tuer,0,2,0,D,1989
1143,11,22,Allen Pedersen,1,79,12,D,1986
1144,6,23,Allen Pedersen,0,78,6,D,1987
1145,6,24,Allen Pedersen,0,51,6,D,1988
1146,2,25,Allen Pedersen,1,68,3,D,1989
1147,6,26,Allen Pedersen,2,57,8,D,1990
1148,1,27,Allen Pedersen,0,29,1,D,1991
1149,4,28,Allen Pedersen,1,59,5,D,1992
1150,0,29,Allen Pedersen,0,7,0,D,1993
1151,21,27,Alton White,21,70,42,RW,1972
1152,21,27,Alton White,21,70,42,RW,1972
1153,13,28,Alton White,8,48,21,RW,1973
1154,13,28,Alton White,8,48,21,RW,1973
1155,12,29,Alton White,9,27,21,RW,1974
1156,12,29,Alton White,9,27,21,RW,1974
1157,10,20,Alyn McCauley,6,60,16,C,1997
1158,15,21,Alyn McCauley,9,39,24,C,1998
1159,5,22,Alyn McCauley,5,45,10,C,1999
1160,0,23,Alyn McCauley,1,14,1,C,2000
1161,10,24,Alyn McCauley,6,82,16,C,2001
1162,16,25,Alyn McCauley,9,80,25,C,2002
1163,27,26,Alyn McCauley,20,82,47,C,2003
1164,14,28,Alyn McCauley,12,76,26,C,2005
1165,0,29,Alyn McCauley,1,10,1,C,2006
1166,4,,Anatoli Emeljaneko,2,8,6,RW,1977
1167,4,,Anatoli Emeljaneko,2,8,6,RW,1977
1168,1,,Anatoli Emeljaneko,0,5,1,RW,1978
1169,1,,Anatoli Emeljaneko,0,5,1,RW,1978
1170,2,26,Anatoli Fedotov,0,1,2,D,1992
1171,0,27,Anatoli Fedotov,0,3,0,D,1993
1172,16,28,Anatoli Semenov,15,57,31,C,1990
1173,22,29,Anatoli Semenov,20,59,42,C,1991
1174,37,30,Anatoli Semenov,12,75,49,C,1992
1175,19,31,Anatoli Semenov,11,49,30,C,1993
1176,6,32,Anatoli Semenov,4,41,10,C,1994
1177,22,33,Anatoli Semenov,4,56,26,C,1995
1178,4,34,Anatoli Semenov,2,25,6,C,1996
1179,8,21,Anders Bjork,4,30,12,LW,2017
1180,18,26,Anders Carlsson,2,48,20,C,1986
1181,0,27,Anders Carlsson,1,9,1,C,1987
1182,8,28,Anders Carlsson,4,47,12,C,1988
1183,8,21,Anders Eldebrink,1,38,9,D,1981
1184,3,22,Anders Eldebrink,2,17,5,D,1982
1185,0,21,Anders Eriksson,0,1,0,D,1995
1186,6,22,Anders Eriksson,0,23,6,D,1996
1187,14,23,Anders Eriksson,7,66,21,D,1997
1188,18,24,Anders Eriksson,2,72,20,D,1998
1189,25,25,Anders Eriksson,3,73,28,D,1999
1190,24,26,Anders Eriksson,2,73,26,D,2000
1191,2,27,Anders Eriksson,0,34,2,D,2001
1192,0,28,Anders Eriksson,0,4,0,D,2002
1193,20,29,Anders Eriksson,7,66,27,D,2003
1194,23,32,Anders Eriksson,0,79,23,D,2006
1195,17,33,Anders Eriksson,1,61,18,D,2007
1196,5,35,Anders Eriksson,0,20,5,D,2009
1197,4,25,Anders Hakansson,12,72,16,LW,1981
1198,12,26,Anders Hakansson,9,67,21,LW,1982
1199,17,27,Anders Hakansson,15,80,32,LW,1983
1200,12,28,Anders Hakansson,12,73,24,RW,1984
1201,1,29,Anders Hakansson,4,38,5,RW,1985
1202,47,23,Anders Hedberg,53,65,100,RW,1974
1203,47,23,Anders Hedberg,53,65,100,RW,1974
1204,55,24,Anders Hedberg,50,76,105,RW,1975
1205,55,24,Anders Hedberg,50,76,105,RW,1975
1206,61,25,Anders Hedberg,70,68,131,RW,1976
1207,61,25,Anders Hedberg,70,68,131,RW,1976
1208,59,26,Anders Hedberg,63,77,122,RW,1977
1209,59,26,Anders Hedberg,63,77,122,RW,1977
1210,45,27,Anders Hedberg,33,80,78,RW,1978
1211,39,28,Anders Hedberg,32,80,71,RW,1979
1212,40,29,Anders Hedberg,30,80,70,RW,1980
1213,1,30,Anders Hedberg,0,4,1,RW,1981
1214,34,31,Anders Hedberg,25,78,59,RW,1982
1215,35,32,Anders Hedberg,32,79,67,RW,1983
1216,31,33,Anders Hedberg,20,64,51,RW,1984
1217,30,27,Anders Kallur,22,76,52,RW,1979
1218,28,28,Anders Kallur,36,78,64,RW,1980
1219,22,29,Anders Kallur,18,58,40,RW,1981
1220,8,30,Anders Kallur,6,55,14,RW,1982
1221,14,31,Anders Kallur,9,65,23,RW,1983
1222,8,32,Anders Kallur,10,51,18,C,1984
1223,1,22,Anders Lee,1,2,2,C,2012
1224,5,23,Anders Lee,9,22,14,C,2013
1225,16,24,Anders Lee,25,76,41,C,2014
1226,21,25,Anders Lee,15,80,36,LW,2015
1227,18,26,Anders Lee,34,81,52,LW,2016
1228,22,27,Anders Lee,40,82,62,LW,2017
1229,1,20,Anders Myrvold,0,4,1,D,1995
1230,2,21,Anders Myrvold,0,9,2,D,1996
1231,1,25,Anders Myrvold,0,12,1,D,2000
1232,1,28,Anders Myrvold,0,8,1,D,2003
1233,11,25,Anders Steen,5,42,16,C,1980
1234,1,27,Andre Benoit,0,8,1,D,2010
1235,7,29,Andre Benoit,3,33,10,D,2012
1236,21,30,Andre Benoit,7,79,28,D,2013
1237,8,31,Andre Benoit,1,59,9,D,2014
1238,0,32,Andre Benoit,0,2,0,D,2015
1239,35,24,Andre Boudrias,18,74,53,C,1967
1240,19,25,Andre Boudrias,8,73,27,LW,1968
1241,14,26,Andre Boudrias,3,50,17,C,1969
1242,41,27,Andre Boudrias,25,77,66,C,1970
1243,34,28,Andre Boudrias,27,78,61,LW,1971
1244,40,29,Andre Boudrias,30,77,70,LW,1972
1245,59,30,Andre Boudrias,16,78,75,LW,1973
1246,62,31,Andre Boudrias,16,77,78,LW,1974
1247,31,32,Andre Boudrias,7,71,38,LW,1975
1248,31,33,Andre Boudrias,12,74,43,C,1976
1249,31,33,Andre Boudrias,12,74,43,C,1976
1250,17,34,Andre Boudrias,10,66,27,C,1977
1251,17,34,Andre Boudrias,10,66,27,C,1977
1252,13,19,Andre Burakovsky,9,53,22,LW,2014
1253,21,20,Andre Burakovsky,17,79,38,LW,2015
1254,23,21,Andre Burakovsky,12,64,35,LW,2016
1255,13,22,Andre Burakovsky,12,56,25,LW,2017
1256,2,23,Andre Deschamps,1,9,3,LW,1976
1257,2,23,Andre Deschamps,1,9,3,LW,1976
1258,1,24,Andre Deveaux,0,21,1,C,2008
1259,0,25,Andre Deveaux,0,1,0,C,2009
1260,1,27,Andre Deveaux,0,9,1,C,2011
1261,0,20,Andre Dore,0,2,0,D,1978
1262,0,21,Andre Dore,0,2,0,D,1979
1263,3,22,Andre Dore,1,15,4,D,1980
1264,16,23,Andre Dore,4,56,20,D,1981
1265,27,24,Andre Dore,5,77,32,D,1982
1266,28,25,Andre Dore,4,80,32,D,1983
1267,7,26,Andre Dore,0,25,7,D,1984
1268,2,21,Andre Dupont,1,7,3,D,1970
1269,10,22,Andre Dupont,3,60,13,D,1971
1270,26,23,Andre Dupont,4,71,30,D,1972
1271,20,24,Andre Dupont,3,75,23,D,1973
1272,21,25,Andre Dupont,11,80,32,D,1974
1273,27,26,Andre Dupont,9,75,36,D,1975
1274,19,27,Andre Dupont,10,59,29,D,1976
1275,12,28,Andre Dupont,2,69,14,D,1977
1276,9,29,Andre Dupont,3,77,12,D,1978
1277,7,30,Andre Dupont,1,58,8,D,1979
1278,8,31,Andre Dupont,5,63,13,D,1980
1279,12,32,Andre Dupont,4,60,16,D,1981
1280,12,33,Andre Dupont,3,46,15,D,1982
1281,2,23,Andre Faust,2,10,4,LW,1992
1282,5,24,Andre Faust,8,37,13,LW,1993
1283,44,25,Andre Gaudette,27,77,71,C,1972
1284,44,25,Andre Gaudette,27,77,71,C,1972
1285,44,26,Andre Gaudette,24,78,68,C,1973
1286,44,26,Andre Gaudette,24,78,68,C,1973
1287,17,27,Andre Gaudette,10,67,27,C,1974
1288,17,27,Andre Gaudette,10,67,27,C,1974
1289,0,23,Andre Hidi,0,1,0,LW,1983
1290,1,24,Andre Hidi,2,6,3,LW,1984
1291,0,22,Andre Hinse,0,4,0,LW,1967
1292,56,28,Andre Hinse,24,69,80,LW,1973
1293,56,28,Andre Hinse,24,69,80,LW,1973
1294,47,29,Andre Hinse,39,75,86,LW,1974
1295,47,29,Andre Hinse,39,75,86,LW,1974
1296,38,30,Andre Hinse,35,70,73,LW,1975
1297,38,30,Andre Hinse,35,70,73,LW,1975
1298,10,31,Andre Hinse,4,42,14,LW,1976
1299,10,31,Andre Hinse,4,42,14,LW,1976
1300,8,22,Andre Lacroix,6,18,14,C,1967
1301,32,23,Andre Lacroix,24,75,56,C,1968
1302,36,24,Andre Lacroix,22,74,58,C,1969
1303,22,25,Andre Lacroix,20,78,42,C,1970
1304,7,26,Andre Lacroix,4,51,11,C,1971
1305,74,27,Andre Lacroix,50,78,124,C,1972
1306,74,27,Andre Lacroix,50,78,124,C,1972
1307,80,28,Andre Lacroix,31,78,111,C,1973
1308,80,28,Andre Lacroix,31,78,111,C,1973
1309,106,29,Andre Lacroix,41,78,147,C,1974
1310,106,29,Andre Lacroix,41,78,147,C,1974
1311,72,30,Andre Lacroix,29,80,101,C,1975
1312,72,30,Andre Lacroix,29,80,101,C,1975
1313,82,31,Andre Lacroix,32,81,114,C,1976
1314,82,31,Andre Lacroix,32,81,114,C,1976
1315,77,32,Andre Lacroix,36,78,113,C,1977
1316,77,32,Andre Lacroix,36,78,113,C,1977
1317,56,33,Andre Lacroix,32,78,88,C,1978
1318,56,33,Andre Lacroix,32,78,88,C,1978
1319,14,34,Andre Lacroix,3,29,17,C,1979
1320,0,23,Andre Peloffy,0,9,0,C,1974
1321,0,26,Andre Peloffy,2,10,2,C,1977
1322,0,26,Andre Peloffy,2,10,2,C,1977
1323,0,21,Andre Petersson,0,1,0,RW,2011
1324,0,31,Andre Pronovost,0,8,0,LW,1967
1325,0,20,Andre Roy,0,3,0,LW,1995
1326,2,21,Andre Roy,0,10,2,LW,1996
1327,3,24,Andre Roy,4,73,7,LW,1999
1328,5,25,Andre Roy,3,64,8,LW,2000
1329,9,26,Andre Roy,7,65,16,LW,2001
1330,7,27,Andre Roy,10,62,17,LW,2002
1331,1,28,Andre Roy,1,33,2,RW,2003
1332,1,30,Andre Roy,2,42,3,LW,2005
1333,2,31,Andre Roy,1,56,3,RW,2006
1334,3,32,Andre Roy,4,63,7,RW,2007
1335,0,33,Andre Roy,3,44,3,LW,2008
1336,0,23,Andre Savage,1,6,1,C,1998
1337,13,24,Andre Savage,7,43,20,C,1999
1338,0,25,Andre Savage,0,1,0,C,2000
1339,1,27,Andre Savage,2,16,3,C,2002
1340,14,20,Andre Savard,16,72,30,C,1973
1341,25,21,Andre Savard,19,77,44,C,1974
1342,23,22,Andre Savard,17,79,40,C,1975
1343,35,23,Andre Savard,25,80,60,C,1976
1344,20,24,Andre Savard,19,80,39,C,1977
1345,22,25,Andre Savard,18,65,40,C,1978
1346,10,26,Andre Savard,3,33,13,C,1979
1347,43,27,Andre Savard,31,79,74,C,1980
1348,20,28,Andre Savard,18,62,38,C,1981
1349,25,29,Andre Savard,16,68,41,C,1982
1350,24,30,Andre Savard,20,60,44,C,1983
1351,10,31,Andre Savard,9,35,19,C,1984
1352,9,20,Andre St. Laurent,5,42,14,C,1973
1353,27,21,Andre St. Laurent,14,78,41,C,1974
1354,17,22,Andre St. Laurent,9,67,26,C,1975
1355,13,23,Andre St. Laurent,10,72,23,C,1976
1356,39,24,Andre St. Laurent,31,79,70,C,1977
1357,31,25,Andre St. Laurent,18,76,49,C,1978
1358,24,26,Andre St. Laurent,6,77,30,C,1979
1359,6,27,Andre St. Laurent,10,22,16,C,1980
1360,9,28,Andre St. Laurent,10,34,19,C,1981
1361,9,29,Andre St. Laurent,13,70,22,C,1982
1362,3,30,Andre St. Laurent,3,27,6,C,1983
1363,5,21,Andreas Athanasiou,9,37,14,C,2015
1364,11,22,Andreas Athanasiou,18,64,29,C,2016
1365,17,23,Andreas Athanasiou,16,71,33,LW,2017
1366,8,22,Andreas Borgman,3,48,11,D,2017
1367,19,24,Andreas Dackell,12,79,31,RW,1996
1368,18,25,Andreas Dackell,15,82,33,RW,1997
1369,35,26,Andreas Dackell,15,77,50,RW,1998
1370,25,27,Andreas Dackell,10,82,35,RW,1999
1371,18,28,Andreas Dackell,13,81,31,RW,2000
1372,18,29,Andreas Dackell,15,79,33,RW,2001
1373,18,30,Andreas Dackell,7,73,25,RW,2002
1374,8,31,Andreas Dackell,4,60,12,RW,2003
1375,0,21,Andreas Englund,0,5,0,D,2016
1376,0,22,Andreas Englund,0,1,0,D,2017
1377,0,23,Andreas Engqvist,0,3,0,C,2010
1378,0,24,Andreas Engqvist,0,12,0,C,2011
1379,1,22,Andreas Johansson,0,3,1,C,1995
1380,9,23,Andreas Johansson,4,42,13,C,1996
1381,10,24,Andreas Johansson,5,50,15,RW,1997
1382,16,25,Andreas Johansson,21,69,37,C,1998
1383,10,26,Andreas Johansson,5,40,15,LW,1999
1384,10,28,Andreas Johansson,14,70,24,LW,2001
1385,17,29,Andreas Johansson,20,56,37,LW,2002
1386,15,30,Andreas Johansson,12,47,27,LW,2003
1387,1,23,Andreas Johnsson,2,9,3,LW,2017
1388,9,24,Andreas Karlsson,5,51,14,C,1999
1389,11,25,Andreas Karlsson,5,60,16,C,2000
1390,7,26,Andreas Karlsson,1,42,8,C,2001
1391,6,31,Andreas Karlsson,3,53,9,C,2006
1392,2,32,Andreas Karlsson,2,58,4,C,2007
1393,0,25,Andreas Lilja,0,2,0,D,2000
1394,4,26,Andreas Lilja,1,26,5,D,2001
1395,11,27,Andreas Lilja,4,73,15,D,2002
1396,4,28,Andreas Lilja,3,79,7,D,2003
1397,13,30,Andreas Lilja,2,82,15,D,2005
1398,5,31,Andreas Lilja,0,57,5,D,2006
1399,10,32,Andreas Lilja,2,79,12,D,2007
1400,11,33,Andreas Lilja,2,60,13,D,2008
1401,1,34,Andreas Lilja,1,20,2,D,2009
1402,6,35,Andreas Lilja,1,52,7,D,2010
1403,6,36,Andreas Lilja,0,46,6,D,2011
1404,0,37,Andreas Lilja,0,4,0,D,2012
1405,7,25,Andreas Martinsen,4,55,11,LW,2015
1406,0,26,Andreas Martinsen,0,9,0,LW,2016
1407,0,27,Andreas Martinsen,1,9,1,LW,2017
1408,3,21,Andreas Nodl,1,38,4,RW,2008
1409,1,22,Andreas Nodl,0,10,1,RW,2009
1410,11,23,Andreas Nodl,11,67,22,RW,2010
1411,5,24,Andreas Nodl,3,60,8,RW,2011
1412,1,25,Andreas Nodl,0,8,1,RW,2012
1413,5,28,Andreas Salomonsson,4,39,9,LW,2001
1414,4,29,Andreas Salomonsson,1,32,5,LW,2002
1415,2,22,Andreas Thuresson,1,22,3,RW,2009
1416,0,23,Andreas Thuresson,0,3,0,RW,2010
1417,0,28,Andrei Bashkirov,0,10,0,LW,1998
1418,0,29,Andrei Bashkirov,0,2,0,LW,1999
1419,3,30,Andrei Bashkirov,0,18,3,LW,2000
1420,1,20,Andrei Kostitsyn,2,12,3,RW,2005
1421,10,21,Andrei Kostitsyn,1,22,11,LW,2006
1422,27,22,Andrei Kostitsyn,26,78,53,LW,2007
1423,18,23,Andrei Kostitsyn,23,74,41,LW,2008
1424,18,24,Andrei Kostitsyn,15,59,33,LW,2009
1425,25,25,Andrei Kostitsyn,20,81,45,LW,2010
1426,20,26,Andrei Kostitsyn,16,72,36,LW,2011
1427,41,22,Andrei Kovalenko,27,81,68,RW,1992
1428,17,23,Andrei Kovalenko,16,58,33,RW,1993
1429,10,24,Andrei Kovalenko,14,45,24,RW,1994
1430,28,25,Andrei Kovalenko,28,77,56,LW,1995
1431,27,26,Andrei Kovalenko,32,74,59,RW,1996
1432,17,27,Andrei Kovalenko,6,59,23,RW,1997
1433,21,28,Andrei Kovalenko,19,74,40,RW,1998
1434,24,29,Andrei Kovalenko,15,76,39,RW,1999
1435,21,30,Andrei Kovalenko,16,76,37,RW,2000
1436,0,19,Andrei Loktionov,0,1,0,C,2009
1437,3,20,Andrei Loktionov,4,19,7,C,2010
1438,4,21,Andrei Loktionov,3,39,7,C,2011
1439,4,22,Andrei Loktionov,8,28,12,C,2012
1440,15,23,Andrei Loktionov,7,68,22,C,2013
1441,16,27,Andrei Lomakin,14,57,30,RW,1991
1442,12,28,Andrei Lomakin,8,51,20,LW,1992
1443,28,29,Andrei Lomakin,19,76,47,LW,1993
1444,6,30,Andrei Lomakin,1,31,7,LW,1994
1445,17,22,Andrei Markov,6,63,23,D,2000
1446,19,23,Andrei Markov,5,56,24,D,2001
1447,24,24,Andrei Markov,13,79,37,D,2002
1448,22,25,Andrei Markov,6,69,28,D,2003
1449,36,27,Andrei Markov,10,67,46,D,2005
1450,43,28,Andrei Markov,6,77,49,D,2006
1451,42,29,Andrei Markov,16,82,58,D,2007
1452,52,30,Andrei Markov,12,78,64,D,2008
1453,28,31,Andrei Markov,6,45,34,D,2009
1454,2,32,Andrei Markov,1,7,3,D,2010
1455,3,33,Andrei Markov,0,13,3,D,2011
1456,20,34,Andrei Markov,10,48,30,D,2012
1457,36,35,Andrei Markov,7,81,43,D,2013
1458,40,36,Andrei Markov,10,81,50,D,2014
1459,39,37,Andrei Markov,5,82,44,D,2015
1460,30,38,Andrei Markov,6,62,36,D,2016
1461,2,23,Andrei Mironov,1,10,3,D,2017
1462,0,19,Andrei Nazarov,0,1,0,RW,1993
1463,5,20,Andrei Nazarov,3,26,8,LW,1994
1464,7,21,Andrei Nazarov,7,42,14,RW,1995
1465,15,22,Andrei Nazarov,12,60,27,LW,1996
1466,2,23,Andrei Nazarov,2,54,4,RW,1997
1467,9,24,Andrei Nazarov,7,62,16,LW,1998
1468,22,25,Andrei Nazarov,10,76,32,RW,1999
1469,4,26,Andrei Nazarov,2,79,6,RW,2000
1470,5,27,Andrei Nazarov,6,77,11,LW,2001
1471,0,28,Andrei Nazarov,3,59,3,LW,2002
1472,2,29,Andrei Nazarov,1,33,3,LW,2003
1473,0,31,Andrei Nazarov,0,2,0,RW,2005
1474,10,21,Andrei Nikolishin,8,39,18,C,1994
1475,37,22,Andrei Nikolishin,14,61,51,C,1995
1476,19,23,Andrei Nikolishin,9,71,28,LW,1996
1477,10,24,Andrei Nikolishin,6,38,16,C,1997
1478,27,25,Andrei Nikolishin,8,73,35,LW,1998
1479,14,26,Andrei Nikolishin,11,76,25,C,1999
1480,25,27,Andrei Nikolishin,13,81,38,C,2000
1481,23,28,Andrei Nikolishin,13,80,36,C,2001
1482,15,29,Andrei Nikolishin,6,60,21,C,2002
1483,7,30,Andrei Nikolishin,5,49,12,C,2003
1484,1,27,Andrei Skopintsev,1,19,2,D,1998
1485,0,28,Andrei Skopintsev,0,4,0,D,1999
1486,3,29,Andrei Skopintsev,1,17,4,D,2000
1487,0,22,Andrei Vasilyev,0,2,0,LW,1994
1488,5,23,Andrei Vasilyev,2,10,7,LW,1995
1489,0,24,Andrei Vasilyev,0,3,0,LW,1996
1490,0,26,Andrei Vasilyev,0,1,0,LW,1998
1491,1,23,Andrei Zubarev,0,4,1,D,2010
1492,7,20,Andrei Zyuzin,6,56,13,D,1997
1493,1,21,Andrei Zyuzin,3,25,4,D,1998
1494,9,22,Andrei Zyuzin,2,34,11,D,1999
1495,16,23,Andrei Zyuzin,4,64,20,D,2000
1496,4,24,Andrei Zyuzin,1,47,5,D,2001
1497,13,25,Andrei Zyuzin,4,67,17,D,2002
1498,13,26,Andrei Zyuzin,8,65,21,D,2003
1499,11,28,Andrei Zyuzin,7,57,18,D,2005
1500,5,29,Andrei Zyuzin,1,49,6,D,2006
1501,3,30,Andrei Zyuzin,2,32,5,D,2007
1502,29,20,Andrej Meszaros,10,82,39,D,2005
1503,28,21,Andrej Meszaros,7,82,35,D,2006
1504,27,22,Andrej Meszaros,9,82,36,D,2007
1505,14,23,Andrej Meszaros,2,52,16,D,2008
1506,11,24,Andrej Meszaros,6,81,17,D,2009
1507,24,25,Andrej Meszaros,8,81,32,D,2010
1508,18,26,Andrej Meszaros,7,62,25,D,2011
1509,2,27,Andrej Meszaros,0,11,2,D,2012
1510,15,28,Andrej Meszaros,7,52,22,D,2013
1511,7,29,Andrej Meszaros,7,60,14,D,2014
1512,2,21,Andrej Nedorost,0,7,2,C,2001
1513,1,22,Andrej Nedorost,0,12,1,C,2002
1514,0,23,Andrej Nedorost,2,9,2,LW,2003
1515,13,23,Andrej Nestrasil,7,54,20,C,2014
1516,14,24,Andrej Nestrasil,9,55,23,C,2015
1517,4,25,Andrej Nestrasil,1,19,5,C,2016
1518,0,22,Andrej Podkonicky,1,6,1,LW,2000
1519,0,25,Andrej Podkonicky,0,2,0,C,2003
1520,0,20,Andrej Sekera,0,2,0,D,2006
1521,6,21,Andrej Sekera,2,37,8,D,2007
1522,16,22,Andrej Sekera,3,69,19,D,2008
1523,7,23,Andrej Sekera,4,49,11,D,2009
1524,26,24,Andrej Sekera,3,76,29,D,2010
1525,10,25,Andrej Sekera,3,69,13,D,2011
1526,10,26,Andrej Sekera,2,37,12,D,2012
1527,33,27,Andrej Sekera,11,74,44,D,2013
1528,20,28,Andrej Sekera,3,73,23,D,2014
1529,24,29,Andrej Sekera,6,81,30,D,2015
1530,27,30,Andrej Sekera,8,80,35,D,2016
1531,8,31,Andrej Sekera,0,36,8,D,2017
1532,0,22,Andrej Sustr,0,2,0,D,2012
1533,7,23,Andrej Sustr,1,43,8,D,2013
1534,13,24,Andrej Sustr,0,72,13,D,2014
1535,17,25,Andrej Sustr,4,77,21,D,2015
1536,11,26,Andrej Sustr,3,80,14,D,2016
1537,5,27,Andrej Sustr,2,44,7,D,2017
1538,1,24,Andrew Agozzino,0,1,1,LW,2014
1539,2,25,Andrew Agozzino,0,9,2,LW,2015
1540,6,24,Andrew Alberts,1,73,7,D,2005
1541,10,25,Andrew Alberts,0,76,10,D,2006
1542,2,26,Andrew Alberts,0,35,2,D,2007
1543,12,27,Andrew Alberts,1,79,13,D,2008
1544,9,28,Andrew Alberts,3,76,12,D,2009
1545,6,29,Andrew Alberts,1,42,7,D,2010
1546,1,30,Andrew Alberts,2,44,3,D,2011
1547,1,31,Andrew Alberts,0,24,1,D,2012
1548,0,32,Andrew Alberts,0,10,0,D,2013
1549,0,21,Andrew Bodnarchuk,0,5,0,D,2009
1550,4,27,Andrew Bodnarchuk,0,37,4,D,2015
1551,3,22,Andrew Brunette,3,11,6,LW,1995
1552,7,23,Andrew Brunette,4,23,11,LW,1996
1553,12,24,Andrew Brunette,11,28,23,LW,1997
1554,20,25,Andrew Brunette,11,77,31,LW,1998
1555,27,26,Andrew Brunette,23,81,50,LW,1999
1556,44,27,Andrew Brunette,15,77,59,LW,2000
1557,48,28,Andrew Brunette,21,81,69,LW,2001
1558,28,29,Andrew Brunette,18,82,46,LW,2002
1559,34,30,Andrew Brunette,15,82,49,RW,2003
1560,39,32,Andrew Brunette,24,82,63,LW,2005
1561,56,33,Andrew Brunette,27,82,83,LW,2006
1562,40,34,Andrew Brunette,19,82,59,LW,2007
1563,28,35,Andrew Brunette,22,80,50,LW,2008
1564,36,36,Andrew Brunette,25,82,61,LW,2009
1565,28,37,Andrew Brunette,18,82,46,LW,2010
1566,15,38,Andrew Brunette,12,78,27,LW,2011
1567,0,25,Andrew Campbell,0,3,0,D,2013
1568,1,26,Andrew Campbell,0,33,1,D,2014
1569,1,27,Andrew Campbell,0,6,1,D,2015
1570,0,20,Andrew Cassels,2,6,2,C,1989
1571,19,21,Andrew Cassels,6,54,25,LW,1990
1572,30,22,Andrew Cassels,11,67,41,C,1991
1573,64,23,Andrew Cassels,21,84,85,C,1992
1574,42,24,Andrew Cassels,16,79,58,C,1993
1575,30,25,Andrew Cassels,7,46,37,C,1994
1576,43,26,Andrew Cassels,20,81,63,C,1995
1577,44,27,Andrew Cassels,22,81,66,C,1996
1578,27,28,Andrew Cassels,17,81,44,C,1997
1579,25,29,Andrew Cassels,12,70,37,C,1998
1580,45,30,Andrew Cassels,17,79,62,C,1999
1581,44,31,Andrew Cassels,12,66,56,C,2000
1582,39,32,Andrew Cassels,11,53,50,C,2001
1583,48,33,Andrew Cassels,20,79,68,C,2002
1584,20,34,Andrew Cassels,6,58,26,C,2003
1585,8,36,Andrew Cassels,4,31,12,C,2005
1586,27,20,Andrew Cogliano,18,82,45,C,2007
1587,20,21,Andrew Cogliano,18,82,38,C,2008
1588,18,22,Andrew Cogliano,10,82,28,C,2009
1589,24,23,Andrew Cogliano,11,82,35,C,2010
1590,13,24,Andrew Cogliano,13,82,26,C,2011
1591,10,25,Andrew Cogliano,13,48,23,C,2012
1592,20,26,Andrew Cogliano,22,82,42,C,2013
1593,14,27,Andrew Cogliano,15,82,29,LW,2014
1594,23,28,Andrew Cogliano,9,82,32,LW,2015
1595,19,29,Andrew Cogliano,16,82,35,LW,2016
1596,23,30,Andrew Cogliano,12,80,35,LW,2017
1597,1,20,Andrew Copp,0,1,1,C,2014
1598,6,21,Andrew Copp,7,77,13,C,2015
1599,8,22,Andrew Copp,9,64,17,C,2016
1600,19,23,Andrew Copp,9,82,28,C,2017
1601,0,25,Andrew Crescenzi,0,2,0,C,2017
1602,2,24,Andrew Desjardins,1,17,3,C,2010
1603,13,25,Andrew Desjardins,4,76,17,C,2011
1604,1,26,Andrew Desjardins,2,42,3,C,2012
1605,14,27,Andrew Desjardins,3,81,17,C,2013
1606,5,28,Andrew Desjardins,5,69,10,C,2014
1607,5,29,Andrew Desjardins,8,77,13,LW,2015
1608,1,30,Andrew Desjardins,0,46,1,LW,2016
1609,0,25,Andrew Ebbett,0,3,0,C,2007
1610,24,26,Andrew Ebbett,8,48,32,C,2008
1611,6,27,Andrew Ebbett,9,61,15,C,2009
1612,3,28,Andrew Ebbett,2,33,5,C,2010
1613,1,29,Andrew Ebbett,5,18,6,C,2011
1614,5,30,Andrew Ebbett,1,28,6,C,2012
1615,1,31,Andrew Ebbett,0,9,1,C,2013
1616,5,32,Andrew Ebbett,1,24,6,C,2014
1617,4,20,Andrew Ference,2,30,6,D,1999
1618,11,21,Andrew Ference,4,36,15,D,2000
1619,7,22,Andrew Ference,4,75,11,D,2001
1620,7,23,Andrew Ference,1,38,8,D,2002
1621,12,24,Andrew Ference,4,72,16,D,2003
1622,27,26,Andrew Ference,4,82,31,D,2005
1623,12,27,Andrew Ference,3,80,15,D,2006
1624,14,28,Andrew Ference,1,59,15,D,2007
1625,15,29,Andrew Ference,1,47,16,D,2008
1626,8,30,Andrew Ference,0,51,8,D,2009
1627,12,31,Andrew Ference,3,70,15,D,2010
1628,18,32,Andrew Ference,6,72,24,D,2011
1629,9,33,Andrew Ference,4,48,13,D,2012
1630,15,34,Andrew Ference,3,71,18,D,2013
1631,11,35,Andrew Ference,3,70,14,D,2014
1632,0,36,Andrew Ference,0,6,0,D,2015
1633,0,23,Andrew Gordon,0,1,0,RW,2008
1634,0,24,Andrew Gordon,0,2,0,RW,2009
1635,1,25,Andrew Gordon,1,9,2,RW,2010
1636,3,26,Andrew Gordon,2,37,5,RW,2011
1637,0,27,Andrew Gordon,0,6,0,RW,2012
1638,4,23,Andrew Hutchinson,4,18,8,D,2003
1639,8,25,Andrew Hutchinson,3,36,11,D,2005
1640,11,26,Andrew Hutchinson,3,41,14,D,2006
1641,3,28,Andrew Hutchinson,2,40,5,D,2008
1642,1,30,Andrew Hutchinson,0,5,1,D,2010
1643,0,27,Andrew Joudrey,0,1,0,C,2011
1644,5,20,Andrew Ladd,6,29,11,LW,2005
1645,10,21,Andrew Ladd,11,65,21,LW,2006
1646,16,22,Andrew Ladd,14,63,30,LW,2007
1647,34,23,Andrew Ladd,15,82,49,LW,2008
1648,21,24,Andrew Ladd,17,82,38,LW,2009
1649,30,25,Andrew Ladd,29,81,59,LW,2010
1650,22,26,Andrew Ladd,28,82,50,LW,2011
1651,28,27,Andrew Ladd,18,48,46,LW,2012
1652,31,28,Andrew Ladd,23,78,54,LW,2013
1653,38,29,Andrew Ladd,24,81,62,LW,2014
1654,21,30,Andrew Ladd,25,78,46,LW,2015
1655,8,31,Andrew Ladd,23,78,31,LW,2016
1656,17,32,Andrew Ladd,12,73,29,LW,2017
1657,0,22,Andrew MacDonald,0,3,0,D,2008
1658,6,23,Andrew MacDonald,1,46,7,D,2009
1659,23,24,Andrew MacDonald,4,60,27,D,2010
1660,14,25,Andrew MacDonald,5,75,19,D,2011
1661,9,26,Andrew MacDonald,3,48,12,D,2012
1662,24,27,Andrew MacDonald,4,82,28,D,2013
1663,10,28,Andrew MacDonald,2,58,12,D,2014
1664,7,29,Andrew MacDonald,1,28,8,D,2015
1665,16,30,Andrew MacDonald,2,73,18,D,2016
1666,15,31,Andrew MacDonald,6,66,21,D,2017
1667,2,24,Andrew MacWilliam,0,12,2,D,2014
1668,0,21,Andrew Mangiapane,0,10,0,LW,2017
1669,19,19,Andrew McBain,11,78,30,RW,1983
1670,15,20,Andrew McBain,7,77,22,RW,1984
1671,3,21,Andrew McBain,3,28,6,RW,1985
1672,21,22,Andrew McBain,11,71,32,RW,1986
1673,31,23,Andrew McBain,32,74,63,RW,1987
1674,40,24,Andrew McBain,37,80,77,RW,1988
1675,14,25,Andrew McBain,9,67,23,RW,1989
1676,5,26,Andrew McBain,0,13,5,RW,1990
1677,0,27,Andrew McBain,1,6,1,RW,1991
1678,16,28,Andrew McBain,7,59,23,RW,1992
1679,8,29,Andrew McBain,11,55,19,RW,1993
1680,3,22,Andrew McKim,1,7,4,C,1992
1681,1,23,Andrew McKim,0,29,1,C,1993
1682,0,24,Andrew McKim,0,2,0,C,1994
1683,5,26,Andrew Miller,1,9,6,C,2014
1684,0,27,Andrew Miller,0,6,0,C,2015
1685,4,26,Andrew Murray,6,39,10,C,2007
1686,3,27,Andrew Murray,8,67,11,C,2008
1687,2,28,Andrew Murray,5,46,7,C,2009
1688,4,29,Andrew Murray,4,29,8,C,2010
1689,3,30,Andrew Murray,1,39,4,C,2011
1690,0,31,Andrew Murray,0,1,0,C,2012
1691,0,23,Andrew Peters,2,42,2,LW,2003
1692,0,25,Andrew Peters,0,28,0,LW,2005
1693,1,26,Andrew Peters,1,58,2,LW,2006
1694,1,27,Andrew Peters,1,44,2,LW,2007
1695,1,28,Andrew Peters,0,28,1,LW,2008
1696,0,29,Andrew Peters,0,29,0,LW,2009
1697,0,23,Andrew Poturalski,0,2,0,C,2016
1698,11,20,Andrew Shaw,12,37,23,C,2011
1699,6,21,Andrew Shaw,9,48,15,C,2012
1700,19,22,Andrew Shaw,20,80,39,C,2013
1701,11,23,Andrew Shaw,15,79,26,C,2014
1702,20,24,Andrew Shaw,14,78,34,RW,2015
1703,17,25,Andrew Shaw,12,68,29,C,2016
1704,10,26,Andrew Shaw,10,51,20,RW,2017
1705,0,22,Andrey Pedan,0,13,0,D,2015
1706,1,23,Andy Andreoff,2,18,3,LW,2014
1707,2,24,Andy Andreoff,8,60,10,LW,2015
1708,2,25,Andy Andreoff,0,36,2,LW,2016
1709,6,26,Andy Andreoff,3,45,9,LW,2017
1710,39,35,Andy Bathgate,20,74,59,RW,1967
1711,29,38,Andy Bathgate,15,76,44,RW,1970
1712,6,42,Andy Bathgate*,1,11,7,RW,1974
1713,6,42,Andy Bathgate*,1,11,7,RW,1974
1714,1,21,Andy Brickley,1,3,2,LW,1982
1715,20,22,Andy Brickley,18,50,38,LW,1983
1716,15,23,Andy Brickley,7,45,22,LW,1984
1717,12,25,Andy Brickley,11,51,23,C,1986
1718,14,26,Andy Brickley,8,45,22,LW,1987
1719,22,27,Andy Brickley,13,71,35,C,1988
1720,28,28,Andy Brickley,12,43,40,LW,1989
1721,9,29,Andy Brickley,2,40,11,C,1990
1722,17,30,Andy Brickley,10,23,27,C,1991
1723,2,31,Andy Brickley,0,12,2,LW,1992
1724,0,32,Andy Brickley,0,2,0,LW,1993
1725,1,22,Andy Delmore,0,2,1,D,1998
1726,5,23,Andy Delmore,2,27,7,D,1999
1727,9,24,Andy Delmore,5,66,14,D,2000
1728,22,25,Andy Delmore,16,73,38,D,2001
1729,16,26,Andy Delmore,18,71,34,D,2002
1730,5,27,Andy Delmore,2,37,7,D,2003
1731,0,29,Andy Delmore,0,7,0,D,2005
1732,5,24,Andy Greene,1,23,6,D,2006
1733,8,25,Andy Greene,2,59,10,D,2007
1734,7,26,Andy Greene,2,49,9,D,2008
1735,31,27,Andy Greene,6,78,37,D,2009
1736,19,28,Andy Greene,4,82,23,D,2010
1737,15,29,Andy Greene,1,56,16,D,2011
1738,12,30,Andy Greene,4,48,16,D,2012
1739,24,31,Andy Greene,8,82,32,D,2013
1740,19,32,Andy Greene,3,82,22,D,2014
1741,9,33,Andy Greene,4,82,13,D,2015
1742,9,34,Andy Greene,4,66,13,D,2016
1743,10,35,Andy Greene,3,81,13,D,2017
1744,0,20,Andy Hilbert,1,6,1,C,2001
1745,3,21,Andy Hilbert,0,14,3,C,2002
1746,0,22,Andy Hilbert,2,18,2,C,2003
1747,15,24,Andy Hilbert,12,47,27,C,2005
1748,20,25,Andy Hilbert,8,81,28,C,2006
1749,8,26,Andy Hilbert,8,70,16,C,2007
1750,16,27,Andy Hilbert,11,67,27,C,2008
1751,0,28,Andy Hilbert,0,4,0,C,2009
1752,0,23,Andy McDonald,1,16,1,C,2000
1753,21,24,Andy McDonald,7,53,28,C,2001
1754,11,25,Andy McDonald,10,46,21,C,2002
1755,21,26,Andy McDonald,9,79,30,LW,2003
1756,51,28,Andy McDonald,34,82,85,C,2005
1757,51,29,Andy McDonald,27,82,78,C,2006
1758,34,30,Andy McDonald,18,82,52,C,2007
1759,29,31,Andy McDonald,15,46,44,C,2008
1760,33,32,Andy McDonald,24,79,57,C,2009
1761,30,33,Andy McDonald,20,58,50,C,2010
1762,12,34,Andy McDonald,10,25,22,C,2011
1763,14,35,Andy McDonald,7,37,21,C,2012
1764,0,23,Andy Miele,0,7,0,C,2011
1765,0,24,Andy Miele,0,1,0,C,2012
1766,2,25,Andy Miele,0,7,2,C,2013
1767,2,32,Andy Roach,1,5,3,D,2005
1768,0,23,Andy Rymsha,0,6,0,D,1991
1769,1,19,Andy Schliebener,0,22,1,D,1981
1770,10,21,Andy Schliebener,2,51,12,D,1983
1771,0,22,Andy Schliebener,0,11,0,D,1984
1772,0,21,Andy Schneider,0,10,0,LW,1993
1773,6,22,Andy Spruce,9,51,15,LW,1976
1774,21,23,Andy Spruce,19,74,40,LW,1977
1775,15,24,Andy Spruce,3,47,18,LW,1978
1776,3,23,Andy Sutton,0,31,3,D,1998
1777,1,24,Andy Sutton,1,40,2,D,1999
1778,4,25,Andy Sutton,3,69,7,D,2000
1779,8,26,Andy Sutton,2,43,10,D,2001
1780,18,27,Andy Sutton,3,53,21,D,2002
1781,13,28,Andy Sutton,8,65,21,D,2003
1782,17,30,Andy Sutton,8,76,25,D,2005
1783,14,31,Andy Sutton,2,55,16,D,2006
1784,7,32,Andy Sutton,1,58,8,D,2007
1785,8,33,Andy Sutton,2,23,10,D,2008
1786,8,34,Andy Sutton,5,72,13,D,2009
1787,4,35,Andy Sutton,0,39,4,D,2010
1788,7,36,Andy Sutton,3,52,10,D,2011
1789,2,24,Andy Welinski,0,7,2,D,2017
1790,1,25,Andy Wozniewski,0,13,1,D,2005
1791,2,26,Andy Wozniewski,0,15,2,D,2006
1792,7,27,Andy Wozniewski,2,48,9,D,2007
1793,0,28,Andy Wozniewski,0,1,0,D,2008
1794,0,29,Andy Wozniewski,0,2,0,D,2009
1795,2,23,Angelo Moretto,1,5,3,C,1976
1796,1,25,Angelo Moretto,3,18,4,C,1978
1797,1,25,Angelo Moretto,3,18,4,C,1978
1798,7,22,Anson Carter,11,38,18,RW,1996
1799,27,23,Anson Carter,16,78,43,C,1997
1800,16,24,Anson Carter,24,55,40,C,1998
1801,25,25,Anson Carter,22,59,47,C,1999
1802,26,26,Anson Carter,16,61,42,LW,2000
1803,32,27,Anson Carter,28,82,60,RW,2001
1804,34,28,Anson Carter,26,79,60,RW,2002
1805,13,29,Anson Carter,15,77,28,RW,2003
1806,22,31,Anson Carter,33,81,55,RW,2005
1807,17,32,Anson Carter,11,64,28,RW,2006
1808,3,24,Anssi Melametsa,0,27,3,LW,1985
1809,5,24,Anssi Salmela,1,26,6,D,2008
1810,6,25,Anssi Salmela,2,38,8,D,2009
1811,6,26,Anssi Salmela,1,48,7,D,2010
1812,12,25,Antero Lehtonen,9,65,21,LW,1979
1813,15,19,Anthony Beauvillier,9,66,24,LW,2016
1814,15,20,Anthony Beauvillier,21,71,36,LW,2017
1815,0,24,Anthony Bitetto,0,7,0,D,2014
1816,5,25,Anthony Bitetto,1,28,6,D,2015
1817,7,26,Anthony Bitetto,0,29,7,D,2016
1818,2,27,Anthony Bitetto,1,32,3,D,2017
1819,6,20,Anthony Cirelli,5,18,11,C,2017
1820,9,21,Anthony DeAngelo,5,39,14,D,2016
1821,8,22,Anthony DeAngelo,0,32,8,D,2017
1822,6,19,Anthony Duclair,1,18,7,LW,2014
1823,24,20,Anthony Duclair,20,81,44,LW,2015
1824,10,21,Anthony Duclair,5,58,15,LW,2016
1825,6,22,Anthony Duclair,2,23,8,LW,2017
1826,1,21,Anthony Mantha,2,10,3,RW,2015
1827,19,22,Anthony Mantha,17,60,36,RW,2016
1828,24,23,Anthony Mantha,24,80,48,RW,2017
1829,2,23,Anthony Peluso,0,5,2,RW,2012
1830,3,24,Anthony Peluso,2,53,5,RW,2013
1831,1,25,Anthony Peluso,1,49,2,RW,2014
1832,4,26,Anthony Peluso,1,35,5,RW,2015
1833,0,28,Anthony Peluso,0,2,0,RW,2017
1834,1,21,Anthony Stewart,2,10,3,C,2005
1835,1,22,Anthony Stewart,0,10,1,C,2006
1836,1,23,Anthony Stewart,0,26,1,C,2007
1837,5,24,Anthony Stewart,2,59,7,RW,2008
1838,25,26,Anthony Stewart,14,80,39,C,2010
1839,11,27,Anthony Stewart,9,77,20,C,2011
1840,7,23,Antoine Roussel,7,39,14,C,2012
1841,15,24,Antoine Roussel,14,81,29,LW,2013
1842,12,25,Antoine Roussel,13,80,25,LW,2014
1843,16,26,Antoine Roussel,13,80,29,LW,2015
1844,15,27,Antoine Roussel,12,60,27,LW,2016
1845,12,28,Antoine Roussel,5,73,17,LW,2017
1846,7,21,Antoine Vermette,7,57,14,LW,2003
1847,12,23,Antoine Vermette,21,82,33,C,2005
1848,20,24,Antoine Vermette,19,77,39,C,2006
1849,29,25,Antoine Vermette,24,81,53,LW,2007
1850,25,26,Antoine Vermette,16,79,41,C,2008
1851,38,27,Antoine Vermette,27,82,65,C,2009
1852,28,28,Antoine Vermette,19,82,47,C,2010
1853,26,29,Antoine Vermette,11,82,37,C,2011
1854,8,30,Antoine Vermette,13,48,21,C,2012
1855,21,31,Antoine Vermette,24,82,45,C,2013
1856,25,32,Antoine Vermette,13,82,38,C,2014
1857,21,33,Antoine Vermette,17,76,38,C,2015
1858,19,34,Antoine Vermette,9,72,28,C,2016
1859,8,35,Antoine Vermette,8,64,16,C,2017
1860,2,19,Anton Babchuk,0,5,2,D,2003
1861,5,21,Anton Babchuk,5,39,10,D,2005
1862,12,22,Anton Babchuk,2,52,14,D,2006
1863,19,24,Anton Babchuk,16,72,35,D,2008
1864,24,26,Anton Babchuk,11,82,35,D,2010
1865,8,27,Anton Babchuk,2,32,10,D,2011
1866,1,28,Anton Babchuk,0,7,1,D,2012
1867,6,27,Anton Belov,1,57,7,D,2013
1868,1,21,Anton Blidh,1,19,2,LW,2016
1869,0,22,Anton Blidh,0,1,0,LW,2017
1870,0,19,Anton Klementyev,0,1,0,D,2009
1871,4,20,Anton Lander,2,56,6,C,2011
1872,1,21,Anton Lander,0,11,1,C,2012
1873,1,22,Anton Lander,0,27,1,C,2013
1874,14,23,Anton Lander,6,38,20,C,2014
1875,2,24,Anton Lander,1,61,3,C,2015
1876,3,25,Anton Lander,1,22,4,C,2016
1877,0,22,Anton Lindholm,0,12,0,D,2016
1878,4,23,Anton Lindholm,0,48,4,D,2017
1879,1,26,Anton Rodin,0,3,1,RW,2016
1880,1,21,Anton Slepyshev,0,11,1,RW,2015
1881,6,22,Anton Slepyshev,4,41,10,LW,2016
1882,6,23,Anton Slepyshev,6,50,12,LW,2017
1883,46,21,Anton Stastny,39,80,85,LW,1980
1884,46,22,Anton Stastny,26,68,72,LW,1981
1885,60,23,Anton Stastny,32,79,92,LW,1982
1886,37,24,Anton Stastny,25,69,62,LW,1983
1887,42,25,Anton Stastny,38,79,80,RW,1984
1888,43,26,Anton Stastny,31,74,74,RW,1985
1889,35,27,Anton Stastny,27,77,62,RW,1986
1890,45,28,Anton Stastny,27,69,72,RW,1987
1891,30,29,Anton Stastny,7,55,37,LW,1988
1892,6,21,Anton Stralman,3,50,9,D,2007
1893,12,22,Anton Stralman,1,38,13,D,2008
1894,28,23,Anton Stralman,6,73,34,D,2009
1895,17,24,Anton Stralman,1,51,18,D,2010
1896,16,25,Anton Stralman,2,53,18,D,2011
1897,3,26,Anton Stralman,4,48,7,D,2012
1898,12,27,Anton Stralman,1,81,13,D,2013
1899,30,28,Anton Stralman,9,82,39,D,2014
1900,25,29,Anton Stralman,9,73,34,D,2015
1901,17,30,Anton Stralman,5,73,22,D,2016
1902,14,31,Anton Stralman,4,80,18,D,2017
1903,13,20,Anton Volchenkov,3,57,16,D,2002
1904,2,21,Anton Volchenkov,1,19,3,D,2003
1905,13,23,Anton Volchenkov,4,75,17,D,2005
1906,18,24,Anton Volchenkov,1,78,19,D,2006
1907,14,25,Anton Volchenkov,1,67,15,D,2007
1908,8,26,Anton Volchenkov,2,68,10,D,2008
1909,10,27,Anton Volchenkov,4,64,14,D,2009
1910,8,28,Anton Volchenkov,0,57,8,D,2010
1911,9,29,Anton Volchenkov,2,72,11,D,2011
1912,4,30,Anton Volchenkov,1,37,5,D,2012
1913,8,31,Anton Volchenkov,0,56,8,D,2013
1914,7,32,Anton Volchenkov,0,46,7,D,2014
1915,0,22,Antti Aalto,0,3,0,C,1997
1916,5,23,Antti Aalto,3,73,8,C,1998
1917,11,24,Antti Aalto,7,63,18,C,1999
1918,1,25,Antti Aalto,1,12,2,C,2000
1919,2,25,Antti Laaksonen,1,11,3,LW,1998
1920,3,26,Antti Laaksonen,6,27,9,LW,1999
1921,16,27,Antti Laaksonen,12,82,28,LW,2000
1922,17,28,Antti Laaksonen,16,82,33,LW,2001
1923,16,29,Antti Laaksonen,15,82,31,LW,2002
1924,14,30,Antti Laaksonen,12,77,26,LW,2003
1925,18,32,Antti Laaksonen,16,81,34,LW,2005
1926,1,33,Antti Laaksonen,3,41,4,LW,2006
1927,0,23,Antti Miettinen,1,16,1,C,2003
1928,20,25,Antti Miettinen,11,79,31,LW,2005
1929,14,26,Antti Miettinen,11,74,25,RW,2006
1930,19,27,Antti Miettinen,15,69,34,RW,2007
1931,29,28,Antti Miettinen,15,82,44,RW,2008
1932,22,29,Antti Miettinen,20,79,42,RW,2009
1933,19,30,Antti Miettinen,16,73,35,RW,2010
1934,8,31,Antti Miettinen,5,45,13,RW,2011
1935,2,32,Antti Miettinen,3,22,5,RW,2012
1936,0,23,Antti Pihlstrom,0,1,0,LW,2007
1937,5,24,Antti Pihlstrom,2,53,7,LW,2008
1938,8,25,Antti Tormanen,7,50,15,RW,1995
1939,1,23,Antti-Jussi Niemi,1,28,2,D,2000
1940,0,24,Antti-Jussi Niemi,0,1,0,D,2001
1941,41,19,Anze Kopitar,20,72,61,C,2006
1942,45,20,Anze Kopitar,32,82,77,C,2007
1943,39,21,Anze Kopitar,27,82,66,C,2008
1944,47,22,Anze Kopitar,34,82,81,C,2009
1945,48,23,Anze Kopitar,25,75,73,C,2010
1946,51,24,Anze Kopitar,25,82,76,C,2011
1947,32,25,Anze Kopitar,10,47,42,C,2012
1948,41,26,Anze Kopitar,29,82,70,C,2013
1949,48,27,Anze Kopitar,16,79,64,C,2014
1950,49,28,Anze Kopitar,25,81,74,C,2015
1951,40,29,Anze Kopitar,12,76,52,C,2016
1952,57,30,Anze Kopitar,35,82,92,C,2017
1953,0,23,Archie Henderson,1,7,1,RW,1980
1954,0,24,Archie Henderson,0,1,0,RW,1981
1955,1,25,Archie Henderson,2,15,3,RW,1982
1956,7,20,Ari Haanpaa,0,18,7,RW,1985
1957,4,21,Ari Haanpaa,6,41,10,RW,1986
1958,0,22,Ari Haanpaa,0,1,0,RW,1987
1959,0,21,Aris Brimanis,0,1,0,D,1993
1960,2,23,Aris Brimanis,0,17,2,D,1995
1961,1,24,Aris Brimanis,0,3,1,D,1996
1962,1,27,Aris Brimanis,2,18,3,D,1999
1963,8,28,Aris Brimanis,0,56,8,D,2000
1964,0,29,Aris Brimanis,0,5,0,D,2001
1965,0,31,Aris Brimanis,0,13,0,D,2003
1966,25,26,Arnie Brown,1,74,26,D,1967
1967,12,27,Arnie Brown,10,74,22,D,1968
1968,21,28,Arnie Brown,15,73,36,D,1969
1969,18,29,Arnie Brown,5,75,23,D,1970
1970,23,30,Arnie Brown,2,77,25,D,1971
1971,8,31,Arnie Brown,5,63,13,D,1972
1972,6,32,Arnie Brown,2,48,8,D,1973
1973,5,33,Arnie Brown,3,60,8,D,1974
1974,5,33,Arnie Brown,3,60,8,D,1974
1975,0,20,Arron Asham,0,7,0,RW,1998
1976,2,21,Arron Asham,4,33,6,RW,1999
1977,3,22,Arron Asham,2,46,5,RW,2000
1978,4,23,Arron Asham,5,35,9,RW,2001
1979,19,24,Arron Asham,15,78,34,RW,2002
1980,12,25,Arron Asham,12,79,24,LW,2003
1981,15,27,Arron Asham,9,63,24,RW,2005
1982,12,28,Arron Asham,11,80,23,RW,2006
1983,4,29,Arron Asham,6,77,10,RW,2007
1984,12,30,Arron Asham,8,78,20,RW,2008
1985,14,31,Arron Asham,10,72,24,RW,2009
1986,6,32,Arron Asham,5,44,11,RW,2010
1987,11,33,Arron Asham,5,64,16,RW,2011
1988,0,34,Arron Asham,2,27,2,RW,2012
1989,0,35,Arron Asham,0,6,0,RW,2013
1990,25,32,Art Stratton,16,70,41,C,1967
1991,0,20,Artem Anisimov,0,1,0,C,2008
1992,16,21,Artem Anisimov,12,82,28,C,2009
1993,26,22,Artem Anisimov,18,82,44,C,2010
1994,20,23,Artem Anisimov,16,79,36,C,2011
1995,7,24,Artem Anisimov,11,35,18,C,2012
1996,17,25,Artem Anisimov,22,81,39,C,2013
1997,20,26,Artem Anisimov,7,52,27,C,2014
1998,22,27,Artem Anisimov,20,77,42,C,2015
1999,23,28,Artem Anisimov,22,64,45,C,2016
2000,11,29,Artem Anisimov,20,72,31,C,2017
2001,8,20,Artem Chubarov,1,49,9,C,1999
2002,0,21,Artem Chubarov,0,1,0,C,2000
2003,5,22,Artem Chubarov,5,51,10,C,2001
2004,13,23,Artem Chubarov,7,62,20,C,2002
2005,7,24,Artem Chubarov,12,65,19,C,2003
2006,47,24,Artemi Panarin,30,80,77,LW,2015
2007,43,25,Artemi Panarin,31,82,74,LW,2016
2008,55,26,Artemi Panarin,27,81,82,LW,2017
2009,2,28,Arto Blomsten,0,18,2,D,1993
2010,1,29,Arto Blomsten,0,5,1,D,1994
2011,1,30,Arto Blomsten,0,2,1,D,1995
2012,1,25,Arto Javanainen,4,14,5,LW,1984
2013,10,21,Artturi Lehkonen,18,73,28,LW,2016
2014,9,22,Artturi Lehkonen,12,66,21,LW,2017
2015,2,21,Arturs Kulda,0,4,2,D,2009
2016,0,22,Arturs Kulda,0,2,0,D,2010
2017,0,23,Arturs Kulda,0,9,0,D,2011
2018,2,23,Ashton Sautner,0,5,2,D,2017
2019,8,24,Austin Czarnik,5,49,13,C,2016
2020,4,25,Austin Czarnik,0,10,4,C,2017
2021,0,21,Austin Watson,1,6,1,RW,2012
2022,7,24,Austin Watson,3,57,10,LW,2015
2023,12,25,Austin Watson,5,77,17,LW,2016
2024,5,26,Austin Watson,14,76,19,LW,2017
2025,29,19,Auston Matthews,40,82,69,C,2016
2026,29,20,Auston Matthews,34,62,63,C,2017
2027,11,30,Aut Erickson,4,65,15,D,1967
2028,0,32,Aut Erickson,0,1,0,D,1969
2029,2,22,B.J. Crombeen,0,8,2,RW,2007
2030,10,23,B.J. Crombeen,12,81,22,RW,2008
2031,8,24,B.J. Crombeen,7,79,15,RW,2009
2032,7,25,B.J. Crombeen,7,80,14,RW,2010
2033,2,26,B.J. Crombeen,1,40,3,RW,2011
2034,7,27,B.J. Crombeen,1,44,8,RW,2012
2035,7,28,B.J. Crombeen,3,55,10,RW,2013
2036,3,29,B.J. Crombeen,3,58,6,RW,2014
2037,0,22,B.J. Young,0,1,0,RW,1999
2038,8,21,Barclay Goodrow,4,60,12,RW,2014
2039,3,22,Barclay Goodrow,0,14,3,RW,2015
2040,1,23,Barclay Goodrow,0,3,1,RW,2016
2041,7,24,Barclay Goodrow,7,47,14,RW,2017
2042,15,26,Barclay Plager,5,49,20,D,1967
2043,26,27,Barclay Plager,4,61,30,D,1968
2044,26,28,Barclay Plager,6,75,32,D,1969
2045,20,29,Barclay Plager,4,69,24,D,1970
2046,22,30,Barclay Plager,7,78,29,D,1971
2047,25,31,Barclay Plager,8,68,33,D,1972
2048,20,32,Barclay Plager,6,72,26,D,1973
2049,24,33,Barclay Plager,4,76,28,D,1974
2050,8,34,Barclay Plager,0,64,8,D,1975
2051,1,35,Barclay Plager,0,2,1,D,1976
2052,0,20,Barret Jackman,0,1,0,D,2001
2053,16,21,Barret Jackman,3,82,19,D,2002
2054,2,22,Barret Jackman,1,15,3,D,2003
2055,6,24,Barret Jackman,4,63,10,D,2005
2056,24,25,Barret Jackman,3,70,27,D,2006
2057,14,26,Barret Jackman,2,78,16,D,2007
2058,17,27,Barret Jackman,4,82,21,D,2008
2059,15,28,Barret Jackman,2,66,17,D,2009
2060,13,29,Barret Jackman,0,60,13,D,2010
2061,12,30,Barret Jackman,1,81,13,D,2011
2062,9,31,Barret Jackman,3,46,12,D,2012
2063,12,32,Barret Jackman,3,79,15,D,2013
2064,13,33,Barret Jackman,2,80,15,D,2014
2065,4,34,Barret Jackman,1,73,5,D,2015
2066,0,21,Barrett Heisten,0,10,0,C,2001
2067,0,21,Barrie Meissner,0,1,0,LW,1967
2068,1,22,Barrie Meissner,0,5,1,LW,1968
2069,0,20,Barrie Moore,0,3,0,LW,1995
2070,6,21,Barrie Moore,2,35,8,LW,1996
2071,0,24,Barrie Moore,0,1,0,LW,1999
2072,23,31,Barry Ashbee,4,64,27,D,1970
2073,14,32,Barry Ashbee,6,73,20,D,1971
2074,17,33,Barry Ashbee,1,64,18,D,1972
2075,13,34,Barry Ashbee,4,69,17,D,1973
2076,38,20,Barry Beck,22,75,60,D,1977
2077,28,21,Barry Beck,14,63,42,D,1978
2078,50,22,Barry Beck,15,71,65,D,1979
2079,23,23,Barry Beck,11,75,34,D,1980
2080,29,24,Barry Beck,9,60,38,D,1981
2081,22,25,Barry Beck,12,66,34,D,1982
2082,27,26,Barry Beck,9,72,36,D,1983
2083,19,27,Barry Beck,7,56,26,D,1984
2084,8,28,Barry Beck,4,25,12,D,1985
2085,7,32,Barry Beck,1,52,8,D,1989
2086,0,22,Barry Boughner,0,4,0,LW,1969
2087,0,23,Barry Boughner,0,16,0,LW,1970
2088,2,25,Barry Cummins,1,36,3,D,1973
2089,25,20,Barry Dean,9,71,34,LW,1975
2090,25,20,Barry Dean,9,71,34,LW,1975
2091,25,21,Barry Dean,14,79,39,LW,1976
2092,18,22,Barry Dean,7,56,25,LW,1977
2093,13,23,Barry Dean,4,30,17,LW,1978
2094,0,19,Barry Gibbs,0,16,0,D,1967
2095,0,20,Barry Gibbs,0,8,0,D,1968
2096,13,21,Barry Gibbs,3,56,16,D,1969
2097,15,22,Barry Gibbs,5,68,20,D,1970
2098,20,23,Barry Gibbs,4,75,24,D,1971
2099,24,24,Barry Gibbs,10,63,34,D,1972
2100,29,25,Barry Gibbs,9,76,38,D,1973
2101,33,26,Barry Gibbs,7,76,40,D,1974
2102,21,27,Barry Gibbs,8,76,29,D,1975
2103,16,28,Barry Gibbs,1,66,17,D,1976
2104,17,29,Barry Gibbs,7,78,24,D,1977
2105,27,30,Barry Gibbs,2,76,29,D,1978
2106,9,31,Barry Gibbs,2,63,11,D,1979
2107,18,20,Barry Legge,3,36,21,D,1974
2108,18,20,Barry Legge,3,36,21,D,1974
2109,15,21,Barry Legge,6,75,21,D,1975
2110,15,21,Barry Legge,6,75,21,D,1975
2111,22,22,Barry Legge,7,76,29,D,1976
2112,22,22,Barry Legge,7,76,29,D,1976
2113,17,23,Barry Legge,7,78,24,D,1977
2114,17,23,Barry Legge,7,78,24,D,1977
2115,8,24,Barry Legge,3,80,11,D,1978
2116,8,24,Barry Legge,3,80,11,D,1978
2117,3,25,Barry Legge,0,31,3,D,1979
2118,6,26,Barry Legge,0,38,6,D,1980
2119,2,27,Barry Legge,1,38,3,D,1981
2120,13,24,Barry Long,2,70,15,D,1972
2121,19,25,Barry Long,3,60,22,D,1973
2122,40,26,Barry Long,20,78,60,D,1974
2123,40,26,Barry Long,20,78,60,D,1974
2124,32,27,Barry Long,10,78,42,D,1975
2125,32,27,Barry Long,10,78,42,D,1975
2126,39,28,Barry Long,9,73,48,D,1976
2127,39,28,Barry Long,9,73,48,D,1976
2128,24,29,Barry Long,7,78,31,D,1977
2129,24,29,Barry Long,7,78,31,D,1977
2130,36,30,Barry Long,5,80,41,D,1978
2131,36,30,Barry Long,5,80,41,D,1978
2132,17,31,Barry Long,0,80,17,D,1979
2133,17,32,Barry Long,6,65,23,D,1980
2134,2,33,Barry Long,0,5,2,D,1981
2135,1,27,Barry MacKenzie,0,6,1,D,1968
2136,4,20,Barry Melrose,1,29,5,D,1976
2137,9,21,Barry Melrose,2,69,11,D,1977
2138,9,21,Barry Melrose,2,69,11,D,1977
2139,14,22,Barry Melrose,2,80,16,D,1978
2140,14,22,Barry Melrose,2,80,16,D,1978
2141,6,23,Barry Melrose,4,74,10,D,1979
2142,6,24,Barry Melrose,3,75,9,D,1980
2143,5,25,Barry Melrose,1,64,6,D,1981
2144,5,26,Barry Melrose,2,52,7,D,1982
2145,1,27,Barry Melrose,0,21,1,D,1983
2146,0,29,Barry Melrose,0,14,0,D,1985
2147,3,31,Barry Merrell,1,10,4,C,1976
2148,0,25,Barry Nieckar,0,2,0,LW,1992
2149,0,27,Barry Nieckar,0,3,0,LW,1994
2150,0,29,Barry Nieckar,0,2,0,LW,1996
2151,0,30,Barry Nieckar,0,1,0,LW,1997
2152,4,19,Barry Pederson,1,9,5,C,1980
2153,48,20,Barry Pederson,44,80,92,C,1981
2154,61,21,Barry Pederson,46,77,107,C,1982
2155,77,22,Barry Pederson,39,80,116,C,1983
2156,8,23,Barry Pederson,4,22,12,C,1984
2157,47,24,Barry Pederson,29,79,76,C,1985
2158,52,25,Barry Pederson,24,79,76,C,1986
2159,52,26,Barry Pederson,19,76,71,C,1987
2160,26,27,Barry Pederson,15,62,41,C,1988
2161,25,28,Barry Pederson,6,54,31,C,1989
2162,8,29,Barry Pederson,6,46,14,C,1990
2163,8,30,Barry Pederson,5,37,13,C,1991
2164,2,23,Barry Potomski,3,33,5,LW,1995
2165,2,24,Barry Potomski,3,26,5,LW,1996
2166,1,25,Barry Potomski,0,9,1,LW,1997
2167,1,25,Barry Richter,0,4,1,D,1995
2168,13,26,Barry Richter,5,50,18,D,1996
2169,18,28,Barry Richter,6,72,24,D,1998
2170,2,29,Barry Richter,0,23,2,D,1999
2171,0,30,Barry Richter,0,2,0,D,2000
2172,2,27,Barry Salovaara,0,27,2,D,1974
2173,11,28,Barry Salovaara,2,63,13,D,1975
2174,0,20,Barry Smith,1,19,1,C,1975
2175,3,24,Barry Smith,2,33,5,C,1979
2176,4,25,Barry Smith,4,62,8,C,1980
2177,1,22,Barry Tallackson,1,10,2,RW,2005
2178,0,23,Barry Tallackson,0,3,0,RW,2006
2179,0,24,Barry Tallackson,0,3,0,RW,2007
2180,0,25,Barry Tallackson,0,4,0,RW,2008
2181,2,24,Barry Wilcox,3,31,5,RW,1972
2182,0,26,Barry Wilcox,0,2,0,RW,1974
2183,0,21,Barry Wilkins,1,1,1,D,1968
2184,0,22,Barry Wilkins,0,6,0,D,1969
2185,18,23,Barry Wilkins,5,70,23,D,1970
2186,5,24,Barry Wilkins,2,45,7,D,1971
2187,17,25,Barry Wilkins,11,76,28,D,1972
2188,28,26,Barry Wilkins,3,78,31,D,1973
2189,30,27,Barry Wilkins,5,66,35,D,1974
2190,27,28,Barry Wilkins,0,75,27,D,1975
2191,24,29,Barry Wilkins,4,51,28,D,1976
2192,24,29,Barry Wilkins,4,51,28,D,1976
2193,21,30,Barry Wilkins,2,79,23,D,1977
2194,21,30,Barry Wilkins,2,79,23,D,1977
2195,14,21,Bart Crashley,2,57,16,D,1967
2196,0,22,Bart Crashley,0,1,0,D,1968
2197,27,26,Bart Crashley,18,70,45,D,1972
2198,27,26,Bart Crashley,18,70,45,D,1972
2199,26,27,Bart Crashley,4,78,30,D,1973
2200,26,27,Bart Crashley,4,78,30,D,1973
2201,21,28,Bart Crashley,5,75,26,D,1974
2202,1,29,Bart Crashley,0,4,1,D,1975
2203,3,21,Basil McRae,4,20,7,LW,1981
2204,1,22,Basil McRae,1,22,2,LW,1982
2205,0,23,Basil McRae,0,3,0,LW,1983
2206,0,24,Basil McRae,0,1,0,LW,1984
2207,0,25,Basil McRae,0,4,0,LW,1985
2208,7,26,Basil McRae,11,69,18,LW,1986
2209,11,27,Basil McRae,5,80,16,LW,1987
2210,19,28,Basil McRae,12,78,31,LW,1988
2211,17,29,Basil McRae,9,66,26,LW,1989
2212,3,30,Basil McRae,1,40,4,LW,1990
2213,8,31,Basil McRae,5,59,13,LW,1991
2214,6,32,Basil McRae,3,47,9,LW,1992
2215,2,33,Basil McRae,1,40,3,LW,1993
2216,5,34,Basil McRae,0,21,5,LW,1994
2217,1,35,Basil McRae,1,18,2,LW,1995
2218,0,36,Basil McRae,0,8,0,LW,1996
2219,4,22,Bates Battaglia,2,33,6,C,1997
2220,11,23,Bates Battaglia,7,60,18,LW,1998
2221,18,24,Bates Battaglia,16,77,34,LW,1999
2222,15,25,Bates Battaglia,12,80,27,LW,2000
2223,25,26,Bates Battaglia,21,82,46,LW,2001
2224,19,27,Bates Battaglia,6,83,25,LW,2002
2225,7,28,Bates Battaglia,4,70,11,LW,2003
2226,19,31,Bates Battaglia,12,82,31,LW,2006
2227,0,32,Bates Battaglia,0,13,0,LW,2007
2228,11,21,Beau Bennett,3,26,14,RW,2012
2229,4,22,Beau Bennett,3,21,7,RW,2013
2230,8,23,Beau Bennett,4,49,12,RW,2014
2231,6,24,Beau Bennett,6,33,12,RW,2015
2232,11,25,Beau Bennett,8,65,19,RW,2016
2233,0,26,Beau Bennett,0,6,0,RW,2017
2234,3,28,Bedrick Brunclik,2,6,5,RW,1978
2235,3,28,Bedrick Brunclik,2,6,5,RW,1978
2236,36,20,Behn Wilson,13,80,49,D,1978
2237,25,21,Behn Wilson,9,61,34,D,1979
2238,47,22,Behn Wilson,16,77,63,D,1980
2239,23,23,Behn Wilson,13,59,36,D,1981
2240,24,24,Behn Wilson,8,62,32,D,1982
2241,22,25,Behn Wilson,10,59,32,D,1983
2242,23,26,Behn Wilson,10,76,33,D,1984
2243,37,27,Behn Wilson,13,69,50,D,1985
2244,23,29,Behn Wilson,6,58,29,D,1987
2245,0,22,Ben Chiarot,0,1,0,D,2013
2246,6,23,Ben Chiarot,2,40,8,D,2014
2247,9,24,Ben Chiarot,1,70,10,D,2015
2248,10,25,Ben Chiarot,2,59,12,D,2016
2249,12,26,Ben Chiarot,2,57,14,D,2017
2250,6,21,Ben Clymer,2,60,8,D,1999
2251,1,22,Ben Clymer,5,23,6,D,2000
2252,20,23,Ben Clymer,14,81,34,RW,2001
2253,12,24,Ben Clymer,6,65,18,RW,2002
2254,8,25,Ben Clymer,2,66,10,RW,2003
2255,17,27,Ben Clymer,16,77,33,RW,2005
2256,13,28,Ben Clymer,7,66,20,D,2006
2257,5,22,Ben Eager,3,25,8,LW,2005
2258,5,23,Ben Eager,6,63,11,LW,2006
2259,2,24,Ben Eager,0,32,2,LW,2007
2260,4,25,Ben Eager,11,75,15,LW,2008
2261,9,26,Ben Eager,7,60,16,LW,2009
2262,10,27,Ben Eager,7,68,17,LW,2010
2263,5,28,Ben Eager,8,63,13,LW,2011
2264,1,29,Ben Eager,1,14,2,LW,2012
2265,1,30,Ben Eager,0,7,1,LW,2013
2266,0,27,Ben Guite,0,1,0,RW,2005
2267,8,28,Ben Guite,3,39,11,RW,2006
2268,11,29,Ben Guite,11,79,22,RW,2007
2269,7,30,Ben Guite,5,50,12,RW,2008
2270,0,31,Ben Guite,0,6,0,C,2009
2271,1,23,Ben Hankinson,2,4,3,RW,1992
2272,0,24,Ben Hankinson,1,13,1,RW,1993
2273,2,25,Ben Hankinson,0,26,2,RW,1994
2274,0,22,Ben Hanowski,1,5,1,LW,2012
2275,2,23,Ben Hanowski,0,11,2,RW,2013
2276,1,21,Ben Harpur,0,5,1,D,2015
2277,0,22,Ben Harpur,0,6,0,D,2016
2278,1,23,Ben Harpur,0,41,1,D,2017
2279,0,23,Ben Holmstrom,0,2,0,C,2010
2280,0,24,Ben Holmstrom,0,5,0,C,2011
2281,24,22,Ben Hutton,1,75,25,D,2015
2282,14,23,Ben Hutton,5,71,19,D,2016
2283,6,24,Ben Hutton,0,61,6,D,2017
2284,0,24,Ben Lovejoy,0,2,0,D,2008
2285,3,25,Ben Lovejoy,0,12,3,D,2009
2286,14,26,Ben Lovejoy,3,47,17,D,2010
2287,4,27,Ben Lovejoy,1,34,5,D,2011
2288,10,28,Ben Lovejoy,0,35,10,D,2012
2289,13,29,Ben Lovejoy,5,78,18,D,2013
2290,12,30,Ben Lovejoy,2,60,14,D,2014
2291,6,31,Ben Lovejoy,4,66,10,D,2015
2292,6,32,Ben Lovejoy,1,82,7,D,2016
2293,6,33,Ben Lovejoy,2,57,8,D,2017
2294,0,20,Ben Maxwell,0,7,0,C,2008
2295,0,21,Ben Maxwell,0,13,0,C,2009
2296,1,22,Ben Maxwell,1,12,2,C,2010
2297,5,23,Ben Maxwell,1,15,6,C,2011
2298,0,23,Ben Ondrus,0,22,0,LW,2005
2299,2,24,Ben Ondrus,0,16,2,RW,2006
2300,0,25,Ben Ondrus,0,3,0,RW,2007
2301,0,26,Ben Ondrus,0,11,0,RW,2008
2302,0,26,Ben Sexton,0,2,0,C,2017
2303,0,23,Ben Simon,0,6,0,C,2001
2304,1,24,Ben Simon,0,10,1,LW,2002
2305,0,25,Ben Simon,3,52,3,C,2003
2306,0,27,Ben Simon,0,13,0,C,2005
2307,0,22,Ben Smith,1,6,1,RW,2010
2308,0,23,Ben Smith,2,13,2,RW,2011
2309,0,24,Ben Smith,1,1,1,RW,2012
2310,12,25,Ben Smith,14,75,26,RW,2013
2311,7,26,Ben Smith,7,80,14,RW,2014
2312,4,27,Ben Smith,2,22,6,RW,2015
2313,0,28,Ben Smith,0,4,0,RW,2016
2314,1,25,Ben Street,0,6,1,C,2012
2315,1,26,Ben Street,0,13,1,C,2013
2316,0,27,Ben Street,0,3,0,C,2014
2317,0,28,Ben Street,0,7,0,C,2015
2318,1,29,Ben Street,0,6,1,C,2016
2319,0,24,Ben Thomson,0,3,0,LW,2016
2320,0,21,Ben Walter,0,6,0,C,2005
2321,0,22,Ben Walter,0,4,0,C,2006
2322,0,23,Ben Walter,1,8,1,C,2007
2323,0,24,Ben Walter,0,4,0,C,2008
2324,0,25,Ben Walter,0,2,0,C,2009
2325,30,26,Bengt Lundholm,14,66,44,LW,1981
2326,28,27,Bengt Lundholm,14,58,42,LW,1982
2327,14,28,Bengt Lundholm,5,57,19,LW,1983
2328,18,29,Bengt Lundholm,12,78,30,LW,1984
2329,5,30,Bengt Lundholm,3,16,8,RW,1985
2330,38,21,Bengt-Ake Gustafsson,22,80,60,C,1979
2331,34,22,Bengt-Ake Gustafsson,21,72,55,RW,1980
2332,34,23,Bengt-Ake Gustafsson,26,70,60,RW,1981
2333,42,24,Bengt-Ake Gustafsson,22,67,64,RW,1982
2334,43,25,Bengt-Ake Gustafsson,32,69,75,RW,1983
2335,29,26,Bengt-Ake Gustafsson,14,51,43,LW,1984
2336,52,27,Bengt-Ake Gustafsson,23,70,75,C,1985
2337,36,29,Bengt-Ake Gustafsson,18,78,54,C,1987
2338,51,30,Bengt-Ake Gustafsson,18,72,69,RW,1988
2339,3,22,Benn Ferriero,2,24,5,C,2009
2340,4,23,Benn Ferriero,5,33,9,C,2010
2341,1,24,Benn Ferriero,7,35,8,C,2011
2342,1,25,Benn Ferriero,0,4,1,C,2012
2343,0,26,Benn Ferriero,0,2,0,RW,2013
2344,1,21,Bennett Wolf,0,24,1,D,1980
2345,0,22,Bennett Wolf,0,1,0,D,1981
2346,0,23,Bennett Wolf,0,5,0,D,1982
2347,1,20,Benoit Brunet,0,2,1,LW,1988
2348,3,22,Benoit Brunet,1,17,4,LW,1990
2349,6,23,Benoit Brunet,4,18,10,LW,1991
2350,15,24,Benoit Brunet,10,47,25,LW,1992
2351,20,25,Benoit Brunet,10,71,30,LW,1993
2352,18,26,Benoit Brunet,7,45,25,LW,1994
2353,8,27,Benoit Brunet,7,26,15,LW,1995
2354,13,28,Benoit Brunet,10,39,23,LW,1996
2355,20,29,Benoit Brunet,12,68,32,LW,1997
2356,17,30,Benoit Brunet,14,60,31,LW,1998
2357,15,31,Benoit Brunet,14,50,29,LW,1999
2358,11,32,Benoit Brunet,3,35,14,RW,2000
2359,14,33,Benoit Brunet,9,61,23,LW,2001
2360,0,24,Benoit Dusablon,0,3,0,C,2003
2361,0,20,Benoit Gosselin,0,7,0,LW,1977
2362,1,21,Benoit Gratton,0,6,1,C,1997
2363,3,22,Benoit Gratton,4,16,7,LW,1998
2364,2,23,Benoit Gratton,0,10,2,LW,1999
2365,3,24,Benoit Gratton,1,14,4,LW,2000
2366,0,25,Benoit Gratton,1,8,1,C,2001
2367,1,27,Benoit Gratton,0,4,1,C,2003
2368,1,21,Benoit Hogue,1,3,2,C,1987
2369,30,22,Benoit Hogue,14,69,44,LW,1988
2370,7,23,Benoit Hogue,11,45,18,C,1989
2371,28,24,Benoit Hogue,19,76,47,LW,1990
2372,46,25,Benoit Hogue,30,75,76,LW,1991
2373,42,26,Benoit Hogue,33,70,75,C,1992
2374,33,27,Benoit Hogue,36,83,69,LW,1993
2375,7,28,Benoit Hogue,9,45,16,LW,1994
2376,45,29,Benoit Hogue,19,78,64,LW,1995
2377,24,30,Benoit Hogue,19,73,43,LW,1996
2378,16,31,Benoit Hogue,6,53,22,LW,1997
2379,17,32,Benoit Hogue,12,74,29,C,1998
2380,10,33,Benoit Hogue,3,27,13,LW,1999
2381,7,34,Benoit Hogue,3,34,10,LW,2000
2382,8,35,Benoit Hogue,7,58,15,LW,2001
2383,0,20,Benoit Pouliot,0,3,0,LW,2006
2384,1,21,Benoit Pouliot,2,11,3,LW,2007
2385,6,22,Benoit Pouliot,5,37,11,LW,2008
2386,11,23,Benoit Pouliot,17,53,28,LW,2009
2387,17,24,Benoit Pouliot,13,79,30,LW,2010
2388,16,25,Benoit Pouliot,16,74,32,LW,2011
2389,12,26,Benoit Pouliot,8,34,20,LW,2012
2390,21,27,Benoit Pouliot,15,80,36,LW,2013
2391,15,28,Benoit Pouliot,19,58,34,LW,2014
2392,22,29,Benoit Pouliot,14,55,36,LW,2015
2393,6,30,Benoit Pouliot,8,67,14,LW,2016
2394,6,31,Benoit Pouliot,13,74,19,LW,2017
2395,7,25,Bernie Blanchette,7,47,14,RW,1972
2396,7,25,Bernie Blanchette,7,47,14,RW,1972
2397,9,20,Bernie Federko,14,31,23,C,1976
2398,24,21,Bernie Federko,17,72,41,C,1977
2399,64,22,Bernie Federko,31,74,95,C,1978
2400,56,23,Bernie Federko,38,79,94,C,1979
2401,73,24,Bernie Federko,31,78,104,C,1980
2402,62,25,Bernie Federko,30,74,92,C,1981
2403,60,26,Bernie Federko,24,75,84,C,1982
2404,66,27,Bernie Federko,41,79,107,C,1983
2405,73,28,Bernie Federko,30,76,103,C,1984
2406,68,29,Bernie Federko,34,80,102,C,1985
2407,52,30,Bernie Federko,20,64,72,C,1986
2408,69,31,Bernie Federko,20,79,89,C,1987
2409,45,32,Bernie Federko,22,66,67,C,1988
2410,40,33,Bernie Federko,17,73,57,C,1989
2411,16,36,Bernie Geoffrion,5,59,21,RW,1967
2412,13,23,Bernie Johnston,8,32,21,C,1979
2413,11,24,Bernie Johnston,4,25,15,C,1980
2414,10,21,Bernie Lukowich,9,53,19,RW,1973
2415,5,22,Bernie Lukowich,4,26,9,RW,1974
2416,2,23,Bernie Lukowich,5,15,7,RW,1975
2417,2,23,Bernie Lukowich,5,15,7,RW,1975
2418,1,24,Bernie Lukowich,0,6,1,RW,1976
2419,1,24,Bernie Lukowich,0,6,1,RW,1976
2420,7,22,Bernie MacNeil,4,42,11,LW,1972
2421,7,22,Bernie MacNeil,4,42,11,LW,1972
2422,0,23,Bernie MacNeil,0,4,0,LW,1973
2423,12,25,Bernie MacNeil,15,77,27,LW,1975
2424,12,25,Bernie MacNeil,15,77,27,LW,1975
2425,18,20,Bernie Nicholls,14,22,32,C,1981
2426,22,21,Bernie Nicholls,28,71,50,C,1982
2427,54,22,Bernie Nicholls,41,78,95,C,1983
2428,54,23,Bernie Nicholls,46,80,100,C,1984
2429,61,24,Bernie Nicholls,36,80,97,C,1985
2430,48,25,Bernie Nicholls,33,80,81,C,1986
2431,46,26,Bernie Nicholls,32,65,78,C,1987
2432,80,27,Bernie Nicholls,70,79,150,C,1988
2433,73,28,Bernie Nicholls,39,79,112,C,1989
2434,48,29,Bernie Nicholls,25,71,73,C,1990
2435,29,30,Bernie Nicholls,20,50,49,C,1991
2436,47,31,Bernie Nicholls,13,69,60,C,1992
2437,27,32,Bernie Nicholls,19,61,46,C,1993
2438,29,33,Bernie Nicholls,22,48,51,C,1994
2439,41,34,Bernie Nicholls,19,59,60,C,1995
2440,33,35,Bernie Nicholls,12,65,45,C,1996
2441,22,36,Bernie Nicholls,6,60,28,C,1997
2442,2,37,Bernie Nicholls,0,10,2,C,1998
2443,0,23,Bernie Saunders,0,4,0,LW,1979
2444,1,24,Bernie Saunders,0,6,1,LW,1980
2445,9,24,Bert Marshall,1,57,10,D,1967
2446,15,25,Bert Marshall,3,68,18,D,1968
2447,15,26,Bert Marshall,1,72,16,D,1969
2448,6,27,Bert Marshall,2,32,8,D,1970
2449,14,28,Bert Marshall,0,66,14,D,1971
2450,6,29,Bert Marshall,2,63,8,D,1972
2451,7,30,Bert Marshall,1,69,8,D,1973
2452,28,31,Bert Marshall,2,77,30,D,1974
2453,16,32,Bert Marshall,0,71,16,D,1975
2454,21,33,Bert Marshall,4,72,25,D,1976
2455,7,34,Bert Marshall,0,58,7,D,1977
2456,8,35,Bert Marshall,1,45,9,D,1978
2457,4,23,Bert Robertsson,2,30,6,LW,1997
2458,2,24,Bert Robertsson,2,39,4,D,1998
2459,4,25,Bert Robertsson,0,52,4,D,1999
2460,0,26,Bert Robertsson,0,2,0,D,2000
2461,1,24,Bert Wilson,1,5,2,LW,1973
2462,1,25,Bert Wilson,5,61,6,LW,1974
2463,3,26,Bert Wilson,2,58,5,LW,1975
2464,3,27,Bert Wilson,4,77,7,LW,1976
2465,16,28,Bert Wilson,7,79,23,LW,1977
2466,10,29,Bert Wilson,9,73,19,LW,1978
2467,3,30,Bert Wilson,4,75,7,LW,1979
2468,7,31,Bert Wilson,5,50,12,LW,1980
2469,1,24,Bill Armstrong,0,1,1,C,1990
2470,0,21,Bill Arnold,0,1,0,C,2013
2471,3,24,Bill Baker,0,24,3,D,1980
2472,8,25,Bill Baker,3,49,11,D,1981
2473,14,26,Bill Baker,4,70,18,D,1982
2474,34,20,Bill Barber,30,69,64,LW,1972
2475,35,21,Bill Barber,34,75,69,LW,1973
2476,37,22,Bill Barber,34,79,71,LW,1974
2477,62,23,Bill Barber,50,80,112,LW,1975
2478,35,24,Bill Barber,20,73,55,LW,1976
2479,31,25,Bill Barber,41,80,72,LW,1977
2480,46,26,Bill Barber,34,79,80,LW,1978
2481,32,27,Bill Barber,40,79,72,LW,1979
2482,42,28,Bill Barber,43,80,85,LW,1980
2483,44,29,Bill Barber,45,80,89,LW,1981
2484,33,30,Bill Barber,27,66,60,LW,1982
2485,32,31,Bill Barber,22,63,54,LW,1983
2486,4,25,Bill Bennett,1,7,5,LW,1978
2487,3,26,Bill Bennett,3,24,6,LW,1979
2488,2,21,Bill Berg,1,7,3,LW,1988
2489,14,23,Bill Berg,9,78,23,LW,1990
2490,9,24,Bill Berg,5,47,14,LW,1991
2491,11,25,Bill Berg,13,80,24,LW,1992
2492,11,26,Bill Berg,8,83,19,LW,1993
2493,1,27,Bill Berg,5,32,6,LW,1994
2494,2,28,Bill Berg,3,41,5,LW,1995
2495,6,29,Bill Berg,8,67,14,LW,1996
2496,9,30,Bill Berg,1,67,10,C,1997
2497,2,31,Bill Berg,2,44,4,LW,1998
2498,0,22,Bill Blackwood,0,3,0,D,1977
2499,0,22,Bill Blackwood,0,3,0,D,1977
2500,2,26,Bill Bowler,0,9,2,C,2000
2501,2,24,Bill Butters,2,24,4,D,1974
2502,19,25,Bill Butters,0,73,19,D,1975
2503,17,26,Bill Butters,1,75,18,D,1976
2504,17,26,Bill Butters,1,75,18,D,1976
2505,0,27,Bill Butters,1,23,1,D,1977
2506,13,27,Bill Butters,1,45,14,D,1977
2507,13,27,Bill Butters,1,45,14,D,1977
2508,4,28,Bill Butters,0,49,4,D,1978
2509,14,21,Bill Clement,9,49,23,C,1971
2510,14,22,Bill Clement,14,73,28,C,1972
2511,8,23,Bill Clement,9,39,17,C,1973
2512,16,24,Bill Clement,21,68,37,C,1974
2513,31,25,Bill Clement,23,77,54,C,1975
2514,26,26,Bill Clement,17,67,43,C,1976
2515,30,27,Bill Clement,20,70,50,C,1977
2516,23,28,Bill Clement,12,65,35,C,1978
2517,14,29,Bill Clement,7,64,21,C,1979
2518,20,30,Bill Clement,12,78,32,C,1980
2519,12,31,Bill Clement,4,69,16,C,1981
2520,11,24,Bill Collins,9,71,20,RW,1967
2521,10,25,Bill Collins,9,75,19,RW,1968
2522,9,26,Bill Collins,29,74,38,RW,1969
2523,18,27,Bill Collins,11,76,29,RW,1970
2524,25,28,Bill Collins,15,71,40,RW,1971
2525,21,29,Bill Collins,21,78,42,RW,1972
2526,17,30,Bill Collins,15,66,32,RW,1973
2527,15,31,Bill Collins,22,70,37,RW,1974
2528,4,32,Bill Collins,4,50,8,RW,1975
2529,15,33,Bill Collins,12,63,27,RW,1976
2530,9,34,Bill Collins,10,74,19,RW,1977
2531,0,23,Bill Davis,0,12,0,D,1977
2532,0,23,Bill Davis,0,12,0,D,1977
2533,2,24,Bill Davis,1,5,3,D,1978
2534,2,24,Bill Davis,1,5,3,D,1978
2535,4,20,Bill Derlago,4,9,8,C,1978
2536,27,21,Bill Derlago,16,77,43,C,1979
2537,39,22,Bill Derlago,35,80,74,C,1980
2538,50,23,Bill Derlago,34,75,84,C,1981
2539,24,24,Bill Derlago,13,58,37,C,1982
2540,20,25,Bill Derlago,40,79,60,C,1983
2541,31,26,Bill Derlago,31,62,62,C,1984
2542,21,27,Bill Derlago,10,67,31,C,1985
2543,11,28,Bill Derlago,6,48,17,C,1986
2544,9,20,Bill Evo,13,49,22,LW,1974
2545,9,20,Bill Evo,13,49,22,LW,1974
2546,9,21,Bill Evo,1,48,10,RW,1975
2547,9,21,Bill Evo,1,48,10,RW,1975
2548,0,22,Bill Fairbairn,0,1,0,RW,1968
2549,33,23,Bill Fairbairn,23,76,56,RW,1969
2550,23,24,Bill Fairbairn,7,56,30,RW,1970
2551,37,25,Bill Fairbairn,22,78,59,RW,1971
2552,33,26,Bill Fairbairn,30,78,63,RW,1972
2553,44,27,Bill Fairbairn,18,78,62,RW,1973
2554,37,28,Bill Fairbairn,24,80,61,RW,1974
2555,15,29,Bill Fairbairn,13,80,28,RW,1975
2556,22,30,Bill Fairbairn,10,60,32,RW,1976
2557,17,31,Bill Fairbairn,14,66,31,LW,1977
2558,0,32,Bill Fairbairn,1,5,1,LW,1978
2559,20,24,Bill Flett,26,73,46,RW,1967
2560,25,25,Bill Flett,24,72,49,RW,1968
2561,18,26,Bill Flett,14,69,32,RW,1969
2562,24,27,Bill Flett,13,64,37,RW,1970
2563,22,28,Bill Flett,18,76,40,RW,1971
2564,31,29,Bill Flett,43,69,74,RW,1972
2565,27,30,Bill Flett,17,67,44,RW,1973
2566,25,31,Bill Flett,15,77,40,RW,1974
2567,17,32,Bill Flett,23,78,40,RW,1975
2568,4,33,Bill Flett,4,24,8,RW,1976
2569,20,33,Bill Flett,34,48,54,RW,1976
2570,20,33,Bill Flett,34,48,54,RW,1976
2571,28,34,Bill Flett,41,74,69,RW,1977
2572,28,34,Bill Flett,41,74,69,RW,1977
2573,36,35,Bill Flett,28,73,64,RW,1978
2574,36,35,Bill Flett,28,73,64,RW,1978
2575,2,36,Bill Flett,5,20,7,RW,1979
2576,0,20,Bill Gardner,0,1,0,C,1980
2577,15,21,Bill Gardner,8,69,23,C,1981
2578,25,22,Bill Gardner,15,77,40,C,1982
2579,21,23,Bill Gardner,27,79,48,C,1983
2580,34,24,Bill Gardner,17,74,51,LW,1984
2581,18,25,Bill Gardner,4,64,22,C,1985
2582,1,26,Bill Gardner,0,8,1,C,1986
2583,0,27,Bill Gardner,1,2,1,C,1987
2584,1,28,Bill Gardner,1,6,2,C,1988
2585,14,23,Bill Gilligan,10,54,24,RW,1977
2586,14,23,Bill Gilligan,10,54,24,RW,1977
2587,26,24,Bill Gilligan,17,74,43,C,1978
2588,26,24,Bill Gilligan,17,74,43,C,1978
2589,19,23,Bill Goldsworthy,14,68,33,RW,1967
2590,10,24,Bill Goldsworthy,14,68,24,RW,1968
2591,29,25,Bill Goldsworthy,36,75,65,RW,1969
2592,31,26,Bill Goldsworthy,34,77,65,RW,1970
2593,31,27,Bill Goldsworthy,31,78,62,RW,1971
2594,33,28,Bill Goldsworthy,27,75,60,RW,1972
2595,26,29,Bill Goldsworthy,48,74,74,RW,1973
2596,35,30,Bill Goldsworthy,37,71,72,RW,1974
2597,22,31,Bill Goldsworthy,24,68,46,RW,1975
2598,15,32,Bill Goldsworthy,12,77,27,RW,1976
2599,1,33,Bill Goldsworthy,0,7,1,RW,1977
2600,10,33,Bill Goldsworthy,8,32,18,RW,1977
2601,10,33,Bill Goldsworthy,8,32,18,RW,1977
2602,2,34,Bill Goldsworthy,4,17,6,C,1978
2603,2,34,Bill Goldsworthy,4,17,6,C,1978
2604,0,21,Bill Goldthorpe,0,7,0,LW,1974
2605,0,21,Bill Goldthorpe,0,7,0,LW,1974
2606,0,22,Bill Goldthorpe,1,26,1,LW,1975
2607,0,22,Bill Goldthorpe,1,26,1,LW,1975
2608,1,27,Bill Gratton,0,6,1,LW,1975
2609,1,27,Bill Gratton,0,6,1,LW,1975
2610,1,21,Bill Guerin,0,5,1,RW,1991
2611,20,22,Bill Guerin,14,65,34,RW,1992
2612,19,23,Bill Guerin,25,81,44,RW,1993
2613,13,24,Bill Guerin,12,48,25,RW,1994
2614,30,25,Bill Guerin,23,80,53,RW,1995
2615,18,26,Bill Guerin,29,82,47,RW,1996
2616,21,27,Bill Guerin,18,59,39,RW,1997
2617,34,28,Bill Guerin,30,80,64,RW,1998
2618,22,29,Bill Guerin,24,70,46,RW,1999
2619,45,30,Bill Guerin,40,85,85,RW,2000
2620,25,31,Bill Guerin,41,78,66,RW,2001
2621,25,32,Bill Guerin,25,64,50,RW,2002
2622,35,33,Bill Guerin,34,82,69,RW,2003
2623,27,35,Bill Guerin,13,70,40,RW,2005
2624,20,36,Bill Guerin,36,77,56,RW,2006
2625,21,37,Bill Guerin,23,81,44,RW,2007
2626,27,38,Bill Guerin,21,78,48,RW,2008
2627,24,39,Bill Guerin,21,78,45,RW,2009
2628,2,22,Bill Hajt,0,6,2,D,1973
2629,26,23,Bill Hajt,3,76,29,D,1974
2630,21,24,Bill Hajt,6,80,27,D,1975
2631,20,25,Bill Hajt,6,79,26,D,1976
2632,18,26,Bill Hajt,4,76,22,D,1977
2633,8,27,Bill Hajt,3,40,11,D,1978
2634,12,28,Bill Hajt,4,75,16,D,1979
2635,19,29,Bill Hajt,2,68,21,D,1980
2636,9,30,Bill Hajt,2,65,11,D,1981
2637,12,31,Bill Hajt,3,72,15,D,1982
2638,24,32,Bill Hajt,3,79,27,D,1983
2639,13,33,Bill Hajt,5,57,18,D,1984
2640,16,34,Bill Hajt,1,58,17,D,1985
2641,2,35,Bill Hajt,0,23,2,D,1986
2642,1,24,Bill Heindl,1,12,2,LW,1970
2643,0,25,Bill Heindl,0,2,0,LW,1971
2644,0,26,Bill Heindl,1,4,1,LW,1972
2645,14,27,Bill Heindl,4,67,18,LW,1973
2646,14,27,Bill Heindl,4,67,18,LW,1973
2647,19,29,Bill Hicke,21,52,40,RW,1967
2648,36,30,Bill Hicke,25,67,61,RW,1968
2649,29,31,Bill Hicke,15,69,44,RW,1969
2650,17,32,Bill Hicke,18,74,35,RW,1970
2651,0,33,Bill Hicke,2,12,2,RW,1971
2652,24,34,Bill Hicke,14,73,38,RW,1972
2653,0,23,Bill Hogaboam,1,6,1,C,1972
2654,23,24,Bill Hogaboam,18,47,41,C,1973
2655,27,25,Bill Hogaboam,14,60,41,C,1974
2656,23,26,Bill Hogaboam,28,68,51,C,1975
2657,15,27,Bill Hogaboam,10,73,25,C,1976
2658,2,28,Bill Hogaboam,1,8,3,C,1977
2659,7,29,Bill Hogaboam,5,28,12,C,1978
2660,12,30,Bill Hogaboam,3,42,15,C,1979
2661,17,26,Bill Horton,2,74,19,D,1972
2662,17,26,Bill Horton,2,74,19,D,1972
2663,9,27,Bill Horton,0,60,9,D,1973
2664,9,27,Bill Horton,0,60,9,D,1973
2665,9,28,Bill Horton,2,59,11,D,1974
2666,2,20,Bill Houlder,1,30,3,D,1987
2667,3,21,Bill Houlder,0,8,3,D,1988
2668,11,22,Bill Houlder,1,41,12,D,1989
2669,2,23,Bill Houlder,0,7,2,D,1990
2670,0,24,Bill Houlder,1,10,1,D,1991
2671,5,25,Bill Houlder,3,15,8,D,1992
2672,25,26,Bill Houlder,14,80,39,D,1993
2673,13,27,Bill Houlder,5,41,18,D,1994
2674,23,28,Bill Houlder,5,61,28,D,1995
2675,21,29,Bill Houlder,4,79,25,D,1996
2676,25,30,Bill Houlder,7,82,32,D,1997
2677,23,31,Bill Houlder,9,76,32,D,1998
2678,14,32,Bill Houlder,3,71,17,D,1999
2679,12,33,Bill Houlder,4,81,16,D,2000
2680,8,34,Bill Houlder,0,82,8,D,2001
2681,4,35,Bill Houlder,2,82,6,D,2002
2682,0,25,Bill Huard,0,2,0,LW,1992
2683,2,26,Bill Huard,2,63,4,LW,1993
2684,3,27,Bill Huard,3,33,6,LW,1994
2685,6,28,Bill Huard,6,51,12,LW,1995
2686,6,29,Bill Huard,5,40,11,LW,1996
2687,1,30,Bill Huard,0,30,1,LW,1997
2688,0,31,Bill Huard,0,3,0,LW,1998
2689,0,32,Bill Huard,0,1,0,LW,1999
2690,0,21,Bill Kitchen,0,1,0,D,1981
2691,0,22,Bill Kitchen,0,8,0,D,1982
2692,0,23,Bill Kitchen,0,3,0,D,1983
2693,4,24,Bill Kitchen,1,29,5,D,1984
2694,22,25,Bill Klatt,36,78,58,RW,1972
2695,22,25,Bill Klatt,36,78,58,RW,1972
2696,6,26,Bill Klatt,14,65,20,RW,1973
2697,6,26,Bill Klatt,14,65,20,RW,1973
2698,4,21,Bill Laing,2,42,6,LW,1974
2699,4,21,Bill Laing,2,42,6,LW,1974
2700,12,22,Bill Laing,8,54,20,LW,1975
2701,12,22,Bill Laing,8,54,20,LW,1975
2702,0,28,Bill Lecaine,0,4,0,LW,1968
2703,1,22,Bill Lesuk,0,5,1,LW,1968
2704,0,23,Bill Lesuk,0,3,0,LW,1969
2705,19,24,Bill Lesuk,17,78,36,LW,1970
2706,16,25,Bill Lesuk,11,72,27,LW,1971
2707,14,26,Bill Lesuk,6,67,20,LW,1972
2708,1,27,Bill Lesuk,2,35,3,LW,1973
2709,11,28,Bill Lesuk,8,79,19,LW,1974
2710,21,29,Bill Lesuk,15,81,36,RW,1975
2711,21,29,Bill Lesuk,15,81,36,RW,1975
2712,27,30,Bill Lesuk,14,78,41,LW,1976
2713,27,30,Bill Lesuk,14,78,41,LW,1976
2714,18,31,Bill Lesuk,9,80,27,LW,1977
2715,15,32,Bill Lesuk,17,79,32,LW,1978
2716,1,33,Bill Lesuk,0,49,1,LW,1979
2717,4,20,Bill Lindsay,2,23,6,LW,1991
2718,9,21,Bill Lindsay,4,44,13,LW,1992
2719,6,22,Bill Lindsay,6,84,12,LW,1993
2720,9,23,Bill Lindsay,10,48,19,LW,1994
2721,22,24,Bill Lindsay,12,73,34,LW,1995
2722,23,25,Bill Lindsay,11,81,34,LW,1996
2723,16,26,Bill Lindsay,12,82,28,LW,1997
2724,15,27,Bill Lindsay,12,75,27,LW,1998
2725,12,28,Bill Lindsay,8,80,20,LW,1999
2726,13,29,Bill Lindsay,1,68,14,LW,2000
2727,10,30,Bill Lindsay,5,76,15,LW,2001
2728,2,31,Bill Lindsay,0,19,2,LW,2002
2729,0,32,Bill Lindsay,0,24,0,LW,2003
2730,12,20,Bill Lochead,16,65,28,RW,1974
2731,11,21,Bill Lochead,9,53,20,RW,1975
2732,14,22,Bill Lochead,16,61,30,LW,1976
2733,16,23,Bill Lochead,20,77,36,RW,1977
2734,9,24,Bill Lochead,8,67,17,LW,1978
2735,0,25,Bill Lochead,0,7,0,LW,1979
2736,8,29,Bill Masterton,4,38,12,C,1967
2737,13,33,Bill McCreary,13,70,26,LW,1967
2738,17,34,Bill McCreary,13,71,30,LW,1968
2739,17,35,Bill McCreary,15,73,32,LW,1969
2740,10,36,Bill McCreary,9,68,19,LW,1970
2741,0,20,Bill McCreary,1,12,1,RW,1980
2742,1,24,Bill McDougall,0,2,1,C,1990
2743,1,26,Bill McDougall,2,4,3,C,1992
2744,3,27,Bill McDougall,3,22,6,C,1993
2745,1,23,Bill Mikkelson,0,15,1,D,1971
2746,10,24,Bill Mikkelson,1,72,11,D,1972
2747,7,26,Bill Mikkelson,3,59,10,D,1974
2748,0,28,Bill Mikkelson,0,1,0,D,1976
2749,8,25,Bill Morris,4,36,12,LW,1974
2750,8,25,Bill Morris,4,36,12,LW,1974
2751,20,24,Bill Muckalt,16,73,36,RW,1998
2752,11,25,Bill Muckalt,8,45,19,RW,1999
2753,15,26,Bill Muckalt,11,60,26,RW,2000
2754,8,27,Bill Muckalt,0,70,8,RW,2001
2755,3,28,Bill Muckalt,5,8,8,RW,2002
2756,3,23,Bill Nyrop,0,19,3,D,1975
2757,19,24,Bill Nyrop,3,74,22,D,1976
2758,21,25,Bill Nyrop,5,72,26,D,1977
2759,8,29,Bill Nyrop,4,42,12,D,1981
2760,0,24,Bill O'Dwyer,0,5,0,C,1983
2761,0,25,Bill O'Dwyer,1,13,1,C,1984
2762,10,28,Bill O'Dwyer,7,77,17,C,1987
2763,2,29,Bill O'Dwyer,1,19,3,C,1988
2764,1,30,Bill O'Dwyer,0,6,1,C,1989
2765,2,23,Bill Orban,3,39,5,LW,1967
2766,11,24,Bill Orban,5,66,16,LW,1968
2767,2,25,Bill Orban,0,9,2,LW,1969
2768,2,22,Bill Plager,0,32,2,D,1967
2769,0,23,Bill Plager,0,2,0,D,1968
2770,4,24,Bill Plager,1,24,5,D,1969
2771,3,25,Bill Plager,0,36,3,D,1970
2772,11,26,Bill Plager,1,65,12,D,1971
2773,11,27,Bill Plager,2,76,13,D,1972
2774,0,28,Bill Plager,0,1,0,D,1973
2775,0,29,Bill Plager,0,7,0,D,1974
2776,3,30,Bill Plager,0,20,3,D,1975
2777,1,22,Bill Prentice,0,3,1,D,1972
2778,1,22,Bill Prentice,0,3,1,D,1972
2779,2,23,Bill Prentice,1,55,3,D,1973
2780,2,23,Bill Prentice,1,55,3,D,1973
2781,3,24,Bill Prentice,0,17,3,D,1974
2782,3,24,Bill Prentice,0,17,3,D,1974
2783,7,25,Bill Prentice,6,59,13,D,1975
2784,7,25,Bill Prentice,6,59,13,D,1975
2785,0,26,Bill Prentice,0,3,0,D,1976
2786,0,26,Bill Prentice,0,3,0,D,1976
2787,1,27,Bill Prentice,1,21,2,D,1977
2788,1,27,Bill Prentice,1,21,2,D,1977
2789,0,20,Bill Reed,0,11,0,D,1974
2790,0,20,Bill Reed,0,11,0,D,1974
2791,5,21,Bill Reed,0,29,5,D,1975
2792,5,21,Bill Reed,0,29,5,D,1975
2793,0,24,Bill Riley,0,1,0,RW,1974
2794,14,26,Bill Riley,13,43,27,RW,1976
2795,12,27,Bill Riley,13,57,25,RW,1977
2796,2,28,Bill Riley,2,24,4,RW,1978
2797,2,29,Bill Riley,3,14,5,RW,1979
2798,3,23,Bill Root,2,46,5,D,1982
2799,13,24,Bill Root,4,72,17,D,1983
2800,1,25,Bill Root,1,35,2,D,1984
2801,1,26,Bill Root,0,27,1,D,1985
2802,3,27,Bill Root,3,34,6,D,1986
2803,2,28,Bill Root,1,33,3,D,1987
2804,13,25,Bill Speer,3,68,16,D,1967
2805,4,26,Bill Speer,1,34,5,D,1968
2806,3,27,Bill Speer,1,27,4,D,1969
2807,0,28,Bill Speer,0,1,0,D,1970
2808,23,30,Bill Speer,3,69,26,D,1972
2809,23,30,Bill Speer,3,69,26,D,1972
2810,3,31,Bill Speer,1,66,4,D,1973
2811,3,31,Bill Speer,1,66,4,D,1973
2812,0,23,Bill Steele,2,3,2,RW,1975
2813,0,23,Bill Steele,2,3,2,RW,1975
2814,22,24,Bill Steele,9,81,31,RW,1976
2815,22,24,Bill Steele,9,81,31,RW,1976
2816,0,20,Bill Stewart,2,13,2,D,1977
2817,17,21,Bill Stewart,1,68,18,D,1978
2818,21,23,Bill Stewart,2,60,23,D,1980
2819,5,24,Bill Stewart,0,22,5,D,1981
2820,0,25,Bill Stewart,0,7,0,D,1982
2821,17,26,Bill Stewart,2,56,19,D,1983
2822,2,27,Bill Stewart,0,27,2,D,1984
2823,2,28,Bill Stewart,0,8,2,D,1985
2824,9,33,Bill Sutherland,20,60,29,LW,1967
2825,8,34,Bill Sutherland,14,56,22,LW,1968
2826,17,35,Bill Sutherland,15,51,32,LW,1969
2827,20,36,Bill Sutherland,19,69,39,LW,1970
2828,4,37,Bill Sutherland,2,14,6,LW,1971
2829,16,38,Bill Sutherland,6,48,22,LW,1972
2830,5,39,Bill Sutherland,4,12,9,C,1973
2831,0,23,Bill Sweatt,0,2,0,LW,2011
2832,0,24,Bill Sweatt,0,1,0,LW,2012
2833,0,26,Bill Terry,0,5,0,C,1987
2834,2,22,Bill Thomas,1,9,3,RW,2005
2835,6,23,Bill Thomas,8,24,14,RW,2006
2836,0,24,Bill Thomas,0,7,0,RW,2007
2837,1,25,Bill Thomas,2,16,3,RW,2008
2838,3,27,Bill Thomas,4,24,7,RW,2010
2839,0,28,Bill Thomas,1,7,1,RW,2011
2840,16,21,Bill Watson,8,52,24,RW,1985
2841,19,22,Bill Watson,13,51,32,RW,1986
2842,0,23,Bill Watson,2,9,2,RW,1987
2843,1,24,Bill Watson,0,3,1,RW,1988
2844,0,21,Bill Whelton,0,2,0,D,1980
2845,27,28,Bill White,11,74,38,D,1967
2846,28,29,Bill White,5,75,33,D,1968
2847,16,30,Bill White,4,61,20,D,1969
2848,21,31,Bill White,4,67,25,D,1970
2849,22,32,Bill White,7,76,29,D,1971
2850,38,33,Bill White,9,72,47,D,1972
2851,31,34,Bill White,5,69,36,D,1973
2852,23,35,Bill White,4,51,27,D,1974
2853,9,36,Bill White,1,59,10,D,1975
2854,18,25,Bill Young,19,73,37,LW,1972
2855,18,25,Bill Young,19,73,37,LW,1972
2856,12,26,Bill Young,9,69,21,LW,1973
2857,12,26,Bill Young,9,69,21,LW,1973
2858,4,22,Billy Carroll,4,18,8,C,1980
2859,20,23,Billy Carroll,9,72,29,C,1981
2860,11,24,Billy Carroll,1,71,12,C,1982
2861,2,25,Billy Carroll,5,39,7,C,1983
2862,9,26,Billy Carroll,8,65,17,C,1984
2863,6,27,Billy Carroll,2,26,8,C,1985
2864,2,28,Billy Carroll,1,31,3,C,1986
2865,12,34,Billy Dea,16,73,28,LW,1967
2866,8,35,Billy Dea,10,66,18,LW,1968
2867,3,36,Billy Dea,10,70,13,C,1969
2868,3,37,Billy Dea,6,42,9,C,1970
2869,22,21,Billy E Harris,28,78,50,RW,1972
2870,27,22,Billy E Harris,23,78,50,RW,1973
2871,37,23,Billy E Harris,25,80,62,RW,1974
2872,38,24,Billy E Harris,32,80,70,RW,1975
2873,43,25,Billy E Harris,24,80,67,RW,1976
2874,38,26,Billy E Harris,22,80,60,RW,1977
2875,39,27,Billy E Harris,15,80,54,RW,1978
2876,18,28,Billy E Harris,19,78,37,RW,1979
2877,29,29,Billy E Harris,20,80,49,RW,1980
2878,3,30,Billy E Harris,3,36,6,RW,1981
2879,19,31,Billy E Harris,11,76,30,RW,1982
2880,14,32,Billy E Harris,9,71,23,RW,1983
2881,1,24,Billy Inglis,1,12,2,C,1967
2882,1,25,Billy Inglis,0,10,1,C,1968
2883,1,27,Billy Inglis,0,14,1,C,1970
2884,19,27,Billy MacMillan,22,76,41,RW,1970
2885,7,28,Billy MacMillan,10,61,17,RW,1971
2886,15,29,Billy MacMillan,10,78,25,RW,1972
2887,9,30,Billy MacMillan,4,55,13,RW,1973
2888,12,31,Billy MacMillan,13,69,25,RW,1974
2889,7,32,Billy MacMillan,9,64,16,RW,1975
2890,8,33,Billy MacMillan,6,43,14,RW,1976
2891,9,25,Billy Orr,3,46,12,D,1973
2892,2,26,Billy Tibbetts,1,29,3,RW,2000
2893,6,27,Billy Tibbetts,1,42,7,RW,2001
2894,0,28,Billy Tibbetts,0,11,0,C,2002
2895,1,21,Bjorn Johansson,1,10,2,D,1976
2896,0,22,Bjorn Johansson,0,5,0,D,1977
2897,0,25,Bjorn Melin,1,3,1,RW,2006
2898,0,20,Bjorn Skaare,0,1,0,C,1978
2899,1,23,Blaine Rydman,0,31,1,D,1972
2900,1,23,Blaine Rydman,0,31,1,D,1972
2901,0,24,Blaine Rydman,0,8,0,D,1973
2902,6,20,Blaine Stoughton,5,34,11,LW,1973
2903,14,21,Blaine Stoughton,23,78,37,LW,1974
2904,11,22,Blaine Stoughton,6,43,17,RW,1975
2905,52,23,Blaine Stoughton,52,81,104,RW,1976
2906,52,23,Blaine Stoughton,52,81,104,RW,1976
2907,26,24,Blaine Stoughton,19,77,45,RW,1977
2908,26,24,Blaine Stoughton,19,77,45,RW,1977
2909,12,25,Blaine Stoughton,18,61,30,RW,1978
2910,12,25,Blaine Stoughton,18,61,30,RW,1978
2911,44,26,Blaine Stoughton,56,80,100,RW,1979
2912,30,27,Blaine Stoughton,43,71,73,RW,1980
2913,39,28,Blaine Stoughton,52,80,91,LW,1981
2914,31,29,Blaine Stoughton,45,72,76,RW,1982
2915,16,30,Blaine Stoughton,28,68,44,RW,1983
2916,1,23,Blair Atcheynum,0,4,1,RW,1992
2917,15,28,Blair Atcheynum,11,61,26,RW,1997
2918,8,29,Blair Atcheynum,10,65,18,RW,1998
2919,7,30,Blair Atcheynum,5,47,12,RW,1999
2920,2,31,Blair Atcheynum,1,19,3,RW,2000
2921,0,22,Blair Barnes,0,1,0,RW,1982
2922,0,21,Blair Betts,1,6,1,C,2001
2923,3,22,Blair Betts,1,9,4,C,2002
2924,2,23,Blair Betts,1,20,3,C,2003
2925,2,25,Blair Betts,8,66,10,C,2005
2926,4,26,Blair Betts,9,82,13,C,2006
2927,5,27,Blair Betts,2,75,7,C,2007
2928,4,28,Blair Betts,6,81,10,C,2008
2929,10,29,Blair Betts,8,63,18,C,2009
2930,7,30,Blair Betts,5,75,12,C,2010
2931,23,20,Blair Chapman,14,80,37,RW,1976
2932,20,21,Blair Chapman,24,75,44,RW,1977
2933,8,22,Blair Chapman,10,71,18,RW,1978
2934,26,23,Blair Chapman,25,64,51,RW,1979
2935,26,24,Blair Chapman,20,55,46,RW,1980
2936,11,25,Blair Chapman,6,18,17,RW,1981
2937,11,26,Blair Chapman,7,39,18,RW,1982
2938,0,21,Blair Davidson,0,2,0,D,1976
2939,0,21,Blair Davidson,0,2,0,D,1976
2940,2,20,Blair Jones,1,20,3,C,2006
2941,0,21,Blair Jones,0,4,0,C,2007
2942,0,23,Blair Jones,0,14,0,C,2009
2943,2,24,Blair Jones,1,18,3,C,2010
2944,5,25,Blair Jones,3,43,8,C,2011
2945,1,26,Blair Jones,0,15,1,C,2012
2946,0,27,Blair Jones,2,14,2,C,2013
2947,0,28,Blair Jones,0,4,0,C,2014
2948,24,20,Blair MacDonald,21,78,45,RW,1973
2949,24,20,Blair MacDonald,21,78,45,RW,1973
2950,24,21,Blair MacDonald,22,72,46,LW,1974
2951,24,21,Blair MacDonald,22,72,46,LW,1974
2952,16,22,Blair MacDonald,26,85,42,RW,1975
2953,16,22,Blair MacDonald,26,85,42,RW,1975
2954,30,23,Blair MacDonald,34,81,64,RW,1976
2955,30,23,Blair MacDonald,34,81,64,RW,1976
2956,34,24,Blair MacDonald,34,80,68,RW,1977
2957,34,24,Blair MacDonald,34,80,68,RW,1977
2958,37,25,Blair MacDonald,34,80,71,RW,1978
2959,37,25,Blair MacDonald,34,80,71,RW,1978
2960,48,26,Blair MacDonald,46,80,94,RW,1979
2961,33,27,Blair MacDonald,24,63,57,RW,1980
2962,15,28,Blair MacDonald,18,59,33,RW,1981
2963,4,29,Blair MacDonald,3,17,7,RW,1982
2964,0,21,Blair MacKasey,0,1,0,D,1976
2965,4,20,Blair Stewart,0,17,4,LW,1973
2966,5,21,Blair Stewart,1,21,6,C,1974
2967,14,22,Blair Stewart,13,74,27,LW,1975
2968,2,23,Blair Stewart,5,34,7,LW,1976
2969,1,24,Blair Stewart,0,8,1,LW,1977
2970,12,25,Blair Stewart,7,45,19,LW,1978
2971,6,26,Blair Stewart,8,30,14,LW,1979
2972,1,24,Blake Bellefeuille,0,2,1,C,2001
2973,0,25,Blake Bellefeuille,0,3,0,C,2002
2974,1,25,Blake Coleman,1,23,2,C,2016
2975,12,26,Blake Coleman,13,79,25,C,2017
2976,0,20,Blake Comeau,0,3,0,RW,2006
2977,7,21,Blake Comeau,8,51,15,LW,2007
2978,18,22,Blake Comeau,7,53,25,LW,2008
2979,18,23,Blake Comeau,17,61,35,RW,2009
2980,22,24,Blake Comeau,24,77,46,RW,2010
2981,10,25,Blake Comeau,5,74,15,RW,2011
2982,6,26,Blake Comeau,6,42,12,RW,2012
2983,11,27,Blake Comeau,5,61,16,LW,2013
2984,15,28,Blake Comeau,16,61,31,LW,2014
2985,24,29,Blake Comeau,12,81,36,LW,2015
2986,12,30,Blake Comeau,8,77,20,LW,2016
2987,21,31,Blake Comeau,13,79,34,LW,2017
2988,0,20,Blake Dunlop,0,12,0,C,1973
2989,18,21,Blake Dunlop,9,52,27,C,1974
2990,11,22,Blake Dunlop,9,33,20,C,1975
2991,1,23,Blake Dunlop,0,3,1,C,1976
2992,1,24,Blake Dunlop,0,3,1,C,1977
2993,28,25,Blake Dunlop,20,66,48,C,1978
2994,27,26,Blake Dunlop,18,72,45,C,1979
2995,67,27,Blake Dunlop,20,80,87,C,1980
2996,53,28,Blake Dunlop,25,77,78,C,1981
2997,44,29,Blake Dunlop,22,78,66,C,1982
2998,24,30,Blake Dunlop,7,74,31,C,1983
2999,2,22,Blake Geoffrion,6,20,8,LW,2010
3000,3,23,Blake Geoffrion,2,35,5,LW,2011
3001,0,22,Blake Hillman,1,4,1,D,2017
3002,1,22,Blake Pietila,1,7,2,LW,2015
3003,1,23,Blake Pietila,0,10,1,LW,2016
3004,0,24,Blake Pietila,0,2,0,LW,2017
3005,0,23,Blake Sloan,0,14,0,RW,1998
3006,13,24,Blake Sloan,4,67,17,RW,1999
3007,2,25,Blake Sloan,3,47,5,RW,2000
3008,9,26,Blake Sloan,2,67,11,LW,2001
3009,8,27,Blake Sloan,2,67,10,RW,2002
3010,0,28,Blake Sloan,0,28,0,RW,2003
3011,0,20,Blake Speers,0,3,0,C,2016
3012,1,20,Blake Wesley,0,2,1,D,1979
3013,7,21,Blake Wesley,3,50,10,D,1980
3014,18,22,Blake Wesley,9,78,27,D,1981
3015,9,23,Blake Wesley,4,74,13,D,1982
3016,8,24,Blake Wesley,2,46,10,D,1983
3017,2,25,Blake Wesley,0,21,2,D,1984
3018,1,26,Blake Wesley,0,27,1,D,1985
3019,24,22,Blake Wheeler,21,81,45,RW,2008
3020,20,23,Blake Wheeler,18,82,38,RW,2009
3021,26,24,Blake Wheeler,18,81,44,RW,2010
3022,47,25,Blake Wheeler,17,80,64,RW,2011
3023,22,26,Blake Wheeler,19,48,41,RW,2012
3024,41,27,Blake Wheeler,28,82,69,RW,2013
3025,35,28,Blake Wheeler,26,79,61,RW,2014
3026,52,29,Blake Wheeler,26,82,78,RW,2015
3027,48,30,Blake Wheeler,26,82,74,RW,2016
3028,68,31,Blake Wheeler,23,81,91,RW,2017
3029,27,28,Bo Berglund,16,75,43,RW,1983
3030,10,29,Bo Berglund,10,45,20,LW,1984
3031,2,30,Bo Berglund,2,10,4,RW,1985
3032,12,19,Bo Horvat,13,68,25,C,2014
3033,24,20,Bo Horvat,16,82,40,C,2015
3034,32,21,Bo Horvat,20,81,52,C,2016
3035,22,22,Bo Horvat,22,64,44,C,2017
3036,14,29,Bob Ash,3,76,17,D,1972
3037,14,29,Bob Ash,3,76,17,D,1972
3038,18,30,Bob Ash,2,60,20,D,1973
3039,14,31,Bob Ash,1,64,15,D,1974
3040,1,20,Bob Attwell,1,7,2,RW,1979
3041,4,21,Bob Attwell,0,15,4,RW,1980
3042,19,29,Bob Barber,4,75,23,D,1972
3043,19,29,Bob Barber,4,75,23,D,1972
3044,0,30,Bob Barber,0,3,0,D,1973
3045,0,30,Bob Barber,0,3,0,D,1973
3046,17,34,Bob Barlow,16,70,33,C,1969
3047,0,35,Bob Barlow,0,7,0,C,1970
3048,20,39,Bob Barlow,6,51,26,LW,1974
3049,20,39,Bob Barlow,6,51,26,LW,1974
3050,1,20,Bob Bassen,2,11,3,C,1985
3051,10,21,Bob Bassen,7,77,17,C,1986
3052,16,22,Bob Bassen,6,77,22,C,1987
3053,16,23,Bob Bassen,5,68,21,C,1988
3054,1,24,Bob Bassen,1,6,2,C,1989
3055,18,25,Bob Bassen,16,79,34,C,1990
3056,25,26,Bob Bassen,7,79,32,LW,1991
3057,10,27,Bob Bassen,9,53,19,C,1992
3058,15,28,Bob Bassen,13,83,28,RW,1993
3059,15,29,Bob Bassen,12,47,27,C,1994
3060,1,30,Bob Bassen,0,13,1,C,1995
3061,7,31,Bob Bassen,5,46,12,C,1996
3062,4,32,Bob Bassen,3,58,7,LW,1997
3063,2,33,Bob Bassen,1,41,3,C,1998
3064,3,34,Bob Bassen,1,27,4,C,1999
3065,10,31,Bob Baun,3,67,13,D,1967
3066,16,32,Bob Baun,4,76,20,D,1968
3067,18,33,Bob Baun,1,71,19,D,1969
3068,20,34,Bob Baun,1,69,21,D,1970
3069,12,35,Bob Baun,2,74,14,D,1971
3070,1,36,Bob Baun,1,5,2,D,1972
3071,1,22,Bob Beers,0,3,1,D,1989
3072,1,23,Bob Beers,0,16,1,D,1990
3073,5,24,Bob Beers,0,31,5,D,1991
3074,24,25,Bob Beers,12,64,36,D,1992
3075,32,26,Bob Beers,11,82,43,D,1993
3076,7,27,Bob Beers,2,22,9,D,1994
3077,5,28,Bob Beers,0,13,5,D,1995
3078,4,29,Bob Beers,3,27,7,D,1996
3079,0,24,Bob Bergloff,0,2,0,D,1982
3080,0,25,Bob Berry,0,2,0,LW,1968
3081,38,27,Bob Berry,25,77,63,LW,1970
3082,22,28,Bob Berry,17,78,39,LW,1971
3083,28,29,Bob Berry,36,78,64,LW,1972
3084,33,30,Bob Berry,23,77,56,LW,1973
3085,23,31,Bob Berry,25,80,48,LW,1974
3086,22,32,Bob Berry,20,80,42,LW,1975
3087,25,33,Bob Berry,13,69,38,LW,1976
3088,0,30,Bob Blackburn,0,11,0,D,1968
3089,7,31,Bob Blackburn,4,60,11,D,1969
3090,5,32,Bob Blackburn,4,64,9,D,1970
3091,0,26,Bob Bodak,0,3,0,LW,1987
3092,0,28,Bob Bodak,0,1,0,LW,1989
3093,1,24,Bob Boughner,0,31,1,D,1995
3094,7,25,Bob Boughner,1,77,8,D,1996
3095,3,26,Bob Boughner,1,69,4,D,1997
3096,10,27,Bob Boughner,3,79,13,D,1998
3097,4,28,Bob Boughner,3,73,7,D,1999
3098,3,29,Bob Boughner,1,58,4,D,2000
3099,4,30,Bob Boughner,2,79,6,D,2001
3100,14,31,Bob Boughner,3,69,17,D,2002
3101,5,32,Bob Boughner,0,54,5,D,2003
3102,6,34,Bob Boughner,1,41,7,D,2005
3103,23,20,Bob Bourne,16,77,39,C,1974
3104,3,21,Bob Bourne,2,14,5,C,1975
3105,19,22,Bob Bourne,16,75,35,LW,1976
3106,33,23,Bob Bourne,30,80,63,C,1977
3107,31,24,Bob Bourne,30,80,61,C,1978
3108,25,25,Bob Bourne,15,73,40,C,1979
3109,41,26,Bob Bourne,35,78,76,LW,1980
3110,26,27,Bob Bourne,27,76,53,LW,1981
3111,42,28,Bob Bourne,20,77,62,LW,1982
3112,34,29,Bob Bourne,22,78,56,LW,1983
3113,12,30,Bob Bourne,8,44,20,LW,1984
3114,15,31,Bob Bourne,17,62,32,LW,1985
3115,9,32,Bob Bourne,13,78,22,C,1986
3116,11,33,Bob Bourne,7,72,18,C,1987
3117,14,22,Bob Boyd,1,41,15,D,1973
3118,14,22,Bob Boyd,1,41,15,D,1973
3119,0,23,Bob Boyd,0,13,0,D,1974
3120,0,23,Bob Boyd,0,13,0,D,1974
3121,2,23,Bob Brooke,1,9,3,RW,1983
3122,9,24,Bob Brooke,7,72,16,RW,1984
3123,20,25,Bob Brooke,24,79,44,RW,1985
3124,23,26,Bob Brooke,13,80,36,C,1986
3125,20,27,Bob Brooke,5,77,25,RW,1987
3126,9,28,Bob Brooke,7,57,16,RW,1988
3127,14,29,Bob Brooke,12,73,26,RW,1989
3128,4,22,Bob Brown,0,21,4,D,1972
3129,4,22,Bob Brown,0,21,4,D,1972
3130,13,23,Bob Brown,7,59,20,D,1973
3131,13,23,Bob Brown,7,59,20,D,1973
3132,35,18,Bob Carpenter,32,80,67,LW,1981
3133,37,19,Bob Carpenter,32,80,69,LW,1982
3134,40,20,Bob Carpenter,28,80,68,LW,1983
3135,42,21,Bob Carpenter,53,80,95,C,1984
3136,29,22,Bob Carpenter,27,80,56,C,1985
3137,18,23,Bob Carpenter,9,60,27,C,1986
3138,33,24,Bob Carpenter,19,71,52,LW,1987
3139,24,25,Bob Carpenter,16,57,40,LW,1988
3140,31,26,Bob Carpenter,25,80,56,LW,1989
3141,8,27,Bob Carpenter,8,29,16,LW,1990
3142,23,28,Bob Carpenter,25,60,48,LW,1991
3143,17,29,Bob Carpenter,11,68,28,C,1992
3144,23,30,Bob Carpenter,10,76,33,C,1993
3145,11,31,Bob Carpenter,5,41,16,C,1994
3146,5,32,Bob Carpenter,5,52,10,LW,1995
3147,15,33,Bob Carpenter,4,62,19,LW,1996
3148,9,34,Bob Carpenter,9,66,18,LW,1997
3149,8,35,Bob Carpenter,2,56,10,C,1998
3150,0,23,Bob Charlebois,1,7,1,LW,1967
3151,40,28,Bob Charlebois,24,78,64,LW,1972
3152,40,28,Bob Charlebois,24,78,64,LW,1972
3153,7,29,Bob Charlebois,4,74,11,LW,1973
3154,7,29,Bob Charlebois,4,74,11,LW,1973
3155,0,30,Bob Charlebois,1,8,1,LW,1974
3156,0,30,Bob Charlebois,1,8,1,LW,1974
3157,3,31,Bob Charlebois,3,28,6,LW,1975
3158,3,31,Bob Charlebois,3,28,6,LW,1975
3159,3,24,Bob Collyard,1,10,4,C,1973
3160,0,25,Bob Cook,0,2,0,RW,1970
3161,7,27,Bob Cook,11,46,18,RW,1972
3162,1,28,Bob Cook,2,22,3,RW,1973
3163,1,29,Bob Cook,0,2,1,RW,1974
3164,0,22,Bob Corkum,2,8,2,RW,1989
3165,4,24,Bob Corkum,2,20,6,C,1991
3166,4,25,Bob Corkum,6,68,10,RW,1992
3167,28,26,Bob Corkum,23,76,51,C,1993
3168,9,27,Bob Corkum,10,44,19,RW,1994
3169,10,28,Bob Corkum,9,76,19,C,1995
3170,11,29,Bob Corkum,9,80,20,C,1996
3171,9,30,Bob Corkum,12,76,21,C,1997
3172,10,31,Bob Corkum,9,77,19,C,1998
3173,6,32,Bob Corkum,5,45,11,RW,1999
3174,7,33,Bob Corkum,7,75,14,C,2000
3175,5,34,Bob Corkum,3,75,8,C,2001
3176,0,20,Bob Crawford,1,8,1,C,1979
3177,1,22,Bob Crawford,0,3,1,RW,1981
3178,9,23,Bob Crawford,5,27,14,RW,1982
3179,25,24,Bob Crawford,36,80,61,RW,1983
3180,14,25,Bob Crawford,14,45,28,RW,1984
3181,22,26,Bob Crawford,15,68,37,RW,1985
3182,0,27,Bob Crawford,0,15,0,RW,1986
3183,8,23,Bob D'Alvise,5,59,13,C,1975
3184,8,23,Bob D'Alvise,5,59,13,C,1975
3185,17,20,Bob Dailey,7,76,24,D,1973
3186,36,21,Bob Dailey,12,70,48,D,1974
3187,24,22,Bob Dailey,15,67,39,D,1975
3188,30,23,Bob Dailey,9,76,39,D,1976
3189,36,24,Bob Dailey,21,76,57,D,1977
3190,30,25,Bob Dailey,9,70,39,D,1978
3191,26,26,Bob Dailey,13,61,39,D,1979
3192,27,27,Bob Dailey,7,53,34,D,1980
3193,5,28,Bob Dailey,1,12,6,D,1981
3194,12,26,Bob Dillabough,7,47,19,C,1967
3195,12,27,Bob Dillabough,7,62,19,LW,1968
3196,5,28,Bob Dillabough,5,52,10,LW,1969
3197,8,31,Bob Dillabough,8,72,16,C,1972
3198,8,31,Bob Dillabough,8,72,16,C,1972
3199,1,23,Bob Dobek,3,14,4,C,1975
3200,17,24,Bob Dobek,7,58,24,C,1976
3201,13,19,Bob Errey,9,65,22,LW,1983
3202,2,20,Bob Errey,0,16,2,LW,1984
3203,6,21,Bob Errey,11,37,17,LW,1985
3204,18,22,Bob Errey,16,72,34,LW,1986
3205,6,23,Bob Errey,3,17,9,LW,1987
3206,32,24,Bob Errey,26,76,58,LW,1988
3207,19,25,Bob Errey,20,78,39,LW,1989
3208,22,26,Bob Errey,20,79,42,LW,1990
3209,16,27,Bob Errey,19,78,35,LW,1991
3210,9,28,Bob Errey,9,62,18,LW,1992
3211,18,29,Bob Errey,12,64,30,LW,1993
3212,13,30,Bob Errey,8,43,21,LW,1994
3213,21,31,Bob Errey,11,71,32,LW,1995
3214,8,32,Bob Errey,4,66,12,LW,1996
3215,9,33,Bob Errey,2,71,11,RW,1997
3216,2,21,Bob F Murray,1,64,3,D,1975
3217,11,22,Bob F Murray,10,77,21,D,1976
3218,17,23,Bob F Murray,14,70,31,D,1977
3219,32,24,Bob F Murray,19,79,51,D,1978
3220,34,25,Bob F Murray,16,74,50,D,1979
3221,47,26,Bob F Murray,13,77,60,D,1980
3222,22,27,Bob F Murray,8,45,30,D,1981
3223,32,28,Bob F Murray,7,79,39,D,1982
3224,37,29,Bob F Murray,11,78,48,D,1983
3225,38,30,Bob F Murray,5,80,43,D,1984
3226,29,31,Bob F Murray,9,80,38,D,1985
3227,38,32,Bob F Murray,6,79,44,D,1986
3228,20,33,Bob F Murray,6,62,26,D,1987
3229,4,34,Bob F Murray,2,15,6,D,1988
3230,19,35,Bob F Murray,5,49,24,D,1989
3231,3,22,Bob Falkenberg,0,20,3,D,1967
3232,0,23,Bob Falkenberg,0,5,0,D,1968
3233,1,25,Bob Falkenberg,0,9,1,D,1970
3234,0,26,Bob Falkenberg,0,4,0,D,1971
3235,23,27,Bob Falkenberg,6,77,29,D,1972
3236,23,27,Bob Falkenberg,6,77,29,D,1972
3237,14,28,Bob Falkenberg,3,78,17,D,1973
3238,14,28,Bob Falkenberg,3,78,17,D,1973
3239,18,29,Bob Falkenberg,2,78,20,D,1974
3240,18,29,Bob Falkenberg,2,78,20,D,1974
3241,13,30,Bob Falkenberg,3,79,16,D,1975
3242,13,30,Bob Falkenberg,3,79,16,D,1975
3243,6,31,Bob Falkenberg,0,64,6,D,1976
3244,6,31,Bob Falkenberg,0,64,6,D,1976
3245,0,32,Bob Falkenberg,0,2,0,D,1977
3246,0,32,Bob Falkenberg,0,2,0,D,1977
3247,2,23,Bob Fitchner,1,31,3,C,1973
3248,2,23,Bob Fitchner,1,31,3,C,1973
3249,19,24,Bob Fitchner,11,78,30,C,1974
3250,19,24,Bob Fitchner,11,78,30,C,1974
3251,25,25,Bob Fitchner,22,73,47,C,1975
3252,25,25,Bob Fitchner,22,73,47,C,1975
3253,30,26,Bob Fitchner,9,81,39,C,1976
3254,30,26,Bob Fitchner,9,81,39,C,1976
3255,28,27,Bob Fitchner,15,72,43,C,1977
3256,28,27,Bob Fitchner,15,72,43,C,1977
3257,35,28,Bob Fitchner,10,79,45,C,1978
3258,35,28,Bob Fitchner,10,79,45,C,1978
3259,20,29,Bob Fitchner,11,70,31,C,1979
3260,0,30,Bob Fitchner,1,8,1,C,1980
3261,7,20,Bob Gainey,3,66,10,LW,1973
3262,20,21,Bob Gainey,17,80,37,LW,1974
3263,13,22,Bob Gainey,15,78,28,LW,1975
3264,19,23,Bob Gainey,14,80,33,LW,1976
3265,16,24,Bob Gainey,15,66,31,LW,1977
3266,18,25,Bob Gainey,20,79,38,LW,1978
3267,19,26,Bob Gainey,14,64,33,LW,1979
3268,24,27,Bob Gainey,23,78,47,LW,1980
3269,24,28,Bob Gainey,21,79,45,LW,1981
3270,18,29,Bob Gainey,12,80,30,LW,1982
3271,22,30,Bob Gainey,17,77,39,LW,1983
3272,13,31,Bob Gainey,19,79,32,LW,1984
3273,23,32,Bob Gainey,20,80,43,LW,1985
3274,8,33,Bob Gainey,8,47,16,LW,1986
3275,11,34,Bob Gainey,11,78,22,LW,1987
3276,7,35,Bob Gainey,10,49,17,LW,1988
3277,3,20,Bob Gassoff,0,28,3,D,1973
3278,14,21,Bob Gassoff,4,60,18,D,1974
3279,12,22,Bob Gassoff,1,80,13,D,1975
3280,18,23,Bob Gassoff,6,77,24,D,1976
3281,0,22,Bob Geale,0,1,0,C,1984
3282,26,26,Bob Girard,16,80,42,LW,1975
3283,10,27,Bob Girard,11,68,21,LW,1976
3284,18,28,Bob Girard,9,77,27,LW,1977
3285,15,29,Bob Girard,9,79,24,LW,1978
3286,0,30,Bob Girard,0,1,0,LW,1979
3287,0,25,Bob Gladney,0,1,0,D,1982
3288,5,26,Bob Gladney,1,13,6,D,1983
3289,0,23,Bob Gryp,0,1,0,LW,1973
3290,8,24,Bob Gryp,5,27,13,LW,1974
3291,5,25,Bob Gryp,6,46,11,LW,1975
3292,9,19,Bob Halkidis,1,37,10,D,1985
3293,1,20,Bob Halkidis,1,6,2,D,1986
3294,3,21,Bob Halkidis,0,30,3,D,1987
3295,1,22,Bob Halkidis,0,16,1,D,1988
3296,4,23,Bob Halkidis,0,20,4,D,1989
3297,3,24,Bob Halkidis,1,34,4,D,1990
3298,3,25,Bob Halkidis,3,46,6,D,1991
3299,4,27,Bob Halkidis,1,28,5,D,1993
3300,4,28,Bob Halkidis,1,31,5,D,1994
3301,0,29,Bob Halkidis,0,8,0,D,1995
3302,30,19,Bob Hess,9,76,39,D,1974
3303,23,20,Bob Hess,9,78,32,D,1975
3304,18,21,Bob Hess,4,53,22,D,1976
3305,12,22,Bob Hess,2,55,14,D,1977
3306,4,23,Bob Hess,3,27,7,D,1978
3307,0,25,Bob Hess,0,4,0,D,1980
3308,8,26,Bob Hess,0,33,8,D,1981
3309,0,28,Bob Hess,0,3,0,D,1983
3310,1,22,Bob Hoffmeyer,0,5,1,D,1977
3311,2,23,Bob Hoffmeyer,0,6,2,D,1978
3312,20,26,Bob Hoffmeyer,7,57,27,D,1981
3313,11,27,Bob Hoffmeyer,2,35,13,D,1982
3314,12,28,Bob Hoffmeyer,4,58,16,D,1983
3315,6,29,Bob Hoffmeyer,1,37,7,D,1984
3316,0,24,Bob Hurlburt,0,1,0,LW,1974
3317,18,20,Bob J Kelly,14,76,32,LW,1970
3318,15,21,Bob J Kelly,14,78,29,LW,1971
3319,11,22,Bob J Kelly,10,77,21,LW,1972
3320,10,23,Bob J Kelly,4,65,14,LW,1973
3321,18,24,Bob J Kelly,11,67,29,LW,1974
3322,8,25,Bob J Kelly,12,79,20,LW,1975
3323,24,26,Bob J Kelly,22,73,46,LW,1976
3324,13,27,Bob J Kelly,19,74,32,LW,1977
3325,31,28,Bob J Kelly,7,77,38,LW,1978
3326,20,29,Bob J Kelly,15,75,35,LW,1979
3327,36,30,Bob J Kelly,26,80,62,LW,1980
3328,4,31,Bob J Kelly,0,16,4,LW,1981
3329,2,24,Bob J Murdoch,0,1,2,D,1970
3330,1,25,Bob J Murdoch,1,11,2,D,1971
3331,22,26,Bob J Murdoch,2,69,24,D,1972
3332,20,27,Bob J Murdoch,8,76,28,D,1973
3333,29,28,Bob J Murdoch,13,80,42,D,1974
3334,29,29,Bob J Murdoch,6,80,35,D,1975
3335,23,30,Bob J Murdoch,9,70,32,D,1976
3336,17,31,Bob J Murdoch,2,76,19,D,1977
3337,23,32,Bob J Murdoch,8,67,31,D,1978
3338,16,33,Bob J Murdoch,5,80,21,D,1979
3339,19,34,Bob J Murdoch,3,74,22,D,1980
3340,17,35,Bob J Murdoch,3,73,20,D,1981
3341,3,25,Bob J Murray,0,62,3,D,1973
3342,8,26,Bob J Murray,4,55,12,D,1974
3343,5,27,Bob J Murray,2,65,7,D,1975
3344,0,28,Bob J Murray,0,12,0,D,1976
3345,1,28,Bob Jay,0,3,1,D,1993
3346,0,23,Bob Jones,0,2,0,LW,1968
3347,19,27,Bob Jones,13,76,32,LW,1972
3348,19,27,Bob Jones,13,76,32,LW,1972
3349,28,28,Bob Jones,17,78,45,C,1973
3350,28,28,Bob Jones,17,78,45,C,1973
3351,1,29,Bob Jones,0,5,1,LW,1974
3352,1,29,Bob Jones,0,5,1,LW,1974
3353,0,30,Bob Jones,0,2,0,LW,1975
3354,0,30,Bob Jones,0,2,0,LW,1975
3355,5,21,Bob Joyce,7,15,12,LW,1987
3356,31,22,Bob Joyce,18,77,49,LW,1988
3357,10,23,Bob Joyce,6,47,16,LW,1989
3358,3,24,Bob Joyce,3,17,6,LW,1990
3359,0,25,Bob Joyce,0,1,0,LW,1991
3360,0,26,Bob Joyce,0,1,0,LW,1992
3361,1,23,Bob Kudelski,0,26,1,C,1987
3362,3,24,Bob Kudelski,1,14,4,RW,1988
3363,13,25,Bob Kudelski,23,62,36,C,1989
3364,13,26,Bob Kudelski,23,72,36,RW,1990
3365,21,27,Bob Kudelski,22,80,43,C,1991
3366,17,28,Bob Kudelski,24,63,41,RW,1992
3367,30,29,Bob Kudelski,40,86,70,RW,1993
3368,3,30,Bob Kudelski,6,26,9,RW,1994
3369,1,31,Bob Kudelski,0,13,1,RW,1995
3370,27,22,Bob L Murdoch,22,78,49,LW,1975
3371,19,23,Bob L Murdoch,23,57,42,RW,1976
3372,26,24,Bob L Murdoch,14,71,40,RW,1977
3373,13,25,Bob L Murdoch,13,54,26,RW,1978
3374,0,20,Bob LaForest,1,5,1,RW,1983
3375,33,28,Bob Leduc,22,78,55,C,1972
3376,29,29,Bob Leduc,22,61,51,LW,1973
3377,4,30,Bob Leduc,3,19,7,LW,1974
3378,1,23,Bob Lemieux,0,19,1,D,1967
3379,1,22,Bob Liddington,0,11,1,LW,1970
3380,11,24,Bob Liddington,20,78,31,LW,1972
3381,11,24,Bob Liddington,20,78,31,LW,1972
3382,21,25,Bob Liddington,26,73,47,LW,1973
3383,21,25,Bob Liddington,26,73,47,LW,1973
3384,18,26,Bob Liddington,23,78,41,LW,1974
3385,18,26,Bob Liddington,23,78,41,LW,1974
3386,8,27,Bob Liddington,7,37,15,LW,1975
3387,8,27,Bob Liddington,7,37,15,LW,1975
3388,24,28,Bob Liddington,20,80,44,LW,1976
3389,24,28,Bob Liddington,20,80,44,LW,1976
3390,1,23,Bob Lorimer,0,1,1,C,1976
3391,0,24,Bob Lorimer,1,5,1,D,1977
3392,18,25,Bob Lorimer,3,67,21,D,1978
3393,16,26,Bob Lorimer,3,74,19,D,1979
3394,12,27,Bob Lorimer,1,73,13,D,1980
3395,15,28,Bob Lorimer,5,79,20,D,1981
3396,10,29,Bob Lorimer,3,66,13,D,1982
3397,10,30,Bob Lorimer,2,72,12,D,1983
3398,6,31,Bob Lorimer,2,46,8,D,1984
3399,2,32,Bob Lorimer,2,46,4,D,1985
3400,27,20,Bob MacMillan,13,75,40,C,1972
3401,27,20,Bob MacMillan,13,75,40,C,1972
3402,34,21,Bob MacMillan,14,78,48,C,1973
3403,34,21,Bob MacMillan,14,78,48,C,1973
3404,2,22,Bob MacMillan,1,22,3,C,1974
3405,32,23,Bob MacMillan,20,80,52,RW,1975
3406,39,24,Bob MacMillan,19,80,58,LW,1976
3407,33,25,Bob MacMillan,38,80,71,LW,1977
3408,71,26,Bob MacMillan,37,79,108,LW,1978
3409,39,27,Bob MacMillan,22,77,61,RW,1979
3410,35,28,Bob MacMillan,28,77,63,RW,1980
3411,39,29,Bob MacMillan,22,80,61,RW,1981
3412,29,30,Bob MacMillan,19,71,48,RW,1982
3413,23,31,Bob MacMillan,17,71,40,RW,1983
3414,7,32,Bob MacMillan,5,36,12,RW,1984
3415,0,20,Bob Manno,0,2,0,D,1976
3416,14,21,Bob Manno,5,49,19,D,1977
3417,16,22,Bob Manno,5,52,21,D,1978
3418,14,23,Bob Manno,3,40,17,D,1979
3419,11,24,Bob Manno,0,20,11,D,1980
3420,41,25,Bob Manno,9,72,50,D,1981
3421,13,27,Bob Manno,9,62,22,D,1983
3422,22,28,Bob Manno,10,74,32,LW,1984
3423,7,22,Bob McAneeley,5,51,12,LW,1972
3424,7,22,Bob McAneeley,5,51,12,LW,1972
3425,11,23,Bob McAneeley,12,52,23,C,1973
3426,11,23,Bob McAneeley,12,52,23,C,1973
3427,16,25,Bob McAneeley,12,71,28,C,1975
3428,16,25,Bob McAneeley,12,71,28,C,1975
3429,9,33,Bob McCord,3,73,12,D,1967
3430,17,34,Bob McCord,4,69,21,D,1968
3431,13,38,Bob McCord,1,43,14,D,1972
3432,10,19,Bob McGill,1,68,11,D,1981
3433,0,20,Bob McGill,0,30,0,D,1982
3434,2,21,Bob McGill,0,11,2,D,1983
3435,5,22,Bob McGill,0,72,5,D,1984
3436,4,23,Bob McGill,1,61,5,D,1985
3437,4,24,Bob McGill,1,56,5,D,1986
3438,7,25,Bob McGill,4,67,11,D,1987
3439,4,26,Bob McGill,0,68,4,D,1988
3440,10,27,Bob McGill,2,69,12,D,1989
3441,5,28,Bob McGill,4,77,9,D,1990
3442,1,29,Bob McGill,3,74,4,D,1991
3443,0,30,Bob McGill,1,19,1,D,1992
3444,3,31,Bob McGill,0,33,3,D,1993
3445,14,22,Bob McManama,5,47,19,C,1973
3446,9,23,Bob McManama,5,40,14,C,1974
3447,2,24,Bob McManama,1,12,3,C,1975
3448,10,24,Bob McManama,3,37,13,C,1975
3449,10,24,Bob McManama,3,37,13,C,1975
3450,20,21,Bob Miller,20,76,40,C,1977
3451,33,22,Bob Miller,15,77,48,C,1978
3452,25,23,Bob Miller,16,80,41,C,1979
3453,5,24,Bob Miller,9,52,14,C,1980
3454,20,25,Bob Miller,11,56,31,C,1981
3455,16,28,Bob Miller,4,63,20,C,1984
3456,6,20,Bob Mongrain,4,34,10,C,1979
3457,0,21,Bob Mongrain,0,4,0,C,1980
3458,4,22,Bob Mongrain,6,24,10,C,1981
3459,1,25,Bob Mongrain,1,8,2,C,1984
3460,3,26,Bob Mongrain,2,11,5,C,1985
3461,10,25,Bob Mowat,9,53,19,RW,1974
3462,10,25,Bob Mowat,9,53,19,RW,1974
3463,7,20,Bob Neely,5,54,12,D,1973
3464,16,21,Bob Neely,5,57,21,D,1974
3465,13,22,Bob Neely,9,69,22,D,1975
3466,16,23,Bob Neely,17,70,33,LW,1976
3467,7,24,Bob Neely,3,33,10,LW,1977
3468,30,29,Bob Nevin,28,74,58,RW,1967
3469,25,30,Bob Nevin,31,71,56,RW,1968
3470,19,31,Bob Nevin,18,68,37,RW,1969
3471,25,32,Bob Nevin,21,78,46,RW,1970
3472,19,33,Bob Nevin,15,72,34,RW,1971
3473,13,34,Bob Nevin,5,66,18,RW,1972
3474,30,35,Bob Nevin,20,78,50,RW,1973
3475,41,36,Bob Nevin,31,80,72,RW,1974
3476,42,37,Bob Nevin,13,77,55,RW,1975
3477,2,38,Bob Nevin,3,13,5,RW,1976
3478,2,38,Bob Nevin,3,13,5,RW,1976
3479,1,20,Bob Nystrom,1,11,2,RW,1972
3480,20,21,Bob Nystrom,21,77,41,RW,1973
3481,28,22,Bob Nystrom,27,76,55,RW,1974
3482,25,23,Bob Nystrom,23,80,48,RW,1975
3483,27,24,Bob Nystrom,29,80,56,RW,1976
3484,29,25,Bob Nystrom,30,80,59,RW,1977
3485,20,26,Bob Nystrom,19,78,39,RW,1978
3486,18,27,Bob Nystrom,21,67,39,RW,1979
3487,30,28,Bob Nystrom,14,79,44,RW,1980
3488,25,29,Bob Nystrom,22,74,47,RW,1981
3489,20,30,Bob Nystrom,10,74,30,RW,1982
3490,29,31,Bob Nystrom,15,74,44,RW,1983
3491,5,32,Bob Nystrom,2,36,7,RW,1984
3492,1,33,Bob Nystrom,1,14,2,RW,1985
3493,0,27,Bob Paradise,0,6,0,D,1971
3494,7,28,Bob Paradise,1,71,8,D,1972
3495,8,29,Bob Paradise,2,56,10,D,1973
3496,15,30,Bob Paradise,3,78,18,D,1974
3497,8,31,Bob Paradise,0,57,8,D,1975
3498,5,32,Bob Paradise,0,22,5,D,1976
3499,10,33,Bob Paradise,2,64,12,D,1977
3500,1,34,Bob Paradise,0,14,1,D,1978
3501,5,24,Bob Plager,2,53,7,D,1967
3502,7,25,Bob Plager,0,32,7,D,1968
3503,11,26,Bob Plager,3,64,14,D,1969
3504,19,27,Bob Plager,1,70,20,D,1970
3505,7,28,Bob Plager,4,50,11,D,1971
3506,31,29,Bob Plager,2,77,33,D,1972
3507,10,30,Bob Plager,3,61,13,D,1973
3508,14,31,Bob Plager,1,73,15,D,1974
3509,8,32,Bob Plager,3,63,11,D,1975
3510,9,33,Bob Plager,1,54,10,D,1976
3511,0,34,Bob Plager,0,18,0,D,1977
3512,13,20,Bob Probert,8,44,21,LW,1985
3513,11,21,Bob Probert,13,63,24,LW,1986
3514,33,22,Bob Probert,29,74,62,RW,1987
3515,2,23,Bob Probert,4,25,6,LW,1988
3516,0,24,Bob Probert,3,4,3,LW,1989
3517,23,25,Bob Probert,16,55,39,LW,1990
3518,24,26,Bob Probert,20,63,44,RW,1991
3519,29,27,Bob Probert,14,80,43,RW,1992
3520,10,28,Bob Probert,7,66,17,LW,1993
3521,21,30,Bob Probert,19,78,40,RW,1995
3522,14,31,Bob Probert,9,82,23,LW,1996
3523,1,32,Bob Probert,2,14,3,LW,1997
3524,14,33,Bob Probert,7,78,21,LW,1998
3525,11,34,Bob Probert,4,69,15,LW,1999
3526,12,35,Bob Probert,7,79,19,LW,2000
3527,3,36,Bob Probert,1,61,4,LW,2001
3528,30,31,Bob Pulford,20,74,50,LW,1967
3529,23,32,Bob Pulford,11,72,34,LW,1968
3530,19,33,Bob Pulford,18,74,37,LW,1969
3531,26,34,Bob Pulford,17,59,43,LW,1970
3532,24,35,Bob Pulford,13,73,37,LW,1971
3533,0,21,Bob Richer,0,3,0,C,1972
3534,2,21,Bob Ritchie,6,18,8,LW,1976
3535,2,22,Bob Ritchie,2,11,4,LW,1977
3536,12,28,Bob Rivard,5,27,17,C,1967
3537,0,25,Bob Roselle,0,1,0,LW,1975
3538,0,25,Bob Roselle,0,1,0,LW,1975
3539,0,19,Bob Rouse,0,1,0,D,1983
3540,9,20,Bob Rouse,2,63,11,D,1984
3541,14,21,Bob Rouse,1,75,15,D,1985
3542,10,22,Bob Rouse,2,72,12,D,1986
3543,12,23,Bob Rouse,0,74,12,D,1987
3544,15,24,Bob Rouse,4,79,19,D,1988
3545,16,25,Bob Rouse,4,70,20,D,1989
3546,19,26,Bob Rouse,7,60,26,D,1990
3547,19,27,Bob Rouse,3,79,22,D,1991
3548,11,28,Bob Rouse,3,82,14,D,1992
3549,11,29,Bob Rouse,5,63,16,D,1993
3550,7,30,Bob Rouse,1,48,8,D,1994
3551,6,31,Bob Rouse,0,58,6,D,1995
3552,9,32,Bob Rouse,4,70,13,D,1996
3553,11,33,Bob Rouse,1,71,12,D,1997
3554,11,34,Bob Rouse,0,70,11,D,1998
3555,1,35,Bob Rouse,0,26,1,D,1999
3556,18,20,Bob Russell,13,58,31,RW,1975
3557,18,20,Bob Russell,13,58,31,RW,1975
3558,6,21,Bob Russell,7,57,13,C,1976
3559,6,21,Bob Russell,7,57,13,C,1976
3560,63,26,Bob Sicinski,25,77,88,C,1972
3561,63,26,Bob Sicinski,25,77,88,C,1972
3562,29,27,Bob Sicinski,11,69,40,C,1973
3563,29,27,Bob Sicinski,11,69,40,C,1973
3564,34,28,Bob Sicinski,19,77,53,C,1974
3565,34,28,Bob Sicinski,19,77,53,C,1974
3566,34,29,Bob Sicinski,9,70,43,C,1975
3567,34,29,Bob Sicinski,9,70,43,C,1975
3568,24,30,Bob Sicinski,12,60,36,C,1976
3569,24,30,Bob Sicinski,12,60,36,C,1976
3570,0,20,Bob Sirois,1,3,1,RW,1974
3571,19,21,Bob Sirois,10,44,29,RW,1975
3572,22,22,Bob Sirois,13,45,35,RW,1976
3573,37,23,Bob Sirois,24,72,61,RW,1977
3574,25,24,Bob Sirois,29,73,54,RW,1978
3575,17,25,Bob Sirois,15,49,32,RW,1979
3576,6,23,Bob Stephenson,7,39,13,RW,1977
3577,6,23,Bob Stephenson,7,39,13,RW,1977
3578,24,24,Bob Stephenson,23,78,47,RW,1978
3579,24,24,Bob Stephenson,23,78,47,RW,1978
3580,3,25,Bob Stephenson,2,18,5,RW,1979
3581,2,21,Bob Stewart,1,24,3,D,1971
3582,17,22,Bob Stewart,4,63,21,D,1972
3583,5,23,Bob Stewart,2,47,7,D,1973
3584,12,24,Bob Stewart,5,67,17,D,1974
3585,17,25,Bob Stewart,4,76,21,D,1975
3586,12,26,Bob Stewart,1,73,13,D,1976
3587,15,27,Bob Stewart,2,72,17,D,1977
3588,13,28,Bob Stewart,5,78,18,D,1978
3589,8,29,Bob Stewart,3,75,11,D,1979
3590,1,21,Bob Stumpf,1,10,2,RW,1974
3591,19,25,Bob Sullivan,18,62,37,LW,1982
3592,4,23,Bob Sweeney,2,14,6,C,1986
3593,23,24,Bob Sweeney,22,80,45,C,1987
3594,14,25,Bob Sweeney,14,75,28,C,1988
3595,24,26,Bob Sweeney,22,70,46,C,1989
3596,33,27,Bob Sweeney,15,80,48,C,1990
3597,14,28,Bob Sweeney,6,63,20,RW,1991
3598,26,29,Bob Sweeney,21,80,47,C,1992
3599,14,30,Bob Sweeney,11,60,25,C,1993
3600,4,31,Bob Sweeney,5,45,9,C,1994
3601,7,32,Bob Sweeney,7,72,14,C,1995
3602,0,23,Bob Sykes,0,2,0,LW,1974
3603,18,25,Bob Wall,5,71,23,D,1967
3604,13,26,Bob Wall,13,71,26,LW,1968
3605,13,27,Bob Wall,5,70,18,D,1969
3606,4,28,Bob Wall,2,25,6,D,1970
3607,4,29,Bob Wall,2,45,6,LW,1971
3608,29,30,Bob Wall,16,78,45,D,1972
3609,31,31,Bob Wall,6,74,37,D,1973
3610,9,32,Bob Wall,0,33,9,D,1974
3611,9,32,Bob Wall,0,33,9,D,1974
3612,20,33,Bob Wall,1,68,21,D,1975
3613,20,33,Bob Wall,1,68,21,D,1975
3614,1,26,Bob Warner,1,10,2,D,1976
3615,0,20,Bob Whitlock,0,1,0,C,1969
3616,28,23,Bob Whitlock,23,75,51,C,1972
3617,28,23,Bob Whitlock,23,75,51,C,1972
3618,29,24,Bob Whitlock,20,66,49,C,1973
3619,29,24,Bob Whitlock,20,66,49,C,1973
3620,26,25,Bob Whitlock,31,73,57,C,1974
3621,26,25,Bob Whitlock,31,73,57,C,1974
3622,15,26,Bob Whitlock,7,30,22,C,1975
3623,15,26,Bob Whitlock,7,30,22,C,1975
3624,2,21,Bob Wilkie,1,8,3,D,1990
3625,3,24,Bob Wilkie,1,10,4,D,1993
3626,12,22,Bob Winograd,0,52,12,D,1972
3627,0,23,Bob Winograd,1,7,1,D,1973
3628,0,26,Bob Winograd,0,1,0,D,1976
3629,0,26,Bob Winograd,0,1,0,D,1976
3630,17,26,Bob Woytowich,4,66,21,D,1967
3631,20,27,Bob Woytowich,9,71,29,D,1968
3632,25,28,Bob Woytowich,8,68,33,D,1969
3633,22,29,Bob Woytowich,4,78,26,D,1970
3634,8,30,Bob Woytowich,1,67,9,D,1971
3635,4,31,Bob Woytowich,2,62,6,D,1972
3636,4,31,Bob Woytowich,2,62,6,D,1972
3637,28,32,Bob Woytowich,6,72,34,D,1973
3638,12,33,Bob Woytowich,0,66,12,D,1974
3639,7,34,Bob Woytowich,1,42,8,D,1975
3640,7,34,Bob Woytowich,1,42,8,D,1975
3641,0,23,Bob Wren,0,3,0,LW,1997
3642,0,26,Bob Wren,0,1,0,C,2000
3643,0,27,Bob Wren,0,1,0,C,2001
3644,0,24,Bobby Allen,0,1,0,D,2002
3645,3,28,Bobby Allen,0,31,3,D,2006
3646,0,29,Bobby Allen,0,19,0,D,2007
3647,0,22,Bobby Babcock,0,1,0,D,1990
3648,0,24,Bobby Babcock,0,1,0,D,1992
3649,0,22,Bobby Butler,0,2,0,LW,2009
3650,11,23,Bobby Butler,10,36,21,LW,2010
3651,10,24,Bobby Butler,6,56,16,LW,2011
3652,7,25,Bobby Butler,4,34,11,LW,2012
3653,1,26,Bobby Butler,0,2,1,RW,2013
3654,31,20,Bobby Clarke,15,76,46,C,1969
3655,36,21,Bobby Clarke,27,77,63,C,1970
3656,46,22,Bobby Clarke,35,78,81,C,1971
3657,67,23,Bobby Clarke,37,78,104,C,1972
3658,52,24,Bobby Clarke,35,77,87,C,1973
3659,89,25,Bobby Clarke,27,80,116,C,1974
3660,89,26,Bobby Clarke,30,76,119,C,1975
3661,63,27,Bobby Clarke,27,80,90,C,1976
3662,68,28,Bobby Clarke,21,71,89,C,1977
3663,57,29,Bobby Clarke,16,80,73,C,1978
3664,57,30,Bobby Clarke,12,76,69,C,1979
3665,46,31,Bobby Clarke,19,80,65,C,1980
3666,46,32,Bobby Clarke,17,62,63,C,1981
3667,62,33,Bobby Clarke,23,80,85,C,1982
3668,43,34,Bobby Clarke,17,73,60,C,1983
3669,3,20,Bobby Crawford,1,15,4,RW,1980
3670,0,22,Bobby Crawford,0,1,0,RW,1982
3671,0,19,Bobby Dollas,0,1,0,D,1983
3672,0,20,Bobby Dollas,0,9,0,D,1984
3673,5,21,Bobby Dollas,0,46,5,D,1985
3674,0,23,Bobby Dollas,0,9,0,D,1987
3675,3,24,Bobby Dollas,0,16,3,D,1988
3676,5,26,Bobby Dollas,3,56,8,D,1990
3677,1,27,Bobby Dollas,3,27,4,D,1991
3678,0,28,Bobby Dollas,0,6,0,D,1992
3679,11,29,Bobby Dollas,9,77,20,D,1993
3680,13,30,Bobby Dollas,7,45,20,D,1994
3681,22,31,Bobby Dollas,8,82,30,D,1995
3682,14,32,Bobby Dollas,4,79,18,D,1996
3683,6,33,Bobby Dollas,2,52,8,D,1997
3684,8,34,Bobby Dollas,2,70,10,D,1998
3685,7,35,Bobby Dollas,3,50,10,D,1999
3686,1,36,Bobby Dollas,1,21,2,D,2000
3687,0,26,Bobby Farnham,0,11,0,RW,2014
3688,2,27,Bobby Farnham,8,53,10,RW,2015
3689,0,28,Bobby Farnham,0,3,0,RW,2016
3690,0,24,Bobby Francis,2,14,2,C,1982
3691,0,22,Bobby Gould,0,1,0,RW,1979
3692,0,23,Bobby Gould,0,3,0,RW,1980
3693,13,24,Bobby Gould,21,76,34,RW,1981
3694,18,25,Bobby Gould,22,80,40,RW,1982
3695,19,26,Bobby Gould,21,78,40,RW,1983
3696,19,27,Bobby Gould,14,78,33,RW,1984
3697,19,28,Bobby Gould,19,79,38,RW,1985
3698,27,29,Bobby Gould,23,78,50,RW,1986
3699,14,30,Bobby Gould,12,72,26,RW,1987
3700,13,31,Bobby Gould,5,75,18,C,1988
3701,17,32,Bobby Gould,8,77,25,RW,1989
3702,28,22,Bobby Guindon,28,71,56,LW,1972
3703,28,22,Bobby Guindon,28,71,56,LW,1972
3704,39,23,Bobby Guindon,31,77,70,LW,1973
3705,39,23,Bobby Guindon,31,77,70,LW,1973
3706,18,24,Bobby Guindon,12,69,30,LW,1974
3707,18,24,Bobby Guindon,12,69,30,LW,1974
3708,3,25,Bobby Guindon,3,29,6,LW,1975
3709,3,25,Bobby Guindon,3,29,6,LW,1975
3710,17,26,Bobby Guindon,10,69,27,LW,1976
3711,22,27,Bobby Guindon,20,77,42,LW,1977
3712,18,28,Bobby Guindon,8,71,26,LW,1978
3713,18,28,Bobby Guindon,8,71,26,LW,1978
3714,1,29,Bobby Guindon,0,6,1,LW,1979
3715,22,20,Bobby Holik,21,78,43,LW,1990
3716,24,21,Bobby Holik,21,76,45,LW,1991
3717,19,22,Bobby Holik,20,61,39,LW,1992
3718,20,23,Bobby Holik,13,70,33,C,1993
3719,10,24,Bobby Holik,10,48,20,C,1994
3720,17,25,Bobby Holik,13,63,30,C,1995
3721,39,26,Bobby Holik,23,82,62,C,1996
3722,36,27,Bobby Holik,29,82,65,C,1997
3723,37,28,Bobby Holik,27,78,64,LW,1998
3724,23,29,Bobby Holik,23,79,46,C,1999
3725,35,30,Bobby Holik,15,80,50,C,2000
3726,29,31,Bobby Holik,25,81,54,C,2001
3727,19,32,Bobby Holik,16,64,35,C,2002
3728,31,33,Bobby Holik,25,82,56,C,2003
3729,18,35,Bobby Holik,15,64,33,C,2005
3730,18,36,Bobby Holik,11,82,29,C,2006
3731,19,37,Bobby Holik,15,82,34,C,2007
3732,5,38,Bobby Holik,4,62,9,C,2008
3733,31,29,Bobby Hull,44,71,75,LW,1967
3734,49,30,Bobby Hull,58,74,107,LW,1968
3735,29,31,Bobby Hull,38,61,67,LW,1969
3736,52,32,Bobby Hull,44,78,96,LW,1970
3737,43,33,Bobby Hull,50,78,93,LW,1971
3738,11,41,Bobby Hull,6,27,17,LW,1979
3739,52,34,Bobby Hull*,51,63,103,LW,1972
3740,52,34,Bobby Hull*,51,63,103,LW,1972
3741,42,35,Bobby Hull*,53,75,95,LW,1973
3742,42,35,Bobby Hull*,53,75,95,LW,1973
3743,65,36,Bobby Hull*,77,78,142,LW,1974
3744,65,36,Bobby Hull*,77,78,142,LW,1974
3745,70,37,Bobby Hull*,53,80,123,LW,1975
3746,70,37,Bobby Hull*,53,80,123,LW,1975
3747,32,38,Bobby Hull*,21,34,53,LW,1976
3748,32,38,Bobby Hull*,21,34,53,LW,1976
3749,71,39,Bobby Hull*,46,77,117,LW,1977
3750,71,39,Bobby Hull*,46,77,117,LW,1977
3751,3,40,Bobby Hull*,2,4,5,LW,1978
3752,3,40,Bobby Hull*,2,4,5,LW,1978
3753,5,20,Bobby Lalonde,1,27,6,C,1971
3754,27,21,Bobby Lalonde,20,77,47,C,1972
3755,4,22,Bobby Lalonde,3,36,7,LW,1973
3756,30,23,Bobby Lalonde,17,74,47,C,1974
3757,36,24,Bobby Lalonde,14,71,50,C,1975
3758,15,25,Bobby Lalonde,17,68,32,C,1976
3759,23,26,Bobby Lalonde,14,73,37,C,1977
3760,32,27,Bobby Lalonde,24,78,56,C,1978
3761,26,28,Bobby Lalonde,10,74,36,C,1979
3762,12,29,Bobby Lalonde,4,62,16,C,1980
3763,0,30,Bobby Lalonde,0,1,0,C,1981
3764,0,27,Bobby Leiter,0,1,0,C,1968
3765,17,30,Bobby Leiter,14,78,31,C,1971
3766,34,31,Bobby Leiter,26,78,60,C,1972
3767,26,32,Bobby Leiter,26,78,52,C,1973
3768,18,33,Bobby Leiter,10,52,28,C,1974
3769,3,34,Bobby Leiter,2,26,5,C,1975
3770,17,34,Bobby Leiter,17,51,34,C,1975
3771,17,34,Bobby Leiter,17,51,34,C,1975
3772,20,19,Bobby Orr,11,46,31,D,1967
3773,43,20,Bobby Orr,21,67,64,D,1968
3774,87,21,Bobby Orr,33,76,120,D,1969
3775,102,22,Bobby Orr,37,78,139,D,1970
3776,80,23,Bobby Orr,37,76,117,D,1971
3777,72,24,Bobby Orr,29,63,101,D,1972
3778,90,25,Bobby Orr,32,74,122,D,1973
3779,89,26,Bobby Orr,46,80,135,D,1974
3780,13,27,Bobby Orr,5,10,18,D,1975
3781,19,28,Bobby Orr,4,20,23,D,1976
3782,2,30,Bobby Orr,2,6,4,D,1978
3783,1,22,Bobby Reynolds,1,7,2,LW,1989
3784,0,33,Bobby Robins,0,3,0,RW,2014
3785,46,27,Bobby Rousseau,19,74,65,RW,1967
3786,40,28,Bobby Rousseau,30,76,70,RW,1968
3787,34,29,Bobby Rousseau,24,72,58,RW,1969
3788,20,30,Bobby Rousseau,4,63,24,RW,1970
3789,36,31,Bobby Rousseau,21,78,57,C,1971
3790,37,32,Bobby Rousseau,8,78,45,RW,1972
3791,41,33,Bobby Rousseau,10,72,51,RW,1973
3792,2,34,Bobby Rousseau,2,8,4,RW,1974
3793,5,20,Bobby Ryan,5,23,10,RW,2007
3794,26,21,Bobby Ryan,31,64,57,RW,2008
3795,29,22,Bobby Ryan,35,81,64,RW,2009
3796,37,23,Bobby Ryan,34,82,71,RW,2010
3797,26,24,Bobby Ryan,31,82,57,RW,2011
3798,19,25,Bobby Ryan,11,46,30,RW,2012
3799,25,26,Bobby Ryan,23,70,48,RW,2013
3800,36,27,Bobby Ryan,18,78,54,RW,2014
3801,34,28,Bobby Ryan,22,81,56,RW,2015
3802,12,29,Bobby Ryan,13,62,25,RW,2016
3803,22,30,Bobby Ryan,11,62,33,RW,2017
3804,0,21,Bobby Sanguinetti,0,5,0,D,2009
3805,0,23,Bobby Sanguinetti,0,3,0,D,2011
3806,4,24,Bobby Sanguinetti,2,37,6,D,2012
3807,2,22,Bobby Schmautz,3,13,5,RW,1967
3808,7,23,Bobby Schmautz,9,63,16,RW,1968
3809,5,25,Bobby Schmautz,5,26,10,RW,1970
3810,13,26,Bobby Schmautz,12,60,25,RW,1971
3811,33,27,Bobby Schmautz,38,77,71,RW,1972
3812,32,28,Bobby Schmautz,33,76,65,RW,1973
3813,30,29,Bobby Schmautz,21,56,51,RW,1974
3814,34,30,Bobby Schmautz,28,75,62,RW,1975
3815,29,31,Bobby Schmautz,23,57,52,RW,1976
3816,27,32,Bobby Schmautz,27,54,54,RW,1977
3817,22,33,Bobby Schmautz,20,65,42,RW,1978
3818,18,34,Bobby Schmautz,25,69,43,RW,1979
3819,34,35,Bobby Schmautz,27,73,61,RW,1980
3820,1,21,Bobby Sheehan,2,16,3,C,1969
3821,5,22,Bobby Sheehan,6,29,11,C,1970
3822,26,23,Bobby Sheehan,20,78,46,C,1971
3823,53,24,Bobby Sheehan,35,75,88,C,1972
3824,53,24,Bobby Sheehan,35,75,88,C,1972
3825,11,25,Bobby Sheehan,13,60,24,C,1973
3826,11,25,Bobby Sheehan,13,60,24,C,1973
3827,39,26,Bobby Sheehan,19,77,58,C,1974
3828,39,26,Bobby Sheehan,19,77,58,C,1974
3829,20,27,Bobby Sheehan,11,78,31,C,1975
3830,4,28,Bobby Sheehan,5,34,9,C,1976
3831,7,29,Bobby Sheehan,8,29,15,C,1977
3832,7,29,Bobby Sheehan,8,29,15,C,1977
3833,4,31,Bobby Sheehan,3,30,7,C,1979
3834,3,32,Bobby Sheehan,1,41,4,LW,1980
3835,0,33,Bobby Sheehan,0,4,0,C,1981
3836,10,20,Bobby Simpson,13,72,23,LW,1976
3837,8,21,Bobby Simpson,10,55,18,LW,1977
3838,2,23,Bobby Simpson,2,18,4,LW,1979
3839,9,25,Bobby Simpson,9,26,18,LW,1981
3840,0,26,Bobby Simpson,1,4,1,LW,1982
3841,44,20,Bobby Smith,30,80,74,C,1978
3842,56,21,Bobby Smith,27,61,83,C,1979
3843,64,22,Bobby Smith,29,78,93,C,1980
3844,71,23,Bobby Smith,43,80,114,C,1981
3845,53,24,Bobby Smith,24,77,77,C,1982
3846,43,25,Bobby Smith,29,80,72,C,1983
3847,40,26,Bobby Smith,16,65,56,C,1984
3848,55,27,Bobby Smith,31,79,86,C,1985
3849,47,28,Bobby Smith,28,80,75,C,1986
3850,66,29,Bobby Smith,27,78,93,C,1987
3851,51,30,Bobby Smith,32,80,83,C,1988
3852,14,31,Bobby Smith,12,53,26,C,1989
3853,31,32,Bobby Smith,15,73,46,C,1990
3854,37,33,Bobby Smith,9,68,46,C,1991
3855,7,34,Bobby Smith,5,45,12,C,1992
3856,0,20,Bogdan Yakimov,0,1,0,C,2014
3857,0,28,Bohumil Salajka,2,6,2,RW,1978
3858,0,28,Bohumil Salajka,2,6,2,RW,1978
3859,0,23,Boo Nieves,0,1,0,C,2016
3860,8,24,Boo Nieves,1,28,9,C,2017
3861,13,20,Boone Jenner,16,72,29,C,2013
3862,8,21,Boone Jenner,9,31,17,C,2014
3863,19,22,Boone Jenner,30,82,49,C,2015
3864,16,23,Boone Jenner,18,82,34,C,2016
3865,19,24,Boone Jenner,13,75,32,C,2017
3866,24,21,Boris Mironov,7,79,31,D,1993
3867,7,22,Boris Mironov,1,29,8,D,1994
3868,24,23,Boris Mironov,8,78,32,D,1995
3869,26,24,Boris Mironov,6,55,32,D,1996
3870,30,25,Boris Mironov,16,81,46,D,1997
3871,38,26,Boris Mironov,11,75,49,D,1998
3872,28,27,Boris Mironov,9,58,37,D,1999
3873,17,28,Boris Mironov,5,66,22,D,2000
3874,14,29,Boris Mironov,4,64,18,D,2001
3875,10,30,Boris Mironov,6,56,16,D,2002
3876,13,31,Boris Mironov,3,75,16,D,2003
3877,0,21,Boris Valabik,0,7,0,D,2007
3878,5,22,Boris Valabik,0,50,5,D,2008
3879,2,23,Boris Valabik,0,23,2,D,2009
3880,34,22,Borje Salming,5,76,39,D,1973
3881,25,23,Borje Salming,12,60,37,D,1974
3882,41,24,Borje Salming,16,78,57,D,1975
3883,66,25,Borje Salming,12,76,78,D,1976
3884,60,26,Borje Salming,16,80,76,D,1977
3885,56,27,Borje Salming,17,78,73,D,1978
3886,52,28,Borje Salming,19,74,71,D,1979
3887,61,29,Borje Salming,5,72,66,D,1980
3888,44,30,Borje Salming,12,69,56,D,1981
3889,38,31,Borje Salming,7,69,45,D,1982
3890,38,32,Borje Salming,5,68,43,D,1983
3891,33,33,Borje Salming,6,73,39,D,1984
3892,15,34,Borje Salming,7,41,22,D,1985
3893,16,35,Borje Salming,4,56,20,D,1986
3894,24,36,Borje Salming,2,66,26,D,1987
3895,17,37,Borje Salming,3,63,20,D,1988
3896,17,38,Borje Salming,2,49,19,D,1989
3897,1,22,Borna Rendulic,1,11,2,RW,2014
3898,0,23,Borna Rendulic,0,3,0,RW,2015
3899,0,24,Borna Rendulic,0,1,0,RW,2016
3900,4,19,Boyd Devereaux,1,38,5,C,1997
3901,8,20,Boyd Devereaux,6,61,14,C,1998
3902,19,21,Boyd Devereaux,8,76,27,C,1999
3903,6,22,Boyd Devereaux,5,55,11,LW,2000
3904,16,23,Boyd Devereaux,9,79,25,LW,2001
3905,9,24,Boyd Devereaux,3,61,12,LW,2002
3906,9,25,Boyd Devereaux,6,61,15,RW,2003
3907,14,27,Boyd Devereaux,8,78,22,C,2005
3908,11,28,Boyd Devereaux,8,33,19,C,2006
3909,11,29,Boyd Devereaux,7,62,18,C,2007
3910,5,30,Boyd Devereaux,6,23,11,C,2008
3911,5,20,Boyd Gordon,1,41,6,C,2003
3912,1,22,Boyd Gordon,0,25,1,RW,2005
3913,22,23,Boyd Gordon,7,71,29,RW,2006
3914,9,24,Boyd Gordon,7,67,16,C,2007
3915,9,25,Boyd Gordon,5,63,14,C,2008
3916,6,26,Boyd Gordon,4,36,10,RW,2009
3917,6,27,Boyd Gordon,3,60,9,RW,2010
3918,15,28,Boyd Gordon,8,75,23,RW,2011
3919,10,29,Boyd Gordon,4,48,14,RW,2012
3920,13,30,Boyd Gordon,8,74,21,C,2013
3921,7,31,Boyd Gordon,6,68,13,C,2014
3922,2,32,Boyd Gordon,2,65,4,C,2015
3923,0,33,Boyd Gordon,1,13,1,C,2016
3924,0,25,Boyd Kane,0,7,0,LW,2003
3925,1,27,Boyd Kane,0,5,1,LW,2005
3926,2,28,Boyd Kane,0,15,2,LW,2006
3927,0,30,Boyd Kane,0,1,0,LW,2008
3928,0,31,Boyd Kane,0,3,0,LW,2009
3929,0,30,Bracken Kearns,0,5,0,C,2011
3930,0,31,Bracken Kearns,0,1,0,C,2012
3931,2,32,Bracken Kearns,3,25,5,C,2013
3932,1,34,Bracken Kearns,0,2,1,C,2015
3933,0,35,Bracken Kearns,0,2,0,C,2016
3934,1,20,Brad Aitken,1,5,2,LW,1987
3935,2,23,Brad Aitken,0,9,2,LW,1990
3936,0,20,Brad Berry,1,13,1,D,1985
3937,8,21,Brad Berry,2,52,10,D,1986
3938,6,22,Brad Berry,0,48,6,D,1987
3939,9,23,Brad Berry,0,38,9,D,1988
3940,2,24,Brad Berry,1,12,3,D,1989
3941,0,26,Brad Berry,0,7,0,D,1991
3942,3,27,Brad Berry,0,63,3,D,1992
3943,0,28,Brad Berry,0,8,0,D,1993
3944,5,25,Brad Bombardir,1,43,6,D,1997
3945,7,26,Brad Bombardir,1,56,8,D,1998
3946,1,27,Brad Bombardir,3,32,4,D,1999
3947,15,28,Brad Bombardir,0,70,15,D,2000
3948,2,29,Brad Bombardir,1,28,3,D,2001
3949,14,30,Brad Bombardir,1,58,15,D,2002
3950,2,31,Brad Bombardir,1,69,3,D,2003
3951,0,21,Brad Boyes,0,1,0,C,2003
3952,43,23,Brad Boyes,26,82,69,C,2005
3953,29,24,Brad Boyes,17,81,46,C,2006
3954,22,25,Brad Boyes,43,82,65,RW,2007
3955,39,26,Brad Boyes,33,82,72,RW,2008
3956,28,27,Brad Boyes,14,82,42,C,2009
3957,38,28,Brad Boyes,17,83,55,C,2010
3958,15,29,Brad Boyes,8,65,23,C,2011
3959,25,30,Brad Boyes,10,48,35,C,2012
3960,15,31,Brad Boyes,21,78,36,RW,2013
3961,24,32,Brad Boyes,14,78,38,RW,2014
3962,16,33,Brad Boyes,8,60,24,RW,2015
3963,0,21,Brad Brown,0,8,0,D,1996
3964,7,23,Brad Brown,1,66,8,D,1998
3965,9,24,Brad Brown,0,57,9,D,1999
3966,3,25,Brad Brown,1,48,4,D,2000
3967,4,26,Brad Brown,0,51,4,D,2001
3968,1,27,Brad Brown,0,57,1,D,2002
3969,3,28,Brad Brown,0,43,3,D,2003
3970,0,23,Brad Buetow,0,25,0,D,1973
3971,0,23,Brad Buetow,0,25,0,D,1973
3972,6,25,Brad Chartrand,6,50,12,RW,1999
3973,0,26,Brad Chartrand,1,4,1,RW,2000
3974,9,27,Brad Chartrand,7,46,16,C,2001
3975,6,28,Brad Chartrand,8,62,14,C,2002
3976,4,29,Brad Chartrand,3,53,7,C,2003
3977,0,21,Brad Church,0,2,0,LW,1997
3978,0,18,Brad Dalgarno,1,2,1,RW,1985
3979,8,20,Brad Dalgarno,2,38,10,RW,1987
3980,10,21,Brad Dalgarno,11,55,21,RW,1988
3981,12,23,Brad Dalgarno,3,41,15,RW,1990
3982,1,24,Brad Dalgarno,2,15,3,RW,1991
3983,17,25,Brad Dalgarno,15,57,32,RW,1992
3984,19,26,Brad Dalgarno,11,73,30,RW,1993
3985,2,27,Brad Dalgarno,3,22,5,RW,1994
3986,2,28,Brad Dalgarno,1,18,3,RW,1995
3987,0,25,Brad DeFauw,3,9,3,LW,2002
3988,0,23,Brad Fast,1,1,1,D,2003
3989,2,20,Brad Ference,0,13,2,D,1999
3990,1,21,Brad Ference,0,14,1,D,2000
3991,15,22,Brad Ference,2,80,17,D,2001
3992,7,23,Brad Ference,2,75,9,D,2002
3993,5,24,Brad Ference,0,63,5,D,2003
3994,0,27,Brad Ference,0,5,0,D,2006
3995,0,20,Brad Gassoff,0,4,0,LW,1975
3996,4,21,Brad Gassoff,6,37,10,LW,1976
3997,6,22,Brad Gassoff,9,47,15,LW,1977
3998,7,23,Brad Gassoff,4,34,11,LW,1978
3999,0,25,Brad Hunt,0,3,0,D,2013
4000,2,26,Brad Hunt,1,11,3,D,2014
4001,0,27,Brad Hunt,0,7,0,D,2015
4002,1,28,Brad Hunt,0,3,1,D,2016
4003,15,29,Brad Hunt,3,45,18,D,2017
4004,8,20,Brad Isbister,9,66,17,LW,1997
4005,4,21,Brad Isbister,4,32,8,RW,1998
4006,20,22,Brad Isbister,22,64,42,LW,1999
4007,14,23,Brad Isbister,18,51,32,LW,2000
4008,21,24,Brad Isbister,17,79,38,LW,2001
4009,15,25,Brad Isbister,13,66,28,LW,2002
4010,8,26,Brad Isbister,10,51,18,LW,2003
4011,17,28,Brad Isbister,6,58,23,RW,2005
4012,4,29,Brad Isbister,1,19,5,LW,2006
4013,5,30,Brad Isbister,6,55,11,LW,2007
4014,0,21,Brad Jones,1,4,1,LW,1986
4015,5,22,Brad Jones,2,19,7,LW,1987
4016,5,23,Brad Jones,6,22,11,LW,1988
4017,0,24,Brad Jones,0,2,0,LW,1989
4018,11,25,Brad Jones,9,53,20,RW,1990
4019,10,26,Brad Jones,7,48,17,LW,1991
4020,0,20,Brad Larsen,0,1,0,LW,1997
4021,0,23,Brad Larsen,0,9,0,LW,2000
4022,7,24,Brad Larsen,2,50,9,LW,2001
4023,3,25,Brad Larsen,0,6,3,LW,2002
4024,2,26,Brad Larsen,2,32,4,LW,2003
4025,8,28,Brad Larsen,7,62,15,LW,2005
4026,6,29,Brad Larsen,7,72,13,LW,2006
4027,3,30,Brad Larsen,1,62,4,LW,2007
4028,14,20,Brad Lauer,7,61,21,RW,1986
4029,18,21,Brad Lauer,17,69,35,RW,1987
4030,2,22,Brad Lauer,3,14,5,LW,1988
4031,18,23,Brad Lauer,6,63,24,LW,1989
4032,8,24,Brad Lauer,4,44,12,LW,1990
4033,0,25,Brad Lauer,1,14,1,LW,1991
4034,1,26,Brad Lauer,0,7,1,LW,1992
4035,5,27,Brad Lauer,2,30,7,LW,1993
4036,1,29,Brad Lauer,4,21,5,LW,1995
4037,0,20,Brad Leeb,0,2,0,RW,1999
4038,0,22,Brad Leeb,0,2,0,RW,2001
4039,0,24,Brad Leeb,0,1,0,RW,2003
4040,1,21,Brad Lukowich,0,4,1,D,1997
4041,2,22,Brad Lukowich,1,14,3,D,1998
4042,1,23,Brad Lukowich,3,60,4,D,1999
4043,10,24,Brad Lukowich,4,80,14,D,2000
4044,6,25,Brad Lukowich,1,66,7,D,2001
4045,14,26,Brad Lukowich,1,70,15,D,2002
4046,14,27,Brad Lukowich,5,79,19,D,2003
4047,19,29,Brad Lukowich,2,75,21,D,2005
4048,8,30,Brad Lukowich,4,75,12,D,2006
4049,6,31,Brad Lukowich,1,59,7,D,2007
4050,8,32,Brad Lukowich,0,58,8,D,2008
4051,1,33,Brad Lukowich,1,13,2,D,2009
4052,0,34,Brad Lukowich,0,5,0,D,2010
4053,2,22,Brad Malone,0,9,2,C,2011
4054,1,23,Brad Malone,1,13,2,C,2012
4055,2,24,Brad Malone,3,32,5,C,2013
4056,8,25,Brad Malone,7,65,15,C,2014
4057,4,26,Brad Malone,2,57,6,C,2015
4058,0,28,Brad Malone,0,7,0,C,2017
4059,1,21,Brad Marchand,0,20,1,C,2009
4060,20,22,Brad Marchand,21,77,41,C,2010
4061,27,23,Brad Marchand,28,76,55,C,2011
4062,18,24,Brad Marchand,18,45,36,C,2012
4063,28,25,Brad Marchand,25,82,53,LW,2013
4064,18,26,Brad Marchand,24,77,42,LW,2014
4065,24,27,Brad Marchand,37,77,61,LW,2015
4066,46,28,Brad Marchand,39,80,85,LW,2016
4067,51,29,Brad Marchand,34,68,85,LW,2017
4068,19,20,Brad Marsh,0,80,19,D,1978
4069,9,21,Brad Marsh,2,80,11,D,1979
4070,12,22,Brad Marsh,1,80,13,D,1980
4071,23,23,Brad Marsh,2,83,25,D,1981
4072,11,24,Brad Marsh,2,68,13,D,1982
4073,14,25,Brad Marsh,3,77,17,D,1983
4074,18,26,Brad Marsh,2,77,20,D,1984
4075,13,27,Brad Marsh,0,79,13,D,1985
4076,9,28,Brad Marsh,2,77,11,D,1986
4077,9,29,Brad Marsh,3,70,12,D,1987
4078,15,30,Brad Marsh,1,80,16,D,1988
4079,13,31,Brad Marsh,1,79,14,D,1989
4080,3,32,Brad Marsh,1,42,4,D,1990
4081,4,33,Brad Marsh,3,55,7,D,1991
4082,3,34,Brad Marsh,0,59,3,D,1992
4083,29,20,Brad Maxwell,18,75,47,D,1977
4084,28,21,Brad Maxwell,9,70,37,D,1978
4085,30,22,Brad Maxwell,7,58,37,D,1979
4086,13,23,Brad Maxwell,3,27,16,D,1980
4087,21,24,Brad Maxwell,10,51,31,D,1981
4088,28,25,Brad Maxwell,11,77,39,D,1982
4089,54,26,Brad Maxwell,19,78,73,D,1983
4090,31,27,Brad Maxwell,10,68,41,D,1984
4091,18,28,Brad Maxwell,8,52,26,D,1985
4092,18,29,Brad Maxwell,3,56,21,D,1986
4093,6,20,Brad May,11,69,17,LW,1991
4094,13,21,Brad May,13,82,26,LW,1992
4095,27,22,Brad May,18,84,45,LW,1993
4096,3,23,Brad May,3,33,6,LW,1994
4097,29,24,Brad May,15,79,44,LW,1995
4098,4,25,Brad May,3,42,7,LW,1996
4099,10,26,Brad May,13,63,23,LW,1997
4100,11,27,Brad May,6,66,17,LW,1998
4101,7,28,Brad May,9,59,16,LW,1999
4102,14,29,Brad May,11,62,25,LW,2000
4103,12,30,Brad May,10,72,22,LW,2001
4104,4,31,Brad May,3,23,7,LW,2002
4105,6,32,Brad May,5,70,11,LW,2003
4106,3,34,Brad May,3,54,6,LW,2005
4107,4,35,Brad May,0,24,4,LW,2006
4108,1,36,Brad May,3,61,4,LW,2007
4109,6,37,Brad May,1,58,7,LW,2008
4110,1,38,Brad May,0,40,1,LW,2009
4111,11,20,Brad McCrimmon,5,72,16,D,1979
4112,18,21,Brad McCrimmon,11,78,29,D,1980
4113,8,22,Brad McCrimmon,1,78,9,D,1981
4114,21,23,Brad McCrimmon,4,79,25,D,1982
4115,24,24,Brad McCrimmon,0,71,24,D,1983
4116,35,25,Brad McCrimmon,8,66,43,D,1984
4117,43,26,Brad McCrimmon,13,80,56,D,1985
4118,29,27,Brad McCrimmon,10,71,39,D,1986
4119,35,28,Brad McCrimmon,7,80,42,D,1987
4120,17,29,Brad McCrimmon,5,72,22,D,1988
4121,15,30,Brad McCrimmon,4,79,19,D,1989
4122,13,31,Brad McCrimmon,0,64,13,D,1990
4123,22,32,Brad McCrimmon,7,79,29,D,1991
4124,14,33,Brad McCrimmon,1,60,15,D,1992
4125,5,34,Brad McCrimmon,1,65,6,D,1993
4126,1,35,Brad McCrimmon,0,33,1,D,1994
4127,6,36,Brad McCrimmon,3,58,9,D,1995
4128,5,37,Brad McCrimmon,1,37,6,D,1996
4129,0,19,Brad Miller,0,7,0,D,1988
4130,0,20,Brad Miller,0,1,0,D,1989
4131,0,21,Brad Miller,0,13,0,D,1990
4132,4,22,Brad Miller,1,42,5,D,1991
4133,0,23,Brad Miller,0,11,0,D,1992
4134,1,24,Brad Miller,0,8,1,D,1993
4135,0,27,Brad Mills,1,4,1,C,2010
4136,1,28,Brad Mills,0,27,1,C,2011
4137,0,30,Brad Mills,0,3,0,C,2013
4138,0,22,Brad Moran,0,3,0,C,2001
4139,1,24,Brad Moran,1,2,2,C,2003
4140,1,27,Brad Moran,0,3,1,C,2006
4141,2,26,Brad Norton,0,22,2,D,2001
4142,3,27,Brad Norton,3,53,6,D,2002
4143,2,28,Brad Norton,0,36,2,D,2003
4144,0,30,Brad Norton,0,7,0,D,2005
4145,1,31,Brad Norton,0,6,1,D,2006
4146,4,19,Brad Palmer,4,23,8,LW,1980
4147,23,20,Brad Palmer,22,72,45,LW,1981
4148,11,21,Brad Palmer,6,73,17,LW,1982
4149,23,20,Brad Park,3,54,26,D,1968
4150,26,21,Brad Park,11,60,37,D,1969
4151,37,22,Brad Park,7,68,44,D,1970
4152,49,23,Brad Park,24,75,73,D,1971
4153,43,24,Brad Park,10,52,53,D,1972
4154,57,25,Brad Park,25,78,82,D,1973
4155,44,26,Brad Park,13,65,57,D,1974
4156,41,27,Brad Park,18,56,59,D,1975
4157,55,28,Brad Park,12,77,67,D,1976
4158,57,29,Brad Park,22,80,79,D,1977
4159,32,30,Brad Park,7,40,39,D,1978
4160,16,31,Brad Park,5,32,21,D,1979
4161,52,32,Brad Park,14,78,66,D,1980
4162,42,33,Brad Park,14,75,56,D,1981
4163,26,34,Brad Park,10,76,36,D,1982
4164,53,35,Brad Park,5,80,58,D,1983
4165,30,36,Brad Park,13,67,43,D,1984
4166,0,20,Brad Ralph,0,1,0,LW,2000
4167,14,20,Brad Rhiness,9,58,23,C,1976
4168,14,20,Brad Rhiness,9,58,23,C,1976
4169,3,21,Brad Rhiness,3,12,6,C,1977
4170,3,21,Brad Rhiness,3,12,6,C,1977
4171,41,20,Brad Richards,21,82,62,C,2000
4172,42,21,Brad Richards,20,82,62,C,2001
4173,57,22,Brad Richards,17,80,74,C,2002
4174,53,23,Brad Richards,26,82,79,C,2003
4175,68,25,Brad Richards,23,82,91,C,2005
4176,45,26,Brad Richards,25,82,70,C,2006
4177,42,27,Brad Richards,20,74,62,C,2007
4178,32,28,Brad Richards,16,56,48,C,2008
4179,67,29,Brad Richards,24,80,91,C,2009
4180,49,30,Brad Richards,28,72,77,C,2010
4181,41,31,Brad Richards,25,82,66,C,2011
4182,23,32,Brad Richards,11,46,34,C,2012
4183,31,33,Brad Richards,20,82,51,C,2013
4184,25,34,Brad Richards,12,76,37,C,2014
4185,18,35,Brad Richards,10,68,28,C,2015
4186,10,20,Brad Richardson,3,41,13,C,2005
4187,8,21,Brad Richardson,14,73,22,RW,2006
4188,3,22,Brad Richardson,2,22,5,RW,2007
4189,5,23,Brad Richardson,0,31,5,RW,2008
4190,16,24,Brad Richardson,11,81,27,RW,2009
4191,12,25,Brad Richardson,7,68,19,RW,2010
4192,3,26,Brad Richardson,5,59,8,RW,2011
4193,5,27,Brad Richardson,1,16,6,RW,2012
4194,12,28,Brad Richardson,11,73,23,RW,2013
4195,13,29,Brad Richardson,8,45,21,RW,2014
4196,20,30,Brad Richardson,11,82,31,RW,2015
4197,4,31,Brad Richardson,5,16,9,RW,2016
4198,12,32,Brad Richardson,3,76,15,C,2017
4199,1,23,Brad Schlegel,0,15,1,D,1991
4200,1,24,Brad Schlegel,0,7,1,D,1992
4201,6,25,Brad Schlegel,1,26,7,D,1993
4202,10,22,Brad Selwood,2,28,12,D,1970
4203,17,23,Brad Selwood,4,72,21,D,1971
4204,21,24,Brad Selwood,13,75,34,D,1972
4205,21,24,Brad Selwood,13,75,34,D,1972
4206,28,25,Brad Selwood,9,76,37,D,1973
4207,28,25,Brad Selwood,9,76,37,D,1973
4208,35,26,Brad Selwood,4,77,39,D,1974
4209,35,26,Brad Selwood,4,77,39,D,1974
4210,10,27,Brad Selwood,2,40,12,D,1975
4211,10,27,Brad Selwood,2,40,12,D,1975
4212,12,28,Brad Selwood,4,41,16,D,1976
4213,12,28,Brad Selwood,4,41,16,D,1976
4214,25,29,Brad Selwood,6,80,31,D,1977
4215,25,29,Brad Selwood,6,80,31,D,1977
4216,12,30,Brad Selwood,4,42,16,D,1978
4217,12,30,Brad Selwood,4,42,16,D,1978
4218,13,31,Brad Selwood,1,63,14,D,1979
4219,2,21,Brad Shaw,0,8,2,D,1985
4220,0,22,Brad Shaw,0,2,0,D,1986
4221,0,23,Brad Shaw,0,1,0,D,1987
4222,0,24,Brad Shaw,1,3,1,D,1988
4223,32,25,Brad Shaw,3,64,35,D,1989
4224,28,26,Brad Shaw,4,72,32,D,1990
4225,22,27,Brad Shaw,3,62,25,D,1991
4226,34,28,Brad Shaw,7,81,41,D,1992
4227,19,29,Brad Shaw,4,66,23,D,1993
4228,0,30,Brad Shaw,0,2,0,D,1994
4229,0,34,Brad Shaw,0,16,0,D,1998
4230,0,20,Brad Smith,0,2,0,RW,1978
4231,3,21,Brad Smith,1,23,4,RW,1979
4232,6,22,Brad Smith,12,65,18,RW,1980
4233,0,23,Brad Smith,2,33,2,RW,1981
4234,0,24,Brad Smith,0,1,0,RW,1982
4235,1,25,Brad Smith,2,8,3,RW,1983
4236,0,26,Brad Smith,1,1,1,RW,1984
4237,17,27,Brad Smith,5,42,22,RW,1985
4238,7,28,Brad Smith,5,47,12,RW,1986
4239,1,22,Brad Smyth,1,7,2,RW,1995
4240,8,23,Brad Smyth,9,52,17,RW,1996
4241,3,24,Brad Smyth,1,10,4,RW,1997
4242,0,25,Brad Smyth,0,3,0,RW,1998
4243,0,27,Brad Smyth,1,4,1,RW,2000
4244,1,29,Brad Smyth,3,12,4,RW,2002
4245,2,24,Brad Staubitz,1,35,3,RW,2008
4246,3,25,Brad Staubitz,3,47,6,RW,2009
4247,5,26,Brad Staubitz,4,71,9,RW,2010
4248,0,27,Brad Staubitz,1,62,1,RW,2011
4249,1,28,Brad Staubitz,1,15,2,RW,2012
4250,26,20,Brad Stuart,10,82,36,D,1999
4251,18,21,Brad Stuart,5,77,23,D,2000
4252,23,22,Brad Stuart,6,82,29,D,2001
4253,10,23,Brad Stuart,4,36,14,D,2002
4254,30,24,Brad Stuart,9,77,39,D,2003
4255,31,26,Brad Stuart,12,78,43,D,2005
4256,15,27,Brad Stuart,7,75,22,D,2006
4257,17,28,Brad Stuart,6,72,23,D,2007
4258,13,29,Brad Stuart,2,67,15,D,2008
4259,16,30,Brad Stuart,4,82,20,D,2009
4260,17,31,Brad Stuart,3,67,20,D,2010
4261,15,32,Brad Stuart,6,81,21,D,2011
4262,6,33,Brad Stuart,0,48,6,D,2012
4263,8,34,Brad Stuart,3,61,11,D,2013
4264,10,35,Brad Stuart,3,65,13,D,2014
4265,0,36,Brad Stuart,0,6,0,D,2015
4266,3,22,Brad Tapper,2,16,5,RW,2000
4267,4,23,Brad Tapper,2,20,6,RW,2001
4268,4,24,Brad Tapper,10,35,14,RW,2002
4269,0,26,Brad Tiley,0,1,0,D,1997
4270,0,27,Brad Tiley,0,8,0,D,1998
4271,0,29,Brad Tiley,0,2,0,D,2000
4272,0,23,Brad Turner,0,3,0,D,1991
4273,4,23,Brad Werenka,5,27,9,D,1992
4274,11,24,Brad Werenka,0,26,11,D,1993
4275,0,26,Brad Werenka,0,9,0,D,1995
4276,15,28,Brad Werenka,3,71,18,D,1997
4277,18,29,Brad Werenka,6,81,24,D,1998
4278,9,30,Brad Werenka,4,73,13,D,1999
4279,4,31,Brad Werenka,1,33,5,D,2000
4280,1,24,Brad Winchester,0,19,1,LW,2005
4281,5,25,Brad Winchester,4,59,9,LW,2006
4282,2,26,Brad Winchester,1,41,3,LW,2007
4283,8,27,Brad Winchester,13,64,21,LW,2008
4284,5,28,Brad Winchester,3,64,8,LW,2009
4285,6,29,Brad Winchester,10,76,16,LW,2010
4286,4,30,Brad Winchester,6,67,10,LW,2011
4287,0,22,Brad Zavisha,0,2,0,LW,1993
4288,0,23,Brady Austin,0,5,0,D,2016
4289,0,23,Brady Murray,1,4,1,LW,2007
4290,0,21,Brady Skjei,0,7,0,D,2015
4291,34,22,Brady Skjei,5,80,39,D,2016
4292,21,23,Brady Skjei,4,82,25,D,2017
4293,9,23,Brandon Bochenski,8,40,17,RW,2005
4294,11,24,Brandon Bochenski,13,41,24,RW,2006
4295,10,25,Brandon Bochenski,3,40,13,RW,2007
4296,1,26,Brandon Bochenski,0,7,1,RW,2008
4297,9,27,Brandon Bochenski,4,28,13,RW,2009
4298,0,25,Brandon Bollig,0,18,0,LW,2011
4299,0,26,Brandon Bollig,0,25,0,LW,2012
4300,7,27,Brandon Bollig,7,82,14,LW,2013
4301,4,28,Brandon Bollig,1,62,5,LW,2014
4302,2,29,Brandon Bollig,2,54,4,LW,2015
4303,10,20,Brandon Carlo,6,82,16,D,2016
4304,6,21,Brandon Carlo,0,76,6,D,2017
4305,2,21,Brandon Convery,5,11,7,C,1995
4306,8,22,Brandon Convery,2,39,10,RW,1996
4307,2,23,Brandon Convery,0,7,2,C,1997
4308,7,24,Brandon Convery,2,15,9,C,1998
4309,0,23,Brandon Davidson,1,12,1,D,2014
4310,7,24,Brandon Davidson,4,51,11,D,2015
4311,2,25,Brandon Davidson,0,10,2,D,2016
4312,1,26,Brandon Davidson,0,13,1,D,2017
4313,0,26,Brandon Defazio,0,2,0,LW,2014
4314,0,20,Brandon Dubinsky,0,6,0,C,2006
4315,26,21,Brandon Dubinsky,14,82,40,C,2007
4316,28,22,Brandon Dubinsky,13,82,41,C,2008
4317,24,23,Brandon Dubinsky,20,69,44,C,2009
4318,30,24,Brandon Dubinsky,24,77,54,C,2010
4319,24,25,Brandon Dubinsky,10,77,34,C,2011
4320,18,26,Brandon Dubinsky,2,29,20,C,2012
4321,34,27,Brandon Dubinsky,16,76,50,C,2013
4322,23,28,Brandon Dubinsky,13,47,36,C,2014
4323,31,29,Brandon Dubinsky,17,75,48,C,2015
4324,29,30,Brandon Dubinsky,12,80,41,C,2016
4325,10,31,Brandon Dubinsky,6,62,16,C,2017
4326,0,21,Brandon Gormley,0,5,0,D,2013
4327,2,22,Brandon Gormley,2,27,4,D,2014
4328,1,23,Brandon Gormley,0,26,1,D,2015
4329,2,24,Brandon Kozun,2,20,4,RW,2014
4330,0,21,Brandon Manning,0,4,0,D,2011
4331,2,22,Brandon Manning,0,6,2,D,2012
4332,3,24,Brandon Manning,0,11,3,D,2014
4333,6,25,Brandon Manning,1,56,7,D,2015
4334,9,26,Brandon Manning,3,65,12,D,2016
4335,12,27,Brandon Manning,7,65,19,D,2017
4336,0,22,Brandon Mashinter,0,13,0,LW,2010
4337,0,24,Brandon Mashinter,0,4,0,LW,2012
4338,0,25,Brandon Mashinter,0,6,0,LW,2013
4339,1,27,Brandon Mashinter,4,41,5,LW,2015
4340,10,20,Brandon McMillan,11,60,21,LW,2010
4341,4,21,Brandon McMillan,0,25,4,LW,2011
4342,1,22,Brandon McMillan,0,6,1,LW,2012
4343,4,23,Brandon McMillan,2,22,6,LW,2013
4344,3,24,Brandon McMillan,1,58,4,LW,2014
4345,4,22,Brandon Montour,2,27,6,D,2016
4346,23,23,Brandon Montour,9,80,32,D,2017
4347,1,24,Brandon Nolan,0,6,1,C,2007
4348,0,19,Brandon Pirri,0,1,0,C,2010
4349,2,20,Brandon Pirri,0,5,2,C,2011
4350,0,21,Brandon Pirri,0,1,0,C,2012
4351,12,22,Brandon Pirri,13,49,25,C,2013
4352,2,23,Brandon Pirri,22,49,24,C,2014
4353,15,24,Brandon Pirri,14,61,29,C,2015
4354,10,25,Brandon Pirri,8,60,18,RW,2016
4355,0,26,Brandon Pirri,3,2,3,RW,2017
4356,0,22,Brandon Prust,0,10,0,C,2006
4357,2,24,Brandon Prust,1,36,3,RW,2008
4358,9,25,Brandon Prust,5,69,14,LW,2009
4359,16,26,Brandon Prust,13,82,29,LW,2010
4360,12,27,Brandon Prust,5,82,17,LW,2011
4361,9,28,Brandon Prust,5,38,14,LW,2012
4362,7,29,Brandon Prust,6,52,13,LW,2013
4363,14,30,Brandon Prust,4,82,18,LW,2014
4364,6,31,Brandon Prust,1,35,7,LW,2015
4365,3,21,Brandon Reid,2,7,5,C,2002
4366,1,22,Brandon Reid,0,3,1,C,2003
4367,0,25,Brandon Reid,0,3,0,C,2006
4368,0,19,Brandon Saad,0,2,0,LW,2011
4369,17,20,Brandon Saad,10,46,27,LW,2012
4370,28,21,Brandon Saad,19,78,47,LW,2013
4371,29,22,Brandon Saad,23,82,52,LW,2014
4372,22,23,Brandon Saad,31,78,53,LW,2015
4373,29,24,Brandon Saad,24,82,53,LW,2016
4374,17,25,Brandon Saad,18,82,35,LW,2017
4375,0,25,Brandon Segal,0,2,0,RW,2008
4376,6,26,Brandon Segal,6,44,12,RW,2009
4377,5,27,Brandon Segal,5,46,10,RW,2010
4378,0,28,Brandon Segal,0,10,0,RW,2011
4379,0,29,Brandon Segal,0,1,0,RW,2012
4380,0,25,Brandon Smith,0,5,0,D,1998
4381,4,26,Brandon Smith,2,22,6,D,1999
4382,0,27,Brandon Smith,1,3,1,D,2000
4383,0,29,Brandon Smith,0,3,0,D,2002
4384,5,19,Brandon Sutter,1,50,6,C,2008
4385,19,20,Brandon Sutter,21,72,40,C,2009
4386,15,21,Brandon Sutter,14,82,29,C,2010
4387,15,22,Brandon Sutter,17,82,32,C,2011
4388,8,23,Brandon Sutter,11,48,19,C,2012
4389,13,24,Brandon Sutter,13,81,26,C,2013
4390,12,25,Brandon Sutter,21,80,33,C,2014
4391,4,26,Brandon Sutter,5,20,9,C,2015
4392,17,27,Brandon Sutter,17,81,34,C,2016
4393,15,28,Brandon Sutter,11,61,26,C,2017
4394,0,24,Brandon Tanev,0,3,0,LW,2015
4395,2,25,Brandon Tanev,2,51,4,LW,2016
4396,10,26,Brandon Tanev,8,61,18,LW,2017
4397,8,24,Brandon Yip,11,32,19,RW,2009
4398,10,25,Brandon Yip,12,71,22,RW,2010
4399,4,26,Brandon Yip,3,35,7,RW,2011
4400,5,27,Brandon Yip,3,34,8,RW,2012
4401,0,28,Brandon Yip,0,2,0,RW,2013
4402,0,21,Brandy Semchuk,0,1,0,RW,1992
4403,4,20,Branislav Mezei,1,42,5,D,2000
4404,2,21,Branislav Mezei,0,24,2,D,2001
4405,0,22,Branislav Mezei,2,11,2,D,2002
4406,7,23,Branislav Mezei,0,45,7,D,2003
4407,1,25,Branislav Mezei,0,16,1,D,2005
4408,3,26,Branislav Mezei,0,45,3,D,2006
4409,2,27,Branislav Mezei,2,57,4,D,2007
4410,2,21,Branko Radivojevic,4,18,6,RW,2001
4411,15,22,Branko Radivojevic,12,79,27,RW,2002
4412,22,23,Branko Radivojevic,10,77,32,RW,2003
4413,6,25,Branko Radivojevic,8,64,14,RW,2005
4414,13,26,Branko Radivojevic,11,82,24,RW,2006
4415,10,27,Branko Radivojevic,7,73,17,RW,2007
4416,0,20,Brantt Myhres,2,15,2,RW,1994
4417,1,22,Brantt Myhres,3,47,4,RW,1996
4418,0,23,Brantt Myhres,0,23,0,RW,1997
4419,0,24,Brantt Myhres,1,30,1,RW,1998
4420,1,25,Brantt Myhres,0,13,1,RW,1999
4421,0,26,Brantt Myhres,0,25,0,LW,2000
4422,0,28,Brantt Myhres,0,1,0,LW,2002
4423,0,22,Brayden Irwin,0,2,0,C,2009
4424,7,21,Brayden McNabb,1,25,8,D,2011
4425,0,23,Brayden McNabb,0,12,0,D,2013
4426,22,24,Brayden McNabb,2,71,24,D,2014
4427,12,25,Brayden McNabb,2,81,14,D,2015
4428,2,26,Brayden McNabb,2,49,4,D,2016
4429,10,27,Brayden McNabb,5,76,15,D,2017
4430,22,20,Brayden Point,18,68,40,C,2016
4431,34,21,Brayden Point,32,82,66,C,2017
4432,0,18,Brayden Schenn,0,1,0,C,2009
4433,2,19,Brayden Schenn,0,8,2,C,2010
4434,6,20,Brayden Schenn,12,54,18,C,2011
4435,18,21,Brayden Schenn,8,47,26,C,2012
4436,21,22,Brayden Schenn,20,82,41,C,2013
4437,29,23,Brayden Schenn,18,82,47,C,2014
4438,33,24,Brayden Schenn,26,80,59,C,2015
4439,30,25,Brayden Schenn,25,79,55,C,2016
4440,42,26,Brayden Schenn,28,82,70,C,2017
4441,1,20,Braydon Coburn,0,9,1,D,2005
4442,8,21,Braydon Coburn,3,49,11,D,2006
4443,27,22,Braydon Coburn,9,78,36,D,2007
4444,21,23,Braydon Coburn,7,80,28,D,2008
4445,14,24,Braydon Coburn,5,81,19,D,2009
4446,14,25,Braydon Coburn,2,82,16,D,2010
4447,20,26,Braydon Coburn,4,81,24,D,2011
4448,4,27,Braydon Coburn,1,33,5,D,2012
4449,12,28,Braydon Coburn,5,82,17,D,2013
4450,10,29,Braydon Coburn,1,43,11,D,2014
4451,9,30,Braydon Coburn,1,80,10,D,2015
4452,7,31,Braydon Coburn,5,80,12,D,2016
4453,14,32,Braydon Coburn,1,72,15,D,2017
4454,0,22,Brendan Bell,0,1,0,D,2005
4455,6,23,Brendan Bell,1,45,7,D,2006
4456,0,24,Brendan Bell,0,2,0,D,2007
4457,15,25,Brendan Bell,6,53,21,D,2008
4458,0,28,Brendan Bell,0,1,0,D,2011
4459,13,20,Brendan Gallagher,15,44,28,RW,2012
4460,22,21,Brendan Gallagher,19,81,41,RW,2013
4461,23,22,Brendan Gallagher,24,82,47,RW,2014
4462,21,23,Brendan Gallagher,19,53,40,RW,2015
4463,19,24,Brendan Gallagher,10,64,29,RW,2016
4464,23,25,Brendan Gallagher,31,82,54,RW,2017
4465,0,21,Brendan Gaunce,1,20,1,C,2015
4466,5,22,Brendan Gaunce,0,57,5,LW,2016
4467,2,23,Brendan Gaunce,4,37,6,LW,2017
4468,0,19,Brendan Guhle,0,3,0,D,2016
4469,5,20,Brendan Guhle,0,18,5,D,2017
4470,2,21,Brendan Leipsic,1,6,3,LW,2015
4471,6,23,Brendan Leipsic,3,14,9,LW,2017
4472,0,21,Brendan Lemieux,1,9,1,LW,2017
4473,2,21,Brendan Mikkelson,0,34,2,D,2008
4474,2,22,Brendan Mikkelson,0,28,2,D,2009
4475,2,23,Brendan Mikkelson,0,24,2,D,2010
4476,2,24,Brendan Mikkelson,1,41,3,D,2011
4477,1,25,Brendan Mikkelson,0,4,1,D,2012
4478,4,22,Brendan Morrison,5,11,9,C,1997
4479,33,23,Brendan Morrison,13,76,46,C,1998
4480,28,24,Brendan Morrison,7,56,35,C,1999
4481,38,25,Brendan Morrison,16,82,54,C,2000
4482,44,26,Brendan Morrison,23,82,67,C,2001
4483,46,27,Brendan Morrison,25,82,71,C,2002
4484,38,28,Brendan Morrison,22,82,60,C,2003
4485,37,30,Brendan Morrison,19,82,56,C,2005
4486,31,31,Brendan Morrison,20,82,51,C,2006
4487,16,32,Brendan Morrison,9,39,25,C,2007
4488,15,33,Brendan Morrison,16,81,31,C,2008
4489,30,34,Brendan Morrison,12,74,42,C,2009
4490,34,35,Brendan Morrison,9,66,43,C,2010
4491,7,36,Brendan Morrison,4,39,11,C,2011
4492,7,20,Brendan Perlini,14,57,21,LW,2016
4493,13,21,Brendan Perlini,17,74,30,LW,2017
4494,0,22,Brendan Ranford,0,1,0,LW,2014
4495,19,19,Brendan Shanahan,7,65,26,RW,1987
4496,28,20,Brendan Shanahan,22,68,50,LW,1988
4497,42,21,Brendan Shanahan,30,73,72,LW,1989
4498,37,22,Brendan Shanahan,29,75,66,LW,1990
4499,36,23,Brendan Shanahan,33,80,69,LW,1991
4500,43,24,Brendan Shanahan,51,71,94,LW,1992
4501,50,25,Brendan Shanahan,52,81,102,LW,1993
4502,21,26,Brendan Shanahan,20,45,41,LW,1994
4503,34,27,Brendan Shanahan,44,74,78,LW,1995
4504,41,28,Brendan Shanahan,47,81,88,LW,1996
4505,29,29,Brendan Shanahan,28,75,57,LW,1997
4506,27,30,Brendan Shanahan,31,81,58,LW,1998
4507,37,31,Brendan Shanahan,41,78,78,LW,1999
4508,45,32,Brendan Shanahan,31,81,76,LW,2000
4509,38,33,Brendan Shanahan,37,80,75,LW,2001
4510,38,34,Brendan Shanahan,30,78,68,LW,2002
4511,28,35,Brendan Shanahan,25,82,53,LW,2003
4512,41,37,Brendan Shanahan,40,82,81,LW,2005
4513,33,38,Brendan Shanahan,29,67,62,LW,2006
4514,23,39,Brendan Shanahan,23,73,46,LW,2007
4515,8,40,Brendan Shanahan,6,34,14,LW,2008
4516,1,24,Brendan Shinnimin,0,12,1,C,2014
4517,6,22,Brendan Smith,1,14,7,D,2011
4518,8,23,Brendan Smith,0,34,8,D,2012
4519,14,24,Brendan Smith,5,71,19,D,2013
4520,9,25,Brendan Smith,4,76,13,D,2014
4521,12,26,Brendan Smith,3,63,15,D,2015
4522,3,27,Brendan Smith,1,18,4,D,2016
4523,7,28,Brendan Smith,1,44,8,D,2017
4524,3,20,Brendan Witt,2,48,5,D,1995
4525,2,21,Brendan Witt,3,44,5,D,1996
4526,7,22,Brendan Witt,1,64,8,D,1997
4527,5,23,Brendan Witt,2,54,7,D,1998
4528,7,24,Brendan Witt,1,77,8,D,1999
4529,3,25,Brendan Witt,3,72,6,D,2000
4530,7,26,Brendan Witt,3,68,10,D,2001
4531,9,27,Brendan Witt,2,69,11,D,2002
4532,10,28,Brendan Witt,2,72,12,D,2003
4533,13,30,Brendan Witt,1,75,14,D,2005
4534,13,31,Brendan Witt,1,81,14,D,2006
4535,5,32,Brendan Witt,2,59,7,D,2007
4536,9,33,Brendan Witt,0,65,9,D,2008
4537,3,34,Brendan Witt,2,42,5,D,2009
4538,0,22,Brendan Woods,0,2,0,LW,2014
4539,0,23,Brendan Woods,0,5,0,LW,2015
4540,0,21,Brenden Dillon,0,1,0,D,2011
4541,5,22,Brenden Dillon,3,48,8,D,2012
4542,11,23,Brenden Dillon,6,80,17,D,2013
4543,8,24,Brenden Dillon,2,80,10,D,2014
4544,9,25,Brenden Dillon,2,76,11,D,2015
4545,8,26,Brenden Dillon,2,81,10,D,2016
4546,17,27,Brenden Dillon,5,81,22,D,2017
4547,19,21,Brenden Morrow,14,64,33,LW,1999
4548,24,22,Brenden Morrow,20,82,44,LW,2000
4549,18,23,Brenden Morrow,17,72,35,LW,2001
4550,22,24,Brenden Morrow,21,71,43,LW,2002
4551,24,25,Brenden Morrow,25,81,49,LW,2003
4552,42,27,Brenden Morrow,23,81,65,LW,2005
4553,15,28,Brenden Morrow,16,40,31,LW,2006
4554,42,29,Brenden Morrow,32,82,74,LW,2007
4555,10,30,Brenden Morrow,5,18,15,LW,2008
4556,26,31,Brenden Morrow,20,76,46,LW,2009
4557,23,32,Brenden Morrow,33,82,56,LW,2010
4558,15,33,Brenden Morrow,11,57,26,LW,2011
4559,13,34,Brenden Morrow,12,44,25,LW,2012
4560,12,35,Brenden Morrow,13,71,25,LW,2013
4561,5,36,Brenden Morrow,3,70,8,LW,2014
4562,0,23,Brendon Nash,0,2,0,D,2010
4563,2,22,Brent A Hughes,3,28,5,LW,1988
4564,2,23,Brent A Hughes,1,11,3,LW,1989
4565,1,25,Brent A Hughes,1,8,2,LW,1991
4566,4,26,Brent A Hughes,5,62,9,LW,1992
4567,11,27,Brent A Hughes,13,77,24,LW,1993
4568,6,28,Brent A Hughes,6,44,12,LW,1994
4569,10,29,Brent A Hughes,5,76,15,LW,1995
4570,3,30,Brent A Hughes,7,51,10,RW,1996
4571,14,19,Brent Ashton,5,47,19,LW,1979
4572,11,20,Brent Ashton,18,77,29,C,1980
4573,36,21,Brent Ashton,24,80,60,LW,1981
4574,19,22,Brent Ashton,14,76,33,LW,1982
4575,10,23,Brent Ashton,7,68,17,LW,1983
4576,31,24,Brent Ashton,31,78,62,LW,1984
4577,32,25,Brent Ashton,26,77,58,LW,1985
4578,35,26,Brent Ashton,40,81,75,LW,1986
4579,27,27,Brent Ashton,26,73,53,LW,1987
4580,37,28,Brent Ashton,31,75,68,LW,1988
4581,34,29,Brent Ashton,22,79,56,LW,1989
4582,24,30,Brent Ashton,12,61,36,LW,1990
4583,22,31,Brent Ashton,18,68,40,LW,1991
4584,13,32,Brent Ashton,10,58,23,LW,1992
4585,5,18,Brent Burns,1,36,6,RW,2003
4586,12,20,Brent Burns,4,72,16,RW,2005
4587,18,21,Brent Burns,7,77,25,D,2006
4588,28,22,Brent Burns,15,82,43,D,2007
4589,19,23,Brent Burns,8,59,27,D,2008
4590,17,24,Brent Burns,3,47,20,D,2009
4591,29,25,Brent Burns,17,80,46,D,2010
4592,26,26,Brent Burns,11,81,37,D,2011
4593,11,27,Brent Burns,9,30,20,D,2012
4594,26,28,Brent Burns,22,69,48,RW,2013
4595,43,29,Brent Burns,17,82,60,D,2014
4596,48,30,Brent Burns,27,82,75,D,2015
4597,47,31,Brent Burns,29,82,76,D,2016
4598,55,32,Brent Burns,12,82,67,D,2017
4599,10,24,Brent D Hughes,4,44,14,D,1967
4600,19,25,Brent D Hughes,2,72,21,D,1968
4601,7,26,Brent D Hughes,1,52,8,D,1969
4602,10,27,Brent D Hughes,1,30,11,D,1970
4603,20,28,Brent D Hughes,2,63,22,D,1971
4604,12,29,Brent D Hughes,3,37,15,D,1972
4605,21,30,Brent D Hughes,1,71,22,D,1973
4606,18,31,Brent D Hughes,1,66,19,D,1974
4607,28,32,Brent D Hughes,7,78,35,D,1975
4608,28,32,Brent D Hughes,7,78,35,D,1975
4609,13,33,Brent D Hughes,4,62,17,D,1976
4610,13,33,Brent D Hughes,4,62,17,D,1976
4611,35,34,Brent D Hughes,9,80,44,D,1977
4612,35,34,Brent D Hughes,9,80,44,D,1977
4613,3,35,Brent D Hughes,3,48,6,D,1978
4614,3,35,Brent D Hughes,3,48,6,D,1978
4615,1,20,Brent Fedyk,0,2,1,RW,1987
4616,0,21,Brent Fedyk,2,5,2,RW,1988
4617,4,22,Brent Fedyk,1,27,5,RW,1989
4618,19,23,Brent Fedyk,16,67,35,RW,1990
4619,8,24,Brent Fedyk,5,61,13,LW,1991
4620,38,25,Brent Fedyk,21,74,59,LW,1992
4621,18,26,Brent Fedyk,20,72,38,RW,1993
4622,4,27,Brent Fedyk,8,30,12,RW,1994
4623,14,28,Brent Fedyk,20,65,34,LW,1995
4624,6,31,Brent Fedyk,4,67,10,LW,1998
4625,16,21,Brent Gilchrist,8,49,24,LW,1988
4626,15,22,Brent Gilchrist,9,57,24,C,1989
4627,9,23,Brent Gilchrist,6,51,15,LW,1990
4628,27,24,Brent Gilchrist,23,79,50,C,1991
4629,11,25,Brent Gilchrist,10,68,21,C,1992
4630,14,26,Brent Gilchrist,17,76,31,C,1993
4631,4,27,Brent Gilchrist,9,32,13,LW,1994
4632,22,28,Brent Gilchrist,20,77,42,C,1995
4633,20,29,Brent Gilchrist,10,67,30,LW,1996
4634,14,30,Brent Gilchrist,13,61,27,LW,1997
4635,0,31,Brent Gilchrist,1,5,1,LW,1998
4636,2,32,Brent Gilchrist,4,24,6,LW,1999
4637,8,33,Brent Gilchrist,1,60,9,C,2000
4638,6,34,Brent Gilchrist,3,45,9,C,2001
4639,2,35,Brent Gilchrist,1,41,3,LW,2002
4640,2,21,Brent Gretzky,1,10,3,C,1993
4641,1,22,Brent Gretzky,0,3,1,C,1994
4642,5,24,Brent Grieve,13,27,18,LW,1993
4643,5,25,Brent Grieve,1,24,6,LW,1994
4644,4,26,Brent Grieve,2,28,6,LW,1995
4645,2,27,Brent Grieve,4,18,6,LW,1996
4646,0,24,Brent L Peterson,2,17,2,LW,1996
4647,0,25,Brent L Peterson,5,19,5,LW,1997
4648,1,26,Brent L Peterson,2,20,3,LW,1998
4649,0,20,Brent Meeke,0,3,0,D,1972
4650,9,21,Brent Meeke,1,18,10,D,1973
4651,0,22,Brent Meeke,0,4,0,D,1974
4652,0,23,Brent Meeke,0,1,0,D,1975
4653,13,24,Brent Meeke,8,49,21,LW,1976
4654,0,20,Brent R Peterson,0,5,0,C,1978
4655,2,21,Brent R Peterson,1,18,3,C,1979
4656,18,22,Brent R Peterson,6,53,24,C,1980
4657,5,23,Brent R Peterson,10,61,15,C,1981
4658,24,24,Brent R Peterson,13,75,37,C,1982
4659,12,25,Brent R Peterson,9,70,21,C,1983
4660,22,26,Brent R Peterson,12,74,34,C,1984
4661,23,27,Brent R Peterson,8,77,31,C,1985
4662,15,28,Brent R Peterson,7,69,22,C,1986
4663,7,29,Brent R Peterson,2,52,9,C,1987
4664,13,30,Brent R Peterson,4,66,17,C,1988
4665,0,26,Brent Regner,0,7,0,D,2015
4666,27,20,Brent Seabrook,5,69,32,D,2005
4667,20,21,Brent Seabrook,4,81,24,D,2006
4668,23,22,Brent Seabrook,9,82,32,D,2007
4669,18,23,Brent Seabrook,8,82,26,D,2008
4670,26,24,Brent Seabrook,4,78,30,D,2009
4671,39,25,Brent Seabrook,9,82,48,D,2010
4672,25,26,Brent Seabrook,9,78,34,D,2011
4673,12,27,Brent Seabrook,8,47,20,D,2012
4674,34,28,Brent Seabrook,7,82,41,D,2013
4675,23,29,Brent Seabrook,8,82,31,D,2014
4676,35,30,Brent Seabrook,14,81,49,D,2015
4677,36,31,Brent Seabrook,3,79,39,D,2016
4678,19,32,Brent Seabrook,7,81,26,D,2017
4679,2,23,Brent Severyn,0,35,2,LW,1989
4680,7,27,Brent Severyn,4,67,11,D,1993
4681,4,28,Brent Severyn,2,28,6,D,1994
4682,8,29,Brent Severyn,1,65,9,D,1995
4683,4,30,Brent Severyn,1,66,5,LW,1996
4684,3,31,Brent Severyn,1,37,4,LW,1997
4685,2,32,Brent Severyn,1,30,3,LW,1998
4686,0,22,Brent Sopel,1,5,1,D,1998
4687,4,23,Brent Sopel,2,18,6,D,1999
4688,10,24,Brent Sopel,4,52,14,D,2000
4689,17,25,Brent Sopel,8,66,25,D,2001
4690,30,26,Brent Sopel,7,81,37,D,2002
4691,32,27,Brent Sopel,10,80,42,D,2003
4692,26,29,Brent Sopel,2,68,28,D,2005
4693,23,30,Brent Sopel,5,64,28,D,2006
4694,19,31,Brent Sopel,1,58,20,D,2007
4695,1,32,Brent Sopel,1,23,2,D,2008
4696,7,33,Brent Sopel,1,73,8,D,2009
4697,5,34,Brent Sopel,2,71,7,D,2010
4698,2,18,Brent Sutter,2,3,4,C,1980
4699,22,19,Brent Sutter,21,43,43,C,1981
4700,19,20,Brent Sutter,21,80,40,C,1982
4701,15,21,Brent Sutter,34,69,49,C,1983
4702,60,22,Brent Sutter,42,72,102,C,1984
4703,31,23,Brent Sutter,24,61,55,C,1985
4704,36,24,Brent Sutter,27,69,63,C,1986
4705,31,25,Brent Sutter,29,70,60,C,1987
4706,34,26,Brent Sutter,29,77,63,C,1988
4707,35,27,Brent Sutter,33,67,68,C,1989
4708,32,28,Brent Sutter,21,75,53,C,1990
4709,38,29,Brent Sutter,22,69,60,C,1991
4710,34,30,Brent Sutter,20,65,54,C,1992
4711,29,31,Brent Sutter,9,73,38,C,1993
4712,8,32,Brent Sutter,7,47,15,C,1994
4713,27,33,Brent Sutter,13,80,40,C,1995
4714,7,34,Brent Sutter,7,39,14,C,1996
4715,6,35,Brent Sutter,2,52,8,RW,1997
4716,5,21,Brent Thompson,0,27,5,D,1991
4717,4,22,Brent Thompson,0,30,4,D,1992
4718,0,23,Brent Thompson,1,24,1,D,1993
4719,0,24,Brent Thompson,0,29,0,D,1994
4720,1,25,Brent Thompson,0,10,1,D,1995
4721,0,26,Brent Thompson,0,1,0,D,1996
4722,0,21,Brent Tremblay,0,1,0,D,1978
4723,0,22,Brent Tremblay,1,9,1,D,1979
4724,0,21,Bret Hedican,1,4,1,D,1991
4725,8,22,Bret Hedican,0,42,8,D,1992
4726,12,23,Bret Hedican,0,69,12,D,1993
4727,11,24,Bret Hedican,2,45,13,D,1994
4728,23,25,Bret Hedican,6,77,29,D,1995
4729,15,26,Bret Hedican,4,67,19,D,1996
4730,24,27,Bret Hedican,3,71,27,D,1997
4731,18,28,Bret Hedican,5,67,23,D,1998
4732,19,29,Bret Hedican,6,76,25,D,1999
4733,15,30,Bret Hedican,5,70,20,D,2000
4734,11,31,Bret Hedican,5,57,16,D,2001
4735,14,32,Bret Hedican,3,72,17,D,2002
4736,17,33,Bret Hedican,7,81,24,D,2003
4737,22,35,Bret Hedican,5,74,27,D,2005
4738,10,36,Bret Hedican,0,50,10,D,2006
4739,15,37,Bret Hedican,2,66,17,D,2007
4740,5,38,Bret Hedican,1,51,6,D,2008
4741,2,24,Brett Bellemore,0,8,2,D,2012
4742,6,25,Brett Bellemore,2,64,8,D,2013
4743,8,26,Brett Bellemore,2,49,10,D,2014
4744,3,19,Brett Bulmer,0,9,3,RW,2011
4745,0,21,Brett Bulmer,0,5,0,RW,2013
4746,0,23,Brett Bulmer,0,3,0,RW,2015
4747,26,23,Brett Callighen,15,62,41,RW,1976
4748,26,23,Brett Callighen,15,62,41,RW,1976
4749,30,24,Brett Callighen,20,80,50,C,1977
4750,30,24,Brett Callighen,20,80,50,C,1977
4751,39,25,Brett Callighen,31,71,70,LW,1978
4752,39,25,Brett Callighen,31,71,70,LW,1978
4753,35,26,Brett Callighen,23,59,58,LW,1979
4754,35,27,Brett Callighen,25,55,60,C,1980
4755,19,28,Brett Callighen,8,46,27,C,1981
4756,0,23,Brett Carson,0,5,0,D,2008
4757,10,24,Brett Carson,2,54,12,D,2009
4758,0,25,Brett Carson,0,19,0,D,2010
4759,0,26,Brett Carson,0,2,0,D,2011
4760,1,27,Brett Carson,0,10,1,D,2012
4761,0,21,Brett Clark,1,41,1,D,1997
4762,2,22,Brett Clark,2,61,4,D,1998
4763,1,23,Brett Clark,0,14,1,D,1999
4764,2,24,Brett Clark,1,28,3,D,2000
4765,0,25,Brett Clark,0,2,0,D,2001
4766,1,27,Brett Clark,1,12,2,D,2003
4767,27,29,Brett Clark,9,80,36,D,2005
4768,29,30,Brett Clark,10,82,39,D,2006
4769,16,31,Brett Clark,5,57,21,D,2007
4770,10,32,Brett Clark,2,76,12,D,2008
4771,17,33,Brett Clark,3,64,20,D,2009
4772,22,34,Brett Clark,9,82,31,D,2010
4773,13,35,Brett Clark,2,82,15,D,2011
4774,1,36,Brett Clark,0,8,1,D,2012
4775,11,19,Brett Connolly,4,68,15,RW,2011
4776,0,20,Brett Connolly,1,5,1,RW,2012
4777,0,21,Brett Connolly,1,11,1,RW,2013
4778,5,22,Brett Connolly,12,55,17,RW,2014
4779,16,23,Brett Connolly,9,71,25,RW,2015
4780,8,24,Brett Connolly,15,66,23,RW,2016
4781,12,25,Brett Connolly,15,70,27,RW,2017
4782,5,22,Brett Festerling,0,40,5,D,2008
4783,3,23,Brett Festerling,0,42,3,D,2009
4784,0,24,Brett Festerling,0,1,0,D,2010
4785,0,25,Brett Festerling,0,5,0,D,2011
4786,0,25,Brett Gallant,0,4,0,LW,2013
4787,1,24,Brett Harkins,0,1,1,C,1994
4788,3,25,Brett Harkins,0,8,3,LW,1995
4789,14,26,Brett Harkins,4,44,18,LW,1996
4790,12,31,Brett Harkins,2,25,14,C,2001
4791,2,24,Brett Hauer,4,29,6,D,1995
4792,2,28,Brett Hauer,0,5,2,D,1999
4793,0,30,Brett Hauer,0,3,0,D,2001
4794,0,22,Brett Hull,1,5,1,RW,1986
4795,32,23,Brett Hull,32,65,64,RW,1987
4796,43,24,Brett Hull,41,78,84,RW,1988
4797,41,25,Brett Hull,72,80,113,RW,1989
4798,45,26,Brett Hull,86,78,131,RW,1990
4799,39,27,Brett Hull,70,73,109,RW,1991
4800,47,28,Brett Hull,54,80,101,RW,1992
4801,40,29,Brett Hull,57,81,97,RW,1993
4802,21,30,Brett Hull,29,48,50,RW,1994
4803,40,31,Brett Hull,43,70,83,RW,1995
4804,40,32,Brett Hull,42,77,82,RW,1996
4805,45,33,Brett Hull,27,66,72,LW,1997
4806,26,34,Brett Hull,32,60,58,RW,1998
4807,35,35,Brett Hull,24,79,59,RW,1999
4808,40,36,Brett Hull,39,79,79,RW,2000
4809,33,37,Brett Hull,30,82,63,RW,2001
4810,39,38,Brett Hull,37,82,76,RW,2002
4811,43,39,Brett Hull,25,81,68,RW,2003
4812,1,41,Brett Hull,0,5,1,RW,2005
4813,0,21,Brett Kulak,0,1,0,D,2014
4814,0,22,Brett Kulak,0,8,0,D,2015
4815,3,23,Brett Kulak,0,21,3,D,2016
4816,6,24,Brett Kulak,2,71,8,D,2017
4817,9,24,Brett Lebda,3,46,12,D,2005
4818,13,25,Brett Lebda,5,74,18,D,2006
4819,11,26,Brett Lebda,3,78,14,D,2007
4820,10,27,Brett Lebda,6,65,16,D,2008
4821,7,28,Brett Lebda,1,63,8,D,2009
4822,3,29,Brett Lebda,1,41,4,D,2010
4823,3,30,Brett Lebda,1,30,4,D,2011
4824,0,20,Brett Lernout,0,1,0,D,2015
4825,0,21,Brett Lernout,0,2,0,D,2016
4826,1,22,Brett Lernout,0,18,1,D,2017
4827,3,19,Brett Lindros,1,33,4,RW,1994
4828,2,20,Brett Lindros,1,18,3,RW,1995
4829,0,23,Brett Lysak,0,2,0,C,2003
4830,0,22,Brett MacDonald,0,1,0,D,1987
4831,1,22,Brett Maclean,2,13,3,LW,2010
4832,2,23,Brett Maclean,0,5,2,LW,2011
4833,0,24,Brett McLean,0,2,0,C,2002
4834,20,25,Brett McLean,11,76,31,C,2003
4835,31,27,Brett McLean,9,82,40,C,2005
4836,20,28,Brett McLean,15,78,35,C,2006
4837,23,29,Brett McLean,14,67,37,C,2007
4838,12,30,Brett McLean,7,80,19,C,2008
4839,12,21,Brett Pesce,4,69,16,D,2015
4840,18,22,Brett Pesce,2,82,20,D,2016
4841,16,23,Brett Pesce,3,65,19,D,2017
4842,3,21,Brett Ritchie,6,31,9,RW,2014
4843,1,22,Brett Ritchie,0,8,1,RW,2015
4844,8,23,Brett Ritchie,16,78,24,RW,2016
4845,7,24,Brett Ritchie,7,71,14,RW,2017
4846,0,25,Brett Skinner,0,11,0,D,2008
4847,2,23,Brett Sterling,1,13,3,LW,2007
4848,0,24,Brett Sterling,1,6,1,LW,2008
4849,2,26,Brett Sterling,3,7,5,LW,2010
4850,0,27,Brett Sterling,0,4,0,LW,2011
4851,0,21,Brett Sutter,1,4,1,LW,2008
4852,0,22,Brett Sutter,0,10,0,C,2009
4853,1,23,Brett Sutter,0,5,1,C,2010
4854,3,24,Brett Sutter,0,15,3,C,2011
4855,0,25,Brett Sutter,0,3,0,C,2012
4856,1,26,Brett Sutter,1,17,2,C,2013
4857,3,27,Brett Sutter,0,6,3,C,2014
4858,30,18,Brian Bellows,35,78,65,RW,1982
4859,42,19,Brian Bellows,41,78,83,RW,1983
4860,36,20,Brian Bellows,26,78,62,RW,1984
4861,48,21,Brian Bellows,31,77,79,RW,1985
4862,27,22,Brian Bellows,26,65,53,RW,1986
4863,41,23,Brian Bellows,40,77,81,LW,1987
4864,27,24,Brian Bellows,23,60,50,LW,1988
4865,44,25,Brian Bellows,55,80,99,LW,1989
4866,40,26,Brian Bellows,35,80,75,LW,1990
4867,45,27,Brian Bellows,30,80,75,LW,1991
4868,48,28,Brian Bellows,40,82,88,RW,1992
4869,38,29,Brian Bellows,33,77,71,RW,1993
4870,8,30,Brian Bellows,8,41,16,LW,1994
4871,26,31,Brian Bellows,23,79,49,RW,1995
4872,15,32,Brian Bellows,16,69,31,LW,1996
4873,3,33,Brian Bellows,6,11,9,RW,1997
4874,19,34,Brian Bellows,17,76,36,LW,1998
4875,2,18,Brian Benning,0,4,2,D,1984
4876,36,20,Brian Benning,13,78,49,D,1986
4877,29,21,Brian Benning,8,77,37,D,1987
4878,26,22,Brian Benning,8,66,34,D,1988
4879,19,23,Brian Benning,6,55,25,D,1989
4880,24,24,Brian Benning,7,61,31,D,1990
4881,42,25,Brian Benning,4,75,46,D,1991
4882,24,26,Brian Benning,10,55,34,D,1992
4883,24,27,Brian Benning,6,73,30,D,1993
4884,7,28,Brian Benning,1,24,8,D,1994
4885,0,25,Brian Bonin,0,5,0,C,1998
4886,0,27,Brian Bonin,0,7,0,LW,2000
4887,0,23,Brian Bowles,0,3,0,D,1975
4888,0,23,Brian Bowles,0,3,0,D,1975
4889,1,23,Brian Boyle,4,8,5,C,2007
4890,1,24,Brian Boyle,4,28,5,C,2008
4891,2,25,Brian Boyle,4,71,6,C,2009
4892,14,26,Brian Boyle,21,82,35,C,2010
4893,15,27,Brian Boyle,11,82,26,C,2011
4894,3,28,Brian Boyle,2,38,5,C,2012
4895,12,29,Brian Boyle,6,82,18,C,2013
4896,9,30,Brian Boyle,15,82,24,C,2014
4897,7,31,Brian Boyle,13,76,20,C,2015
4898,3,32,Brian Boyle,0,21,3,C,2016
4899,10,33,Brian Boyle,13,69,23,C,2017
4900,33,28,Brian Bradley,22,78,55,LW,1972
4901,33,28,Brian Bradley,22,78,55,LW,1972
4902,23,29,Brian Bradley,15,78,38,LW,1973
4903,5,30,Brian Bradley,4,34,9,LW,1974
4904,1,21,Brian Bradley,0,5,1,C,1985
4905,18,22,Brian Bradley,10,40,28,C,1986
4906,5,23,Brian Bradley,3,11,8,C,1987
4907,27,24,Brian Bradley,18,71,45,C,1988
4908,29,25,Brian Bradley,19,67,48,C,1989
4909,31,26,Brian Bradley,11,70,42,C,1990
4910,21,27,Brian Bradley,10,59,31,RW,1991
4911,44,28,Brian Bradley,42,80,86,C,1992
4912,40,29,Brian Bradley,24,78,64,C,1993
4913,27,30,Brian Bradley,13,46,40,C,1994
4914,56,31,Brian Bradley,23,75,79,C,1995
4915,17,32,Brian Bradley,7,35,24,C,1996
4916,5,33,Brian Bradley,2,14,7,C,1997
4917,0,21,Brian Bye,0,1,0,C,1975
4918,0,21,Brian Bye,0,1,0,C,1975
4919,4,24,Brian Cadle,4,56,8,LW,1972
4920,4,24,Brian Cadle,4,56,8,LW,1972
4921,4,20,Brian Campbell,1,12,5,D,1999
4922,0,21,Brian Campbell,0,8,0,D,2000
4923,3,22,Brian Campbell,3,29,6,D,2001
4924,17,23,Brian Campbell,2,65,19,D,2002
4925,8,24,Brian Campbell,3,53,11,D,2003
4926,32,26,Brian Campbell,12,79,44,D,2005
4927,42,27,Brian Campbell,6,82,48,D,2006
4928,54,28,Brian Campbell,8,83,62,D,2007
4929,45,29,Brian Campbell,7,82,52,D,2008
4930,31,30,Brian Campbell,7,68,38,D,2009
4931,22,31,Brian Campbell,5,65,27,D,2010
4932,49,32,Brian Campbell,4,82,53,D,2011
4933,19,33,Brian Campbell,8,48,27,D,2012
4934,30,34,Brian Campbell,7,82,37,D,2013
4935,24,35,Brian Campbell,3,82,27,D,2014
4936,25,36,Brian Campbell,6,82,31,D,2015
4937,12,37,Brian Campbell,5,80,17,D,2016
4938,0,21,Brian Carlin,1,5,1,LW,1971
4939,22,22,Brian Carlin,12,65,34,LW,1972
4940,22,22,Brian Carlin,12,65,34,LW,1972
4941,0,23,Brian Carlin,1,5,1,LW,1973
4942,0,23,Brian Carlin,1,5,1,LW,1973
4943,0,22,Brian Chapman,0,3,0,D,1990
4944,3,21,Brian Coates,10,50,13,C,1973
4945,3,21,Brian Coates,10,50,13,C,1973
4946,9,22,Brian Coates,12,35,21,C,1974
4947,9,22,Brian Coates,12,35,21,C,1974
4948,16,23,Brian Coates,11,59,27,LW,1975
4949,16,23,Brian Coates,11,59,27,LW,1975
4950,5,24,Brian Coates,1,16,6,LW,1976
4951,5,24,Brian Coates,1,16,6,LW,1976
4952,10,25,Brian Coates,8,42,18,LW,1977
4953,10,25,Brian Coates,8,42,18,LW,1977
4954,14,26,Brian Conacher,11,64,25,LW,1967
4955,1,30,Brian Conacher,3,22,4,LW,1971
4956,19,31,Brian Conacher,8,69,27,C,1972
4957,19,31,Brian Conacher,8,69,27,C,1972
4958,1,20,Brian Curran,1,16,2,D,1983
4959,1,21,Brian Curran,0,56,1,D,1984
4960,5,22,Brian Curran,2,43,7,D,1985
4961,10,23,Brian Curran,0,68,10,D,1986
4962,2,24,Brian Curran,0,29,2,D,1987
4963,4,25,Brian Curran,1,47,5,D,1988
4964,9,26,Brian Curran,2,72,11,D,1989
4965,1,27,Brian Curran,0,21,1,D,1990
4966,0,28,Brian Curran,0,3,0,D,1991
4967,0,30,Brian Curran,1,26,1,D,1993
4968,0,22,Brian Derksen,0,1,0,D,1973
4969,0,22,Brian Derksen,0,1,0,D,1973
4970,1,20,Brian Dobbin,2,12,3,RW,1986
4971,5,21,Brian Dobbin,3,21,8,RW,1987
4972,1,22,Brian Dobbin,0,14,1,RW,1988
4973,1,23,Brian Dobbin,1,9,2,RW,1989
4974,0,25,Brian Dobbin,1,7,1,RW,1991
4975,1,22,Brian Dumoulin,0,6,1,D,2013
4976,0,23,Brian Dumoulin,1,8,1,D,2014
4977,16,24,Brian Dumoulin,0,79,16,D,2015
4978,14,25,Brian Dumoulin,1,70,15,D,2016
4979,13,26,Brian Dumoulin,5,80,18,D,2017
4980,2,23,Brian Engblom,1,28,3,D,1977
4981,11,24,Brian Engblom,3,62,14,D,1978
4982,20,25,Brian Engblom,3,70,23,D,1979
4983,25,26,Brian Engblom,3,80,28,D,1980
4984,29,27,Brian Engblom,4,76,33,D,1981
4985,22,28,Brian Engblom,5,73,27,D,1982
4986,28,29,Brian Engblom,2,80,30,D,1983
4987,19,30,Brian Engblom,4,79,23,D,1984
4988,17,31,Brian Engblom,4,79,21,D,1985
4989,4,32,Brian Engblom,0,32,4,D,1986
4990,1,29,Brian Fahey,0,7,1,D,2010
4991,3,25,Brian Felsner,1,12,4,LW,1997
4992,1,22,Brian Ferlin,0,7,1,RW,2014
4993,5,24,Brian Flynn,6,26,11,RW,2012
4994,7,25,Brian Flynn,6,79,13,C,2013
4995,12,26,Brian Flynn,5,63,17,C,2014
4996,6,27,Brian Flynn,4,56,10,C,2015
4997,4,28,Brian Flynn,6,51,10,C,2016
4998,35,25,Brian Gibbons,7,73,42,D,1972
4999,35,25,Brian Gibbons,7,73,42,D,1972
5000,31,26,Brian Gibbons,4,78,35,D,1973
5001,31,26,Brian Gibbons,4,78,35,D,1973
5002,22,27,Brian Gibbons,4,73,26,D,1974
5003,22,27,Brian Gibbons,4,73,26,D,1974
5004,0,28,Brian Gibbons,0,2,0,D,1975
5005,0,28,Brian Gibbons,0,2,0,D,1975
5006,12,25,Brian Gibbons,5,41,17,C,2013
5007,5,26,Brian Gibbons,0,25,5,C,2014
5008,14,29,Brian Gibbons,12,59,26,LW,2017
5009,7,23,Brian Gionta,4,33,11,RW,2001
5010,13,24,Brian Gionta,12,58,25,RW,2002
5011,8,25,Brian Gionta,21,75,29,RW,2003
5012,41,27,Brian Gionta,48,82,89,RW,2005
5013,20,28,Brian Gionta,25,62,45,RW,2006
5014,31,29,Brian Gionta,22,82,53,RW,2007
5015,40,30,Brian Gionta,20,81,60,RW,2008
5016,18,31,Brian Gionta,28,61,46,RW,2009
5017,17,32,Brian Gionta,29,82,46,RW,2010
5018,7,33,Brian Gionta,8,31,15,RW,2011
5019,12,34,Brian Gionta,14,48,26,RW,2012
5020,22,35,Brian Gionta,18,81,40,RW,2013
5021,22,36,Brian Gionta,13,69,35,RW,2014
5022,21,37,Brian Gionta,12,79,33,RW,2015
5023,20,38,Brian Gionta,15,82,35,RW,2016
5024,5,39,Brian Gionta,2,20,7,RW,2017
5025,14,23,Brian Glennie,1,52,15,D,1969
5026,8,24,Brian Glennie,0,54,8,D,1970
5027,8,25,Brian Glennie,2,61,10,D,1971
5028,10,26,Brian Glennie,1,44,11,D,1972
5029,18,27,Brian Glennie,4,65,22,D,1973
5030,7,28,Brian Glennie,1,63,8,D,1974
5031,8,29,Brian Glennie,0,69,8,D,1975
5032,10,30,Brian Glennie,1,69,11,D,1976
5033,15,31,Brian Glennie,2,77,17,D,1977
5034,2,32,Brian Glennie,2,18,4,D,1978
5035,5,23,Brian Glenwright,2,50,7,LW,1972
5036,5,23,Brian Glenwright,2,50,7,LW,1972
5037,2,24,Brian Glenwright,3,15,5,LW,1973
5038,2,24,Brian Glenwright,3,15,5,LW,1973
5039,14,20,Brian Glynn,5,67,19,D,1987
5040,1,21,Brian Glynn,0,9,1,D,1988
5041,0,22,Brian Glynn,0,1,0,D,1989
5042,11,23,Brian Glynn,8,66,19,D,1990
5043,18,24,Brian Glynn,4,62,22,D,1991
5044,12,25,Brian Glynn,4,64,16,D,1992
5045,13,26,Brian Glynn,2,64,15,D,1993
5046,6,27,Brian Glynn,1,43,7,D,1994
5047,4,28,Brian Glynn,0,54,4,D,1995
5048,0,29,Brian Glynn,1,1,1,D,1996
5049,1,23,Brian Hill,1,19,2,RW,1979
5050,3,22,Brian Holzinger,0,4,3,C,1994
5051,10,23,Brian Holzinger,10,58,20,C,1995
5052,29,24,Brian Holzinger,22,81,51,C,1996
5053,21,25,Brian Holzinger,14,69,35,C,1997
5054,17,26,Brian Holzinger,17,81,34,C,1998
5055,20,27,Brian Holzinger,10,73,30,C,1999
5056,25,28,Brian Holzinger,11,70,36,RW,2000
5057,2,29,Brian Holzinger,1,23,3,C,2001
5058,3,30,Brian Holzinger,1,14,4,C,2002
5059,15,31,Brian Holzinger,7,74,22,C,2003
5060,0,23,Brian Johnson,0,3,0,RW,1983
5061,5,33,Brian Kilrea,3,25,8,C,1967
5062,1,21,Brian Kinsella,0,4,1,C,1975
5063,0,22,Brian Kinsella,0,6,0,C,1976
5064,4,22,Brian Lashoff,1,31,5,D,2012
5065,5,23,Brian Lashoff,1,75,6,D,2013
5066,2,24,Brian Lashoff,0,11,2,D,2014
5067,0,26,Brian Lashoff,0,5,0,D,2016
5068,0,27,Brian Lashoff,0,1,0,D,2017
5069,11,24,Brian Lavender,5,46,16,LW,1971
5070,8,25,Brian Lavender,8,69,16,LW,1972
5071,0,26,Brian Lavender,0,4,0,LW,1973
5072,7,27,Brian Lavender,3,65,10,LW,1974
5073,6,28,Brian Lavender,5,37,11,LW,1975
5074,6,28,Brian Lavender,5,37,11,LW,1975
5075,21,18,Brian Lawton,10,58,31,C,1983
5076,6,19,Brian Lawton,5,40,11,LW,1984
5077,17,20,Brian Lawton,18,65,35,LW,1985
5078,23,21,Brian Lawton,21,66,44,LW,1986
5079,24,22,Brian Lawton,17,74,41,C,1987
5080,26,23,Brian Lawton,17,65,43,LW,1988
5081,7,24,Brian Lawton,7,35,14,LW,1989
5082,22,26,Brian Lawton,15,59,37,LW,1991
5083,8,27,Brian Lawton,2,21,10,LW,1992
5084,1,20,Brian Lee,0,6,1,D,2007
5085,11,21,Brian Lee,2,53,13,D,2008
5086,1,22,Brian Lee,2,23,3,D,2009
5087,3,23,Brian Lee,0,50,3,D,2010
5088,15,24,Brian Lee,1,55,16,D,2011
5089,0,25,Brian Lee,0,22,0,D,2012
5090,12,19,Brian Leetch,2,17,14,D,1987
5091,48,20,Brian Leetch,23,68,71,D,1988
5092,45,21,Brian Leetch,11,72,56,D,1989
5093,72,22,Brian Leetch,16,80,88,D,1990
5094,80,23,Brian Leetch,22,80,102,D,1991
5095,30,24,Brian Leetch,6,36,36,D,1992
5096,56,25,Brian Leetch,23,84,79,D,1993
5097,32,26,Brian Leetch,9,48,41,D,1994
5098,70,27,Brian Leetch,15,82,85,D,1995
5099,58,28,Brian Leetch,20,82,78,D,1996
5100,33,29,Brian Leetch,17,76,50,D,1997
5101,42,30,Brian Leetch,13,82,55,D,1998
5102,19,31,Brian Leetch,7,50,26,D,1999
5103,58,32,Brian Leetch,21,82,79,D,2000
5104,45,33,Brian Leetch,10,82,55,D,2001
5105,18,34,Brian Leetch,12,51,30,D,2002
5106,36,35,Brian Leetch,15,72,51,D,2003
5107,27,37,Brian Leetch,5,61,32,D,2005
5108,3,23,Brian Loney,2,12,5,RW,1995
5109,0,22,Brian Lundberg,0,1,0,D,1982
5110,3,24,Brian MacLellan,0,8,3,LW,1982
5111,29,25,Brian MacLellan,25,72,54,LW,1983
5112,54,26,Brian MacLellan,31,80,85,LW,1984
5113,29,27,Brian MacLellan,16,78,45,LW,1985
5114,31,28,Brian MacLellan,32,76,63,LW,1986
5115,32,29,Brian MacLellan,16,75,48,LW,1987
5116,26,30,Brian MacLellan,18,72,44,LW,1988
5117,18,31,Brian MacLellan,20,65,38,LW,1989
5118,14,32,Brian MacLellan,13,57,27,LW,1990
5119,5,33,Brian MacLellan,1,23,6,LW,1991
5120,0,22,Brian Marchinko,0,2,0,C,1970
5121,0,23,Brian Marchinko,0,3,0,C,1971
5122,6,24,Brian Marchinko,2,36,8,C,1972
5123,0,25,Brian Marchinko,0,6,0,C,1973
5124,1,25,Brian McCutcheon,3,17,4,LW,1974
5125,0,26,Brian McCutcheon,0,8,0,LW,1975
5126,0,27,Brian McCutcheon,0,12,0,LW,1976
5127,0,25,Brian McDonald,0,12,0,C,1970
5128,20,27,Brian McDonald,20,71,40,RW,1972
5129,20,27,Brian McDonald,20,71,40,RW,1972
5130,30,28,Brian McDonald,22,56,52,RW,1973
5131,30,28,Brian McDonald,22,56,52,RW,1973
5132,20,29,Brian McDonald,17,65,37,RW,1974
5133,20,29,Brian McDonald,17,65,37,RW,1974
5134,17,30,Brian McDonald,16,62,33,LW,1975
5135,17,30,Brian McDonald,16,62,33,LW,1975
5136,13,31,Brian McDonald,15,50,28,LW,1976
5137,13,31,Brian McDonald,15,50,28,LW,1976
5138,3,24,Brian McGrattan,2,60,5,RW,2005
5139,2,25,Brian McGrattan,0,45,2,RW,2006
5140,3,26,Brian McGrattan,0,38,3,RW,2007
5141,0,27,Brian McGrattan,0,5,0,RW,2008
5142,3,28,Brian McGrattan,1,34,4,RW,2009
5143,2,30,Brian McGrattan,0,30,2,RW,2011
5144,0,31,Brian McGrattan,3,21,3,RW,2012
5145,4,32,Brian McGrattan,4,76,8,RW,2013
5146,0,33,Brian McGrattan,0,8,0,RW,2014
5147,1,20,Brian McKenzie,1,6,2,LW,1971
5148,20,22,Brian McKenzie,18,78,38,LW,1973
5149,0,23,Brian McKenzie,1,9,1,LW,1974
5150,0,23,Brian McKenzie,1,9,1,LW,1974
5151,2,25,Brian McReynolds,0,9,2,C,1989
5152,0,26,Brian McReynolds,0,1,0,C,1990
5153,3,29,Brian McReynolds,1,20,4,C,1993
5154,1,23,Brian Morenz,7,30,8,RW,1972
5155,1,23,Brian Morenz,7,30,8,RW,1972
5156,30,24,Brian Morenz,20,75,50,RW,1973
5157,30,24,Brian Morenz,20,75,50,RW,1973
5158,19,25,Brian Morenz,20,78,39,C,1974
5159,19,25,Brian Morenz,20,78,39,C,1974
5160,7,26,Brian Morenz,6,40,13,LW,1975
5161,26,20,Brian Mullen,24,80,50,LW,1982
5162,41,21,Brian Mullen,21,75,62,LW,1983
5163,39,22,Brian Mullen,32,69,71,LW,1984
5164,34,23,Brian Mullen,28,79,62,LW,1985
5165,32,24,Brian Mullen,19,69,51,LW,1986
5166,29,25,Brian Mullen,25,74,54,LW,1987
5167,35,26,Brian Mullen,29,78,64,LW,1988
5168,41,27,Brian Mullen,27,76,68,RW,1989
5169,43,28,Brian Mullen,19,79,62,LW,1990
5170,28,29,Brian Mullen,18,72,46,RW,1991
5171,14,30,Brian Mullen,18,81,32,LW,1992
5172,0,27,Brian Murphy,0,1,0,C,1974
5173,20,22,Brian Noonan,10,77,30,C,1987
5174,12,23,Brian Noonan,4,45,16,RW,1988
5175,2,24,Brian Noonan,0,8,2,RW,1989
5176,4,25,Brian Noonan,0,7,4,RW,1990
5177,12,26,Brian Noonan,19,65,31,RW,1991
5178,14,27,Brian Noonan,16,63,30,RW,1992
5179,23,28,Brian Noonan,18,76,41,RW,1993
5180,13,29,Brian Noonan,14,45,27,RW,1994
5181,22,30,Brian Noonan,13,81,35,RW,1995
5182,22,31,Brian Noonan,12,73,34,RW,1996
5183,15,32,Brian Noonan,10,82,25,RW,1997
5184,0,33,Brian Noonan,0,7,0,RW,1998
5185,2,27,Brian O'Neill,0,22,2,C,2015
5186,2,21,Brian Ogilvie,1,12,3,C,1972
5187,5,23,Brian Ogilvie,5,20,10,C,1974
5188,1,24,Brian Ogilvie,2,9,3,C,1975
5189,0,25,Brian Ogilvie,0,3,0,C,1976
5190,8,26,Brian Ogilvie,6,32,14,C,1977
5191,5,27,Brian Ogilvie,1,14,6,C,1978
5192,21,24,Brian Perry,10,61,31,C,1968
5193,8,25,Brian Perry,6,34,14,LW,1969
5194,0,26,Brian Perry,0,1,0,C,1970
5195,20,28,Brian Perry,13,74,33,LW,1972
5196,20,28,Brian Perry,13,74,33,LW,1972
5197,11,29,Brian Perry,20,71,31,RW,1973
5198,11,29,Brian Perry,20,71,31,RW,1973
5199,0,23,Brian Pothier,0,3,0,D,2000
5200,6,24,Brian Pothier,3,33,9,D,2001
5201,4,25,Brian Pothier,2,14,6,D,2002
5202,6,26,Brian Pothier,2,55,8,D,2003
5203,30,28,Brian Pothier,5,77,35,D,2005
5204,25,29,Brian Pothier,3,72,28,D,2006
5205,9,30,Brian Pothier,5,38,14,D,2007
5206,2,31,Brian Pothier,1,9,3,D,2008
5207,10,32,Brian Pothier,5,61,15,D,2009
5208,41,20,Brian Propp,34,80,75,LW,1979
5209,40,21,Brian Propp,26,79,66,LW,1980
5210,47,22,Brian Propp,44,80,91,LW,1981
5211,42,23,Brian Propp,40,80,82,LW,1982
5212,53,24,Brian Propp,39,79,92,LW,1983
5213,54,25,Brian Propp,43,76,97,LW,1984
5214,57,26,Brian Propp,40,72,97,LW,1985
5215,36,27,Brian Propp,31,53,67,LW,1986
5216,49,28,Brian Propp,27,74,76,LW,1987
5217,46,29,Brian Propp,32,77,78,LW,1988
5218,24,30,Brian Propp,16,54,40,LW,1989
5219,47,31,Brian Propp,26,79,73,LW,1990
5220,23,32,Brian Propp,12,51,35,LW,1991
5221,3,33,Brian Propp,3,17,6,LW,1992
5222,17,34,Brian Propp,12,65,29,LW,1993
5223,27,26,Brian Rafalski,5,75,32,D,1999
5224,43,27,Brian Rafalski,9,78,52,D,2000
5225,40,28,Brian Rafalski,7,76,47,D,2001
5226,37,29,Brian Rafalski,3,79,40,D,2002
5227,30,30,Brian Rafalski,6,69,36,D,2003
5228,43,32,Brian Rafalski,6,82,49,D,2005
5229,47,33,Brian Rafalski,8,82,55,D,2006
5230,42,34,Brian Rafalski,13,73,55,D,2007
5231,49,35,Brian Rafalski,10,78,59,D,2008
5232,34,36,Brian Rafalski,8,78,42,D,2009
5233,44,37,Brian Rafalski,4,63,48,D,2010
5234,11,21,Brian Rolston,7,40,18,C,1994
5235,11,22,Brian Rolston,13,58,24,C,1995
5236,27,23,Brian Rolston,18,81,45,LW,1996
5237,14,24,Brian Rolston,16,76,30,LW,1997
5238,33,25,Brian Rolston,24,82,57,C,1998
5239,15,26,Brian Rolston,16,77,31,LW,1999
5240,39,27,Brian Rolston,19,77,58,LW,2000
5241,31,28,Brian Rolston,31,82,62,C,2001
5242,32,29,Brian Rolston,27,81,59,C,2002
5243,29,30,Brian Rolston,19,82,48,C,2003
5244,45,32,Brian Rolston,34,82,79,C,2005
5245,33,33,Brian Rolston,31,78,64,RW,2006
5246,28,34,Brian Rolston,31,81,59,LW,2007
5247,17,35,Brian Rolston,15,64,32,LW,2008
5248,17,36,Brian Rolston,20,80,37,C,2009
5249,20,37,Brian Rolston,14,65,34,C,2010
5250,17,38,Brian Rolston,7,70,24,C,2011
5251,1,23,Brian Salcido,0,2,1,D,2008
5252,0,22,Brian Savage,1,3,1,C,1993
5253,7,23,Brian Savage,12,37,19,C,1994
5254,8,24,Brian Savage,25,75,33,LW,1995
5255,37,25,Brian Savage,23,81,60,LW,1996
5256,17,26,Brian Savage,26,64,43,RW,1997
5257,10,27,Brian Savage,16,54,26,LW,1998
5258,12,28,Brian Savage,17,38,29,RW,1999
5259,24,29,Brian Savage,21,62,45,LW,2000
5260,21,30,Brian Savage,20,77,41,LW,2001
5261,10,31,Brian Savage,6,43,16,LW,2002
5262,16,32,Brian Savage,16,74,32,LW,2003
5263,5,34,Brian Savage,9,66,14,LW,2005
5264,13,22,Brian Skrudland,9,65,22,C,1985
5265,17,23,Brian Skrudland,11,79,28,C,1986
5266,24,24,Brian Skrudland,12,79,36,C,1987
5267,29,25,Brian Skrudland,12,71,41,C,1988
5268,31,26,Brian Skrudland,11,59,42,C,1989
5269,19,27,Brian Skrudland,15,57,34,C,1990
5270,3,28,Brian Skrudland,3,42,6,C,1991
5271,7,29,Brian Skrudland,7,39,14,C,1992
5272,25,30,Brian Skrudland,15,79,40,C,1993
5273,9,31,Brian Skrudland,5,47,14,C,1994
5274,20,32,Brian Skrudland,7,79,27,C,1995
5275,13,33,Brian Skrudland,5,51,18,C,1996
5276,6,34,Brian Skrudland,7,72,13,C,1997
5277,1,35,Brian Skrudland,4,40,5,C,1998
5278,2,36,Brian Skrudland,1,22,3,C,1999
5279,9,27,Brian Smith,10,58,19,LW,1967
5280,1,28,Brian Smith,0,9,1,LW,1968
5281,6,32,Brian Smith,7,48,13,LW,1972
5282,6,32,Brian Smith,7,48,13,LW,1972
5283,0,20,Brian Spencer,0,9,0,LW,1969
5284,15,21,Brian Spencer,9,50,24,LW,1970
5285,5,22,Brian Spencer,1,36,6,LW,1971
5286,24,23,Brian Spencer,14,78,38,LW,1972
5287,18,24,Brian Spencer,8,67,26,LW,1973
5288,29,25,Brian Spencer,12,73,41,LW,1974
5289,26,26,Brian Spencer,13,77,39,LW,1975
5290,15,27,Brian Spencer,14,77,29,LW,1976
5291,11,28,Brian Spencer,9,79,20,LW,1977
5292,0,29,Brian Spencer,0,7,0,LW,1978
5293,0,24,Brian Stapleton,0,1,0,RW,1975
5294,0,23,Brian Strait,0,3,0,D,2010
5295,1,24,Brian Strait,0,9,1,D,2011
5296,4,25,Brian Strait,0,19,4,D,2012
5297,6,26,Brian Strait,3,47,9,D,2013
5298,5,27,Brian Strait,2,52,7,D,2014
5299,5,28,Brian Strait,1,52,6,D,2015
5300,2,29,Brian Strait,0,5,2,D,2016
5301,1,23,Brian Sullivan,0,2,1,RW,1992
5302,0,19,Brian Sutherby,0,7,0,C,2001
5303,9,20,Brian Sutherby,2,72,11,C,2002
5304,0,21,Brian Sutherby,2,30,2,LW,2003
5305,16,23,Brian Sutherby,14,76,30,C,2005
5306,10,24,Brian Sutherby,7,69,17,C,2006
5307,1,25,Brian Sutherby,1,50,2,C,2007
5308,7,26,Brian Sutherby,8,59,15,C,2008
5309,4,27,Brian Sutherby,5,46,9,C,2009
5310,2,28,Brian Sutherby,2,51,4,C,2010
5311,10,20,Brian Sutter,4,35,14,LW,1976
5312,13,21,Brian Sutter,9,78,22,LW,1977
5313,39,22,Brian Sutter,41,77,80,LW,1978
5314,35,23,Brian Sutter,23,71,58,LW,1979
5315,34,24,Brian Sutter,35,78,69,LW,1980
5316,36,25,Brian Sutter,39,74,75,LW,1981
5317,30,26,Brian Sutter,46,79,76,LW,1982
5318,51,27,Brian Sutter,32,76,83,LW,1983
5319,37,28,Brian Sutter,37,77,74,LW,1984
5320,23,29,Brian Sutter,19,44,42,LW,1985
5321,3,30,Brian Sutter,3,14,6,LW,1986
5322,22,31,Brian Sutter,15,76,37,LW,1987
5323,1,24,Brian Swanson,1,16,2,C,2000
5324,1,25,Brian Swanson,1,8,2,C,2001
5325,10,26,Brian Swanson,2,44,12,C,2002
5326,1,27,Brian Swanson,0,2,1,C,2003
5327,0,27,Brian Tutt,1,7,1,D,1989
5328,2,22,Brian Walsh,0,5,2,C,1976
5329,2,22,Brian Walsh,0,5,2,C,1976
5330,0,28,Brian Watts,0,4,0,LW,1975
5331,0,21,Brian Wesenberg,0,1,0,RW,1998
5332,0,22,Brian White,0,2,0,D,1998
5333,0,18,Brian Wilks,0,2,0,C,1984
5334,8,19,Brian Wilks,4,43,12,C,1985
5335,0,20,Brian Wilks,0,1,0,C,1986
5336,0,22,Brian Wilks,0,2,0,C,1988
5337,0,21,Brian Willsie,0,1,0,RW,1999
5338,7,23,Brian Willsie,7,56,14,RW,2001
5339,1,24,Brian Willsie,0,12,1,RW,2002
5340,5,25,Brian Willsie,10,49,15,LW,2003
5341,22,27,Brian Willsie,19,82,41,RW,2005
5342,10,28,Brian Willsie,11,81,21,RW,2006
5343,8,29,Brian Willsie,4,53,12,RW,2007
5344,3,30,Brian Willsie,1,42,4,RW,2008
5345,0,31,Brian Willsie,0,4,0,RW,2009
5346,1,32,Brian Willsie,0,1,1,RW,2010
5347,0,25,Brian Wiseman,0,3,0,C,1996
5348,2,22,Brian Young,0,8,2,D,1980
5349,15,22,Brit Selby,15,56,30,LW,1967
5350,15,23,Brit Selby,12,77,27,LW,1968
5351,13,24,Brit Selby,10,74,23,LW,1969
5352,5,25,Brit Selby,1,67,6,LW,1970
5353,0,26,Brit Selby,0,6,0,LW,1971
5354,30,27,Brit Selby,13,72,43,LW,1972
5355,30,27,Brit Selby,13,72,43,LW,1972
5356,17,28,Brit Selby,9,64,26,LW,1973
5357,17,28,Brit Selby,9,64,26,LW,1973
5358,4,29,Brit Selby,1,17,5,LW,1974
5359,4,29,Brit Selby,1,17,5,LW,1974
5360,1,19,Brock Boeser,4,9,5,RW,2016
5361,26,20,Brock Boeser,29,62,55,RW,2017
5362,1,21,Brock McGinn,3,21,4,LW,2015
5363,9,22,Brock McGinn,7,57,16,LW,2016
5364,14,23,Brock McGinn,16,80,30,LW,2017
5365,12,22,Brock Nelson,14,72,26,C,2013
5366,22,23,Brock Nelson,20,82,42,C,2014
5367,14,24,Brock Nelson,26,81,40,LW,2015
5368,25,25,Brock Nelson,20,81,45,LW,2016
5369,16,26,Brock Nelson,19,82,35,LW,2017
5370,0,22,Brock Trotter,0,2,0,C,2009
5371,0,23,Brodie Dupont,0,1,0,C,2010
5372,0,23,Brody Sutter,0,4,0,C,2014
5373,0,24,Brody Sutter,0,8,0,C,2015
5374,6,37,Bronco Horvath,1,14,7,C,1967
5375,1,20,Brooks Laich,0,5,1,C,2003
5376,14,22,Brooks Laich,7,73,21,C,2005
5377,10,23,Brooks Laich,8,73,18,C,2006
5378,16,24,Brooks Laich,21,82,37,C,2007
5379,30,25,Brooks Laich,23,82,53,C,2008
5380,34,26,Brooks Laich,25,78,59,C,2009
5381,32,27,Brooks Laich,16,82,48,C,2010
5382,25,28,Brooks Laich,16,82,41,C,2011
5383,3,29,Brooks Laich,1,9,4,C,2012
5384,7,30,Brooks Laich,8,51,15,C,2013
5385,13,31,Brooks Laich,7,66,20,C,2014
5386,12,32,Brooks Laich,2,81,14,C,2015
5387,1,34,Brooks Laich,0,12,1,C,2017
5388,0,22,Brooks Orpik,0,6,0,D,2002
5389,9,23,Brooks Orpik,1,79,10,D,2003
5390,7,25,Brooks Orpik,2,64,9,D,2005
5391,6,26,Brooks Orpik,0,70,6,D,2006
5392,10,27,Brooks Orpik,1,78,11,D,2007
5393,17,28,Brooks Orpik,2,79,19,D,2008
5394,23,29,Brooks Orpik,2,73,25,D,2009
5395,12,30,Brooks Orpik,1,63,13,D,2010
5396,16,31,Brooks Orpik,2,73,18,D,2011
5397,8,32,Brooks Orpik,0,46,8,D,2012
5398,11,33,Brooks Orpik,2,72,13,D,2013
5399,19,34,Brooks Orpik,0,78,19,D,2014
5400,7,35,Brooks Orpik,3,41,10,D,2015
5401,14,36,Brooks Orpik,0,79,14,D,2016
5402,10,37,Brooks Orpik,0,81,10,D,2017
5403,0,24,Bruce Abbey,1,17,1,D,1975
5404,0,24,Bruce Abbey,1,17,1,D,1975
5405,2,20,Bruce Affleck,0,13,2,D,1974
5406,26,21,Bruce Affleck,4,80,30,D,1975
5407,20,22,Bruce Affleck,5,80,25,D,1976
5408,14,23,Bruce Affleck,4,75,18,D,1977
5409,3,24,Bruce Affleck,1,26,4,D,1978
5410,1,25,Bruce Affleck,0,5,1,D,1979
5411,0,29,Bruce Affleck,0,1,0,D,1983
5412,31,19,Bruce Bell,6,75,37,D,1984
5413,18,20,Bruce Bell,2,75,20,D,1985
5414,13,21,Bruce Bell,3,45,16,D,1986
5415,2,22,Bruce Bell,1,13,3,D,1987
5416,0,24,Bruce Bell,0,1,0,D,1989
5417,6,21,Bruce Boudreau,3,30,9,C,1975
5418,6,21,Bruce Boudreau,3,30,9,C,1975
5419,5,22,Bruce Boudreau,2,15,7,C,1976
5420,18,23,Bruce Boudreau,11,40,29,C,1977
5421,3,24,Bruce Boudreau,4,26,7,C,1978
5422,0,25,Bruce Boudreau,0,2,0,C,1979
5423,14,26,Bruce Boudreau,10,39,24,C,1980
5424,2,27,Bruce Boudreau,0,12,2,C,1981
5425,0,31,Bruce Boudreau,1,7,1,C,1985
5426,0,18,Bruce Cassidy,0,1,0,D,1983
5427,0,20,Bruce Cassidy,0,1,0,D,1985
5428,0,21,Bruce Cassidy,0,2,0,D,1986
5429,10,22,Bruce Cassidy,3,21,13,D,1987
5430,2,23,Bruce Cassidy,0,9,2,D,1988
5431,1,24,Bruce Cassidy,1,2,2,D,1989
5432,6,23,Bruce Cowick,5,65,11,RW,1974
5433,0,24,Bruce Cowick,0,5,0,LW,1975
5434,11,24,Bruce Crowder,16,63,27,RW,1981
5435,19,25,Bruce Crowder,21,80,40,RW,1982
5436,14,26,Bruce Crowder,6,74,20,RW,1983
5437,7,27,Bruce Crowder,4,26,11,RW,1984
5438,2,21,Bruce Driver,0,4,2,D,1983
5439,23,22,Bruce Driver,9,67,32,D,1984
5440,15,23,Bruce Driver,3,40,18,D,1985
5441,28,24,Bruce Driver,6,74,34,D,1986
5442,40,25,Bruce Driver,15,74,55,D,1987
5443,15,26,Bruce Driver,1,27,16,D,1988
5444,46,27,Bruce Driver,7,75,53,D,1989
5445,36,28,Bruce Driver,9,73,45,D,1990
5446,35,29,Bruce Driver,7,78,42,D,1991
5447,40,30,Bruce Driver,14,83,54,D,1992
5448,24,31,Bruce Driver,8,66,32,D,1993
5449,12,32,Bruce Driver,4,41,16,D,1994
5450,34,33,Bruce Driver,3,66,37,D,1995
5451,25,34,Bruce Driver,5,79,30,D,1996
5452,15,35,Bruce Driver,5,75,20,D,1997
5453,0,19,Bruce Eakin,0,1,0,C,1981
5454,1,21,Bruce Eakin,2,7,3,C,1983
5455,0,22,Bruce Eakin,0,1,0,C,1984
5456,1,23,Bruce Eakin,0,4,1,C,1985
5457,10,24,Bruce Gardiner,11,67,21,RW,1996
5458,11,25,Bruce Gardiner,7,55,18,C,1997
5459,8,26,Bruce Gardiner,4,59,12,C,1998
5460,9,27,Bruce Gardiner,3,51,12,RW,1999
5461,15,28,Bruce Gardiner,7,73,22,LW,2000
5462,1,29,Bruce Gardiner,2,7,3,RW,2001
5463,0,20,Bruce Greig,0,1,0,LW,1973
5464,1,21,Bruce Greig,0,8,1,LW,1974
5465,1,23,Bruce Greig,1,7,2,LW,1976
5466,1,23,Bruce Greig,1,7,2,LW,1976
5467,1,24,Bruce Greig,3,32,4,LW,1977
5468,1,24,Bruce Greig,3,32,4,LW,1977
5469,7,25,Bruce Greig,3,21,10,LW,1978
5470,7,25,Bruce Greig,3,21,10,LW,1978
5471,0,21,Bruce Holloway,0,2,0,D,1984
5472,24,26,Bruce MacGregor,15,71,39,RW,1967
5473,23,27,Bruce MacGregor,18,69,41,RW,1968
5474,23,28,Bruce MacGregor,15,73,38,RW,1969
5475,29,29,Bruce MacGregor,18,74,47,RW,1970
5476,21,30,Bruce MacGregor,19,75,40,RW,1971
5477,12,31,Bruce MacGregor,14,52,26,RW,1972
5478,27,32,Bruce MacGregor,17,66,44,RW,1973
5479,28,33,Bruce MacGregor,24,72,52,RW,1974
5480,28,33,Bruce MacGregor,24,72,52,RW,1974
5481,10,34,Bruce MacGregor,13,63,23,RW,1975
5482,10,34,Bruce MacGregor,13,63,23,RW,1975
5483,0,24,Bruce Major,0,4,0,C,1990
5484,0,23,Bruce McIntosh,0,2,0,D,1972
5485,1,22,Bruce Shoebottom,0,3,1,D,1987
5486,3,23,Bruce Shoebottom,1,29,4,D,1988
5487,0,24,Bruce Shoebottom,0,2,0,D,1989
5488,0,25,Bruce Shoebottom,0,1,0,D,1990
5489,4,21,Bruno Gervais,3,27,7,D,2005
5490,6,22,Bruno Gervais,0,51,6,D,2006
5491,13,23,Bruno Gervais,0,60,13,D,2007
5492,16,24,Bruno Gervais,3,69,19,D,2008
5493,14,25,Bruno Gervais,3,71,17,D,2009
5494,6,26,Bruno Gervais,0,53,6,D,2010
5495,7,27,Bruno Gervais,6,50,13,D,2011
5496,5,28,Bruno Gervais,1,37,6,D,2012
5497,0,21,Bruno St. Jacques,0,7,0,D,2001
5498,5,22,Bruno St. Jacques,2,24,7,D,2002
5499,2,23,Bruno St. Jacques,0,35,2,D,2003
5500,0,25,Bruno St. Jacques,1,1,1,D,2005
5501,0,22,Bryan Adams,0,2,0,LW,1999
5502,1,23,Bryan Adams,0,9,1,LW,2000
5503,0,20,Bryan Allen,0,6,0,D,2000
5504,0,21,Bryan Allen,0,11,0,D,2001
5505,3,22,Bryan Allen,5,48,8,D,2002
5506,5,23,Bryan Allen,2,74,7,D,2003
5507,10,25,Bryan Allen,7,77,17,D,2005
5508,21,26,Bryan Allen,4,82,25,D,2006
5509,14,27,Bryan Allen,2,73,16,D,2007
5510,1,28,Bryan Allen,0,2,1,D,2008
5511,9,29,Bryan Allen,4,74,13,D,2009
5512,13,30,Bryan Allen,4,72,17,D,2010
5513,13,31,Bryan Allen,1,82,14,D,2011
5514,6,32,Bryan Allen,0,41,6,D,2012
5515,10,33,Bryan Allen,0,68,10,D,2013
5516,2,34,Bryan Allen,0,11,2,D,2014
5517,40,19,Bryan Berard,8,82,48,D,1996
5518,32,20,Bryan Berard,14,75,46,D,1997
5519,25,21,Bryan Berard,9,69,34,D,1998
5520,27,22,Bryan Berard,3,64,30,D,1999
5521,21,24,Bryan Berard,2,82,23,D,2001
5522,28,25,Bryan Berard,10,80,38,D,2002
5523,34,26,Bryan Berard,13,58,47,D,2003
5524,20,28,Bryan Berard,12,44,32,D,2005
5525,3,29,Bryan Berard,0,11,3,D,2006
5526,17,30,Bryan Berard,5,54,22,D,2007
5527,0,20,Bryan Bickell,2,3,2,LW,2006
5528,0,21,Bryan Bickell,0,4,0,LW,2007
5529,1,23,Bryan Bickell,3,16,4,LW,2009
5530,20,24,Bryan Bickell,17,78,37,LW,2010
5531,15,25,Bryan Bickell,9,71,24,LW,2011
5532,14,26,Bryan Bickell,9,48,23,LW,2012
5533,4,27,Bryan Bickell,11,59,15,LW,2013
5534,14,28,Bryan Bickell,14,80,28,LW,2014
5535,2,29,Bryan Bickell,0,25,2,LW,2015
5536,0,30,Bryan Bickell,1,11,1,LW,2016
5537,15,23,Bryan Campbell,6,44,21,C,1967
5538,1,24,Bryan Campbell,2,18,3,C,1968
5539,5,25,Bryan Campbell,5,45,10,C,1969
5540,37,26,Bryan Campbell,17,78,54,C,1970
5541,13,27,Bryan Campbell,5,75,18,C,1971
5542,48,28,Bryan Campbell,25,75,73,C,1972
5543,48,28,Bryan Campbell,25,75,73,C,1972
5544,62,29,Bryan Campbell,27,76,89,C,1973
5545,62,29,Bryan Campbell,27,76,89,C,1973
5546,34,30,Bryan Campbell,29,78,63,C,1974
5547,50,31,Bryan Campbell,22,77,72,C,1975
5548,46,32,Bryan Campbell,13,74,59,C,1976
5549,46,32,Bryan Campbell,13,74,59,C,1976
5550,13,33,Bryan Campbell,7,53,20,C,1977
5551,13,33,Bryan Campbell,7,53,20,C,1977
5552,17,23,Bryan Erickson,12,45,29,RW,1983
5553,13,24,Bryan Erickson,15,57,28,RW,1984
5554,23,25,Bryan Erickson,20,55,43,RW,1985
5555,30,26,Bryan Erickson,20,68,50,RW,1986
5556,19,27,Bryan Erickson,7,53,26,RW,1987
5557,7,30,Bryan Erickson,0,6,7,RW,1990
5558,4,31,Bryan Erickson,2,10,6,RW,1991
5559,12,32,Bryan Erickson,4,41,16,RW,1992
5560,0,33,Bryan Erickson,0,16,0,RW,1993
5561,10,20,Bryan Fogarty,4,45,14,D,1989
5562,22,21,Bryan Fogarty,9,45,31,D,1990
5563,12,22,Bryan Fogarty,3,20,15,D,1991
5564,4,23,Bryan Fogarty,0,12,4,D,1992
5565,2,24,Bryan Fogarty,1,13,3,D,1993
5566,2,25,Bryan Fogarty,5,21,7,D,1994
5567,4,26,Bryan Helmer,0,40,4,D,1998
5568,1,27,Bryan Helmer,1,15,2,D,1999
5569,4,28,Bryan Helmer,2,20,6,D,2000
5570,5,29,Bryan Helmer,5,40,10,D,2001
5571,0,30,Bryan Helmer,0,2,0,D,2002
5572,1,31,Bryan Helmer,0,17,1,D,2003
5573,3,36,Bryan Helmer,0,12,3,D,2008
5574,19,28,Bryan Hextall,12,66,31,C,1969
5575,32,29,Bryan Hextall,16,76,48,C,1970
5576,24,30,Bryan Hextall,20,78,44,C,1971
5577,33,31,Bryan Hextall,21,78,54,C,1972
5578,11,32,Bryan Hextall,4,77,15,C,1973
5579,16,33,Bryan Hextall,18,74,34,C,1974
5580,24,34,Bryan Hextall,8,79,32,C,1975
5581,7,24,Bryan Lefley,3,63,10,D,1972
5582,0,25,Bryan Lefley,0,7,0,D,1973
5583,3,26,Bryan Lefley,0,29,3,D,1974
5584,6,28,Bryan Lefley,0,58,6,D,1976
5585,13,29,Bryan Lefley,4,71,17,D,1977
5586,0,29,Bryan Lerg,1,2,1,C,2014
5587,0,30,Bryan Lerg,0,6,0,C,2015
5588,10,20,Bryan Little,6,48,16,C,2007
5589,20,21,Bryan Little,31,79,51,RW,2008
5590,21,22,Bryan Little,13,79,34,C,2009
5591,30,23,Bryan Little,18,76,48,C,2010
5592,22,24,Bryan Little,24,74,46,C,2011
5593,25,25,Bryan Little,7,48,32,C,2012
5594,41,26,Bryan Little,23,82,64,RW,2013
5595,28,27,Bryan Little,24,70,52,C,2014
5596,25,28,Bryan Little,17,57,42,C,2015
5597,26,29,Bryan Little,21,59,47,C,2016
5598,27,30,Bryan Little,16,82,43,C,2017
5599,0,19,Bryan Marchment,0,2,0,D,1988
5600,2,20,Bryan Marchment,0,7,2,D,1989
5601,2,21,Bryan Marchment,2,28,4,D,1990
5602,10,22,Bryan Marchment,5,58,15,D,1991
5603,15,23,Bryan Marchment,5,78,20,D,1992
5604,11,24,Bryan Marchment,4,55,15,D,1993
5605,5,25,Bryan Marchment,1,40,6,D,1994
5606,15,26,Bryan Marchment,3,78,18,D,1995
5607,13,27,Bryan Marchment,3,71,16,D,1996
5608,11,28,Bryan Marchment,2,61,13,D,1997
5609,6,29,Bryan Marchment,2,59,8,D,1998
5610,4,30,Bryan Marchment,0,49,4,D,1999
5611,11,31,Bryan Marchment,7,75,18,D,2000
5612,20,32,Bryan Marchment,2,72,22,D,2001
5613,12,33,Bryan Marchment,2,81,14,D,2002
5614,3,34,Bryan Marchment,1,75,4,D,2003
5615,2,36,Bryan Marchment,1,37,3,D,2005
5616,14,20,Bryan Maxwell,3,73,17,D,1975
5617,14,20,Bryan Maxwell,3,73,17,D,1975
5618,8,21,Bryan Maxwell,1,34,9,D,1976
5619,8,21,Bryan Maxwell,1,34,9,D,1976
5620,5,22,Bryan Maxwell,2,18,7,D,1977
5621,1,22,Bryan Maxwell,2,17,3,D,1977
5622,1,22,Bryan Maxwell,2,17,3,D,1977
5623,6,23,Bryan Maxwell,1,25,7,D,1978
5624,11,24,Bryan Maxwell,1,57,12,D,1979
5625,10,25,Bryan Maxwell,3,40,13,D,1980
5626,9,26,Bryan Maxwell,1,45,10,D,1981
5627,13,27,Bryan Maxwell,7,54,20,D,1982
5628,15,28,Bryan Maxwell,3,48,18,D,1983
5629,8,29,Bryan Maxwell,0,44,8,D,1984
5630,16,20,Bryan McCabe,7,82,23,D,1995
5631,20,21,Bryan McCabe,8,82,28,D,1996
5632,20,22,Bryan McCabe,4,82,24,D,1997
5633,14,23,Bryan McCabe,7,69,21,D,1998
5634,19,24,Bryan McCabe,6,79,25,D,1999
5635,24,25,Bryan McCabe,5,82,29,D,2000
5636,26,26,Bryan McCabe,17,82,43,D,2001
5637,18,27,Bryan McCabe,6,75,24,D,2002
5638,37,28,Bryan McCabe,16,75,53,D,2003
5639,49,30,Bryan McCabe,19,73,68,D,2005
5640,42,31,Bryan McCabe,15,82,57,D,2006
5641,18,32,Bryan McCabe,5,54,23,D,2007
5642,24,33,Bryan McCabe,15,69,39,D,2008
5643,35,34,Bryan McCabe,8,82,43,D,2009
5644,21,35,Bryan McCabe,7,67,28,D,2010
5645,4,20,Bryan McSheffrey,4,33,8,RW,1972
5646,3,21,Bryan McSheffrey,9,54,12,RW,1973
5647,0,22,Bryan McSheffrey,0,3,0,RW,1974
5648,0,22,Bryan Muir,0,5,0,D,1995
5649,0,24,Bryan Muir,0,7,0,D,1997
5650,4,25,Bryan Muir,1,54,5,D,1998
5651,4,26,Bryan Muir,3,41,7,D,1999
5652,3,27,Bryan Muir,0,18,3,D,2000
5653,1,28,Bryan Muir,1,22,2,D,2001
5654,2,29,Bryan Muir,0,32,2,D,2002
5655,1,30,Bryan Muir,0,2,1,D,2003
5656,18,32,Bryan Muir,8,72,26,D,2005
5657,4,33,Bryan Muir,3,26,7,D,2006
5658,2,24,Bryan Rodney,0,8,2,D,2008
5659,10,25,Bryan Rodney,1,22,11,D,2009
5660,0,26,Bryan Rodney,0,3,0,D,2010
5661,0,27,Bryan Rodney,0,1,0,D,2011
5662,1,22,Bryan Rust,1,14,2,RW,2014
5663,7,23,Bryan Rust,4,41,11,RW,2015
5664,13,24,Bryan Rust,15,57,28,RW,2016
5665,25,25,Bryan Rust,13,69,38,RW,2017
5666,3,21,Bryan Smolinski,1,9,4,C,1992
5667,20,22,Bryan Smolinski,31,83,51,C,1993
5668,13,23,Bryan Smolinski,18,44,31,LW,1994
5669,40,24,Bryan Smolinski,24,81,64,C,1995
5670,28,25,Bryan Smolinski,28,64,56,LW,1996
5671,30,26,Bryan Smolinski,13,81,43,C,1997
5672,24,27,Bryan Smolinski,16,82,40,C,1998
5673,36,28,Bryan Smolinski,20,79,56,C,1999
5674,32,29,Bryan Smolinski,27,78,59,LW,2000
5675,25,30,Bryan Smolinski,13,80,38,C,2001
5676,25,31,Bryan Smolinski,21,68,46,RW,2002
5677,27,32,Bryan Smolinski,19,80,46,C,2003
5678,31,34,Bryan Smolinski,17,81,48,C,2005
5679,26,35,Bryan Smolinski,18,82,44,C,2006
5680,17,36,Bryan Smolinski,8,64,25,C,2007
5681,63,19,Bryan Trottier,32,80,95,C,1975
5682,42,20,Bryan Trottier,30,76,72,C,1976
5683,77,21,Bryan Trottier,46,77,123,C,1977
5684,87,22,Bryan Trottier,47,76,134,C,1978
5685,62,23,Bryan Trottier,42,78,104,C,1979
5686,72,24,Bryan Trottier,31,73,103,C,1980
5687,79,25,Bryan Trottier,50,80,129,C,1981
5688,55,26,Bryan Trottier,34,80,89,C,1982
5689,71,27,Bryan Trottier,40,68,111,C,1983
5690,31,28,Bryan Trottier,28,68,59,C,1984
5691,59,29,Bryan Trottier,37,78,96,C,1985
5692,64,30,Bryan Trottier,23,80,87,C,1986
5693,52,31,Bryan Trottier,30,77,82,C,1987
5694,28,32,Bryan Trottier,17,73,45,C,1988
5695,11,33,Bryan Trottier,13,59,24,C,1989
5696,19,34,Bryan Trottier,9,52,28,C,1990
5697,18,35,Bryan Trottier,11,63,29,C,1991
5698,11,37,Bryan Trottier,4,41,15,C,1993
5699,1,25,Bryan Watson,0,12,1,D,1967
5700,7,26,Bryan Watson,2,68,9,D,1968
5701,9,27,Bryan Watson,1,61,10,D,1969
5702,6,28,Bryan Watson,2,43,8,D,1970
5703,17,29,Bryan Watson,3,75,20,D,1971
5704,17,30,Bryan Watson,1,69,18,D,1972
5705,9,31,Bryan Watson,1,70,10,D,1973
5706,13,32,Bryan Watson,1,70,14,D,1974
5707,18,33,Bryan Watson,0,79,18,D,1975
5708,15,34,Bryan Watson,1,70,16,D,1976
5709,11,35,Bryan Watson,3,79,14,D,1977
5710,1,36,Bryan Watson,0,20,1,D,1978
5711,2,36,Bryan Watson,0,21,2,D,1978
5712,2,36,Bryan Watson,0,21,2,D,1978
5713,0,20,Bryan Young,0,15,0,D,2006
5714,0,21,Bryan Young,0,2,0,D,2007
5715,0,21,Bryce Lampman,0,8,0,D,2003
5716,0,23,Bryce Lampman,0,1,0,D,2005
5717,0,24,Bryce Lampman,0,1,0,D,2006
5718,8,24,Bryce Salvador,2,75,10,D,2000
5719,7,25,Bryce Salvador,5,66,12,D,2001
5720,8,26,Bryce Salvador,2,71,10,D,2002
5721,5,27,Bryce Salvador,3,69,8,D,2003
5722,4,29,Bryce Salvador,1,46,5,D,2005
5723,5,30,Bryce Salvador,2,64,7,D,2006
5724,10,31,Bryce Salvador,1,64,11,D,2007
5725,13,32,Bryce Salvador,3,76,16,D,2008
5726,10,33,Bryce Salvador,4,79,14,D,2009
5727,9,35,Bryce Salvador,0,82,9,D,2011
5728,2,36,Bryce Salvador,0,39,2,D,2012
5729,3,37,Bryce Salvador,1,40,4,D,2013
5730,2,38,Bryce Salvador,0,15,2,D,2014
5731,0,22,Bryce Van Brabant,0,6,0,LW,2013
5732,12,22,Bryon Baltimore,8,77,20,D,1974
5733,12,22,Bryon Baltimore,8,77,20,D,1974
5734,18,23,Bryon Baltimore,2,78,20,D,1975
5735,18,23,Bryon Baltimore,2,78,20,D,1975
5736,15,24,Bryon Baltimore,0,55,15,D,1976
5737,15,24,Bryon Baltimore,0,55,15,D,1976
5738,16,25,Bryon Baltimore,3,50,19,D,1977
5739,16,25,Bryon Baltimore,3,50,19,D,1977
5740,11,26,Bryon Baltimore,5,71,16,D,1978
5741,11,26,Bryon Baltimore,5,71,16,D,1978
5742,0,27,Bryon Baltimore,0,2,0,D,1979
5743,0,22,Bubba Berenzweig,0,2,0,D,1999
5744,0,23,Bubba Berenzweig,0,5,0,D,2000
5745,7,24,Bubba Berenzweig,3,26,10,D,2001
5746,0,25,Bubba Berenzweig,0,4,0,D,2002
5747,0,27,Bud Gulka,1,5,1,RW,1974
5748,0,27,Bud Gulka,1,5,1,RW,1974
5749,0,27,Bud Holloway,0,1,0,C,2015
5750,0,22,Bud Stefanski,0,1,0,C,1977
5751,1,24,Buddy Robinson,1,3,2,RW,2015
5752,0,25,Buddy Robinson,0,4,0,RW,2016
5753,2,24,Burke Henry,0,16,2,D,2002
5754,4,25,Burke Henry,2,23,6,D,2003
5755,8,20,Buster Harvey,12,59,20,RW,1970
5756,34,22,Buster Harvey,21,68,55,RW,1972
5757,17,23,Buster Harvey,16,72,33,RW,1973
5758,27,24,Buster Harvey,17,79,44,RW,1974
5759,21,25,Buster Harvey,13,75,34,RW,1975
5760,11,26,Buster Harvey,11,54,22,RW,1976
5761,0,20,Butch Deadmarsh,0,10,0,LW,1970
5762,1,21,Butch Deadmarsh,1,12,2,LW,1971
5763,1,22,Butch Deadmarsh,2,53,3,LW,1972
5764,1,23,Butch Deadmarsh,6,42,7,LW,1973
5765,2,24,Butch Deadmarsh,3,20,5,LW,1974
5766,8,24,Butch Deadmarsh,7,38,15,LW,1974
5767,8,24,Butch Deadmarsh,7,38,15,LW,1974
5768,28,25,Butch Deadmarsh,26,79,54,LW,1975
5769,21,26,Butch Deadmarsh,22,73,43,LW,1976
5770,9,27,Butch Deadmarsh,8,65,17,LW,1977
5771,9,27,Butch Deadmarsh,8,65,17,LW,1977
5772,23,20,Butch Goring,13,59,36,C,1969
5773,5,21,Butch Goring,2,19,7,C,1970
5774,29,22,Butch Goring,21,74,50,C,1971
5775,31,23,Butch Goring,28,67,59,C,1972
5776,33,24,Butch Goring,28,70,61,C,1973
5777,33,25,Butch Goring,27,60,60,C,1974
5778,40,26,Butch Goring,33,80,73,C,1975
5779,55,27,Butch Goring,30,78,85,C,1976
5780,36,28,Butch Goring,37,80,73,C,1977
5781,51,29,Butch Goring,36,80,87,C,1978
5782,53,30,Butch Goring,26,81,79,C,1979
5783,37,31,Butch Goring,23,78,60,C,1980
5784,17,32,Butch Goring,15,67,32,C,1981
5785,20,33,Butch Goring,19,75,39,C,1982
5786,24,34,Butch Goring,22,71,46,C,1983
5787,26,35,Butch Goring,15,68,41,C,1984
5788,10,21,Butch Williams,3,31,13,RW,1973
5789,21,22,Butch Williams,11,63,32,RW,1974
5790,4,23,Butch Williams,0,14,4,RW,1975
5791,10,24,Butch Williams,3,29,13,RW,1976
5792,10,24,Butch Williams,3,29,13,RW,1976
5793,0,22,Buzz Schneider,0,4,0,LW,1976
5794,0,22,Buzz Schneider,0,4,0,LW,1976
5795,3,24,Byron Bitz,4,35,7,RW,2008
5796,6,25,Byron Bitz,5,52,11,RW,2009
5797,3,27,Byron Bitz,1,10,4,RW,2011
5798,3,24,Byron Froese,2,56,5,C,2015
5799,0,25,Byron Froese,0,2,0,C,2016
5800,8,26,Byron Froese,3,48,11,C,2017
5801,0,21,Byron Ritchie,0,3,0,C,1998
5802,2,22,Byron Ritchie,0,26,2,C,1999
5803,6,24,Byron Ritchie,5,35,11,C,2001
5804,3,25,Byron Ritchie,0,30,3,RW,2002
5805,6,26,Byron Ritchie,5,50,11,C,2003
5806,2,28,Byron Ritchie,4,45,6,C,2005
5807,6,29,Byron Ritchie,8,64,14,C,2006
5808,8,30,Byron Ritchie,3,71,11,C,2007
5809,7,23,Byron Shutt,10,65,17,LW,1978
5810,7,23,Byron Shutt,10,65,17,LW,1978
5811,1,22,C.J. Smith,0,2,1,LW,2016
5812,7,25,C.J. Young,7,43,14,C,1992
5813,1,23,Cade Fairchild,0,5,1,D,2011
5814,0,20,Cal Clutterbuck,0,2,0,RW,2007
5815,7,21,Cal Clutterbuck,11,78,18,RW,2008
5816,8,22,Cal Clutterbuck,13,74,21,RW,2009
5817,15,23,Cal Clutterbuck,19,76,34,RW,2010
5818,12,24,Cal Clutterbuck,15,74,27,RW,2011
5819,6,25,Cal Clutterbuck,4,42,10,RW,2012
5820,7,26,Cal Clutterbuck,12,73,19,RW,2013
5821,9,27,Cal Clutterbuck,7,76,16,RW,2014
5822,8,28,Cal Clutterbuck,15,77,23,RW,2015
5823,15,29,Cal Clutterbuck,5,66,20,RW,2016
5824,10,30,Cal Clutterbuck,8,76,18,RW,2017
5825,2,22,Cal O'Reilly,3,11,5,C,2008
5826,9,23,Cal O'Reilly,2,31,11,C,2009
5827,12,24,Cal O'Reilly,6,38,18,C,2010
5828,5,25,Cal O'Reilly,2,33,7,C,2011
5829,4,29,Cal O'Reilly,3,20,7,C,2015
5830,1,30,Cal O'Reilly,0,11,1,C,2016
5831,0,31,Cal O'Reilly,0,1,0,C,2017
5832,2,22,Cal Sandbeck,1,11,3,D,1977
5833,2,22,Cal Sandbeck,1,11,3,D,1977
5834,0,23,Cal Sandbeck,0,6,0,D,1978
5835,0,23,Cal Sandbeck,0,6,0,D,1978
5836,21,24,Cal Swenson,7,77,28,C,1972
5837,21,24,Cal Swenson,7,77,28,C,1972
5838,4,25,Cal Swenson,5,25,9,C,1973
5839,4,25,Cal Swenson,5,25,9,C,1973
5840,0,22,Cale Hulse,0,11,0,D,1995
5841,6,23,Cale Hulse,1,63,7,D,1996
5842,22,24,Cale Hulse,5,79,27,D,1997
5843,9,25,Cale Hulse,3,73,12,D,1998
5844,6,26,Cale Hulse,1,47,7,D,1999
5845,7,27,Cale Hulse,1,82,8,D,2000
5846,2,28,Cale Hulse,0,63,2,D,2001
5847,6,29,Cale Hulse,2,80,8,D,2002
5848,17,30,Cale Hulse,3,82,20,D,2003
5849,4,32,Cale Hulse,0,39,4,D,2005
5850,7,22,Calle Jarnkrok,2,12,9,C,2013
5851,11,23,Calle Jarnkrok,7,74,18,C,2014
5852,14,24,Calle Jarnkrok,16,81,30,C,2015
5853,16,25,Calle Jarnkrok,15,81,31,C,2016
5854,19,26,Calle Jarnkrok,16,68,35,C,2017
5855,38,20,Calle Johansson,4,71,42,D,1987
5856,18,21,Calle Johansson,3,59,21,D,1988
5857,31,22,Calle Johansson,8,70,39,D,1989
5858,41,23,Calle Johansson,11,80,52,D,1990
5859,42,24,Calle Johansson,14,80,56,D,1991
5860,38,25,Calle Johansson,7,77,45,D,1992
5861,33,26,Calle Johansson,9,84,42,D,1993
5862,26,27,Calle Johansson,5,46,31,D,1994
5863,25,28,Calle Johansson,10,78,35,D,1995
5864,11,29,Calle Johansson,6,65,17,D,1996
5865,20,30,Calle Johansson,15,73,35,D,1997
5866,21,31,Calle Johansson,8,67,29,D,1998
5867,25,32,Calle Johansson,7,82,32,D,1999
5868,29,33,Calle Johansson,7,76,36,D,2000
5869,0,34,Calle Johansson,2,11,2,D,2001
5870,12,35,Calle Johansson,3,82,15,D,2002
5871,6,36,Calle Johansson,0,8,6,D,2003
5872,1,23,Calle Rosen,0,4,1,D,2017
5873,0,20,Calvin de Haan,0,1,0,D,2011
5874,13,22,Calvin de Haan,3,51,16,D,2013
5875,11,23,Calvin de Haan,1,65,12,D,2014
5876,14,24,Calvin de Haan,2,72,16,D,2015
5877,20,25,Calvin de Haan,5,82,25,D,2016
5878,11,26,Calvin de Haan,1,33,12,D,2017
5879,7,22,Cam Atkinson,7,27,14,RW,2011
5880,9,23,Cam Atkinson,9,35,18,RW,2012
5881,19,24,Cam Atkinson,21,79,40,RW,2013
5882,18,25,Cam Atkinson,22,78,40,RW,2014
5883,26,26,Cam Atkinson,27,81,53,RW,2015
5884,27,27,Cam Atkinson,35,82,62,RW,2016
5885,22,28,Cam Atkinson,24,65,46,RW,2017
5886,0,19,Cam Barker,0,1,0,D,2005
5887,7,20,Cam Barker,1,35,8,D,2006
5888,12,21,Cam Barker,6,45,18,D,2007
5889,34,22,Cam Barker,6,68,40,D,2008
5890,16,23,Cam Barker,5,70,21,D,2009
5891,4,24,Cam Barker,1,52,5,D,2010
5892,0,25,Cam Barker,2,25,2,D,2011
5893,2,26,Cam Barker,0,14,2,D,2012
5894,1,21,Cam Botting,0,2,1,RW,1975
5895,0,21,Cam Brown,0,1,0,LW,1990
5896,19,20,Cam Connor,9,57,28,RW,1974
5897,19,20,Cam Connor,9,57,28,RW,1974
5898,21,21,Cam Connor,18,73,39,LW,1975
5899,21,21,Cam Connor,18,73,39,LW,1975
5900,32,22,Cam Connor,35,76,67,LW,1976
5901,32,22,Cam Connor,35,76,67,LW,1976
5902,16,23,Cam Connor,21,68,37,LW,1977
5903,16,23,Cam Connor,21,68,37,LW,1977
5904,3,24,Cam Connor,1,23,4,C,1978
5905,16,25,Cam Connor,7,50,23,RW,1979
5906,3,26,Cam Connor,1,15,4,RW,1980
5907,0,28,Cam Connor,0,1,0,RW,1982
5908,30,19,Cam Fowler,10,76,40,D,2010
5909,24,20,Cam Fowler,5,82,29,D,2011
5910,10,21,Cam Fowler,1,37,11,D,2012
5911,30,22,Cam Fowler,6,70,36,D,2013
5912,27,23,Cam Fowler,7,80,34,D,2014
5913,23,24,Cam Fowler,5,69,28,D,2015
5914,28,25,Cam Fowler,11,80,39,D,2016
5915,24,26,Cam Fowler,8,67,32,D,2017
5916,0,21,Cam Janssen,0,47,0,RW,2005
5917,0,22,Cam Janssen,1,48,1,RW,2006
5918,1,23,Cam Janssen,0,12,1,RW,2007
5919,3,24,Cam Janssen,1,56,4,RW,2008
5920,0,25,Cam Janssen,0,43,0,RW,2009
5921,3,26,Cam Janssen,1,54,4,RW,2010
5922,1,27,Cam Janssen,0,48,1,RW,2011
5923,0,28,Cam Janssen,0,4,0,RW,2012
5924,0,29,Cam Janssen,3,24,3,RW,2013
5925,15,18,Cam Neely,16,56,31,RW,1983
5926,18,19,Cam Neely,21,72,39,RW,1984
5927,20,20,Cam Neely,14,73,34,RW,1985
5928,36,21,Cam Neely,36,75,72,RW,1986
5929,27,22,Cam Neely,42,69,69,RW,1987
5930,38,23,Cam Neely,37,74,75,RW,1988
5931,37,24,Cam Neely,55,76,92,RW,1989
5932,40,25,Cam Neely,51,69,91,RW,1990
5933,3,26,Cam Neely,9,9,12,RW,1991
5934,7,27,Cam Neely,11,13,18,RW,1992
5935,24,28,Cam Neely,50,49,74,RW,1993
5936,14,29,Cam Neely,27,42,41,RW,1994
5937,20,30,Cam Neely,26,49,46,RW,1995
5938,1,25,Cam Paddock,2,16,3,C,2008
5939,0,20,Cam Plante,0,2,0,D,1984
5940,1,21,Cam Russell,0,19,1,D,1989
5941,0,22,Cam Russell,0,3,0,D,1990
5942,0,23,Cam Russell,0,19,0,D,1991
5943,4,24,Cam Russell,2,67,6,D,1992
5944,7,25,Cam Russell,1,67,8,D,1993
5945,3,26,Cam Russell,1,33,4,D,1994
5946,2,27,Cam Russell,2,61,4,D,1995
5947,1,28,Cam Russell,1,44,2,D,1996
5948,1,29,Cam Russell,1,41,2,D,1997
5949,2,30,Cam Russell,1,42,3,D,1998
5950,0,25,Cam Severson,0,2,0,LW,2002
5951,0,26,Cam Severson,3,31,3,LW,2003
5952,0,28,Cam Severson,0,4,0,LW,2005
5953,6,22,Cam Stewart,3,57,9,LW,1993
5954,0,23,Cam Stewart,0,5,0,C,1994
5955,0,24,Cam Stewart,0,6,0,C,1995
5956,1,25,Cam Stewart,0,15,1,LW,1996
5957,7,28,Cam Stewart,9,65,16,LW,1999
5958,9,29,Cam Stewart,4,54,13,LW,2000
5959,0,20,Cameron Gaunce,1,11,1,D,2010
5960,0,23,Cameron Gaunce,0,9,0,D,2013
5961,3,26,Cameron Gaunce,1,12,4,D,2016
5962,1,20,Cameron Mann,0,9,1,RW,1997
5963,2,21,Cameron Mann,5,33,7,RW,1998
5964,4,22,Cameron Mann,8,32,12,RW,1999
5965,3,23,Cameron Mann,1,15,4,RW,2000
5966,0,25,Cameron Mann,0,4,0,RW,2002
5967,0,24,Cameron Schilling,0,1,0,D,2012
5968,0,25,Cameron Schilling,0,1,0,D,2013
5969,0,26,Cameron Schilling,0,4,0,D,2014
5970,12,35,Camille Henry,8,36,20,C,1967
5971,22,36,Camille Henry,17,64,39,C,1968
5972,2,37,Camille Henry,1,4,3,C,1969
5973,9,21,Camille Lapierre,5,24,14,D,1972
5974,9,21,Camille Lapierre,5,24,14,D,1972
5975,3,22,Camille Lapierre,0,9,3,D,1973
5976,3,22,Camille Lapierre,0,9,3,D,1973
5977,5,21,Carey Wilson,2,15,7,C,1983
5978,48,22,Carey Wilson,24,74,72,C,1984
5979,29,23,Carey Wilson,29,76,58,C,1985
5980,36,24,Carey Wilson,20,80,56,C,1986
5981,41,25,Carey Wilson,27,70,68,C,1987
5982,45,26,Carey Wilson,32,75,77,C,1988
5983,17,27,Carey Wilson,9,41,26,C,1989
5984,18,28,Carey Wilson,11,57,29,C,1990
5985,12,29,Carey Wilson,11,42,23,C,1991
5986,7,30,Carey Wilson,4,22,11,C,1992
5987,37,31,Carl Brewer,2,70,39,D,1969
5988,9,32,Carl Brewer,2,19,11,D,1970
5989,16,33,Carl Brewer,2,42,18,D,1971
5990,23,35,Carl Brewer,2,77,25,D,1973
5991,23,35,Carl Brewer,2,77,25,D,1973
5992,5,41,Carl Brewer,0,20,5,D,1979
5993,0,24,Carl Corazzini,2,12,2,C,2003
5994,1,27,Carl Corazzini,0,7,1,C,2006
5995,3,23,Carl Dahlstrom,0,11,3,D,2017
5996,12,23,Carl Gunnarsson,3,43,15,D,2009
5997,16,24,Carl Gunnarsson,4,68,20,D,2010
5998,15,25,Carl Gunnarsson,4,76,19,D,2011
5999,14,26,Carl Gunnarsson,1,37,15,D,2012
6000,14,27,Carl Gunnarsson,3,80,17,D,2013
6001,10,28,Carl Gunnarsson,2,61,12,D,2014
6002,6,29,Carl Gunnarsson,3,72,9,D,2015
6003,6,30,Carl Gunnarsson,0,56,6,D,2016
6004,4,31,Carl Gunnarsson,5,63,9,D,2017
6005,24,23,Carl Hagelin,14,64,38,LW,2011
6006,14,24,Carl Hagelin,10,48,24,LW,2012
6007,16,25,Carl Hagelin,17,72,33,LW,2013
6008,18,26,Carl Hagelin,17,82,35,LW,2014
6009,25,27,Carl Hagelin,14,80,39,LW,2015
6010,16,28,Carl Hagelin,6,61,22,LW,2016
6011,21,29,Carl Hagelin,10,81,31,LW,2017
6012,0,20,Carl Klingberg,0,1,0,LW,2010
6013,0,21,Carl Klingberg,0,6,0,LW,2011
6014,0,23,Carl Klingberg,1,3,1,LW,2013
6015,0,24,Carl Klingberg,0,2,0,LW,2014
6016,1,19,Carl Mokosak,0,1,1,LW,1981
6017,6,20,Carl Mokosak,7,41,13,LW,1982
6018,8,22,Carl Mokosak,4,30,12,LW,1984
6019,0,23,Carl Mokosak,0,1,0,LW,1985
6020,0,24,Carl Mokosak,0,3,0,LW,1986
6021,0,26,Carl Mokosak,0,7,0,LW,1988
6022,1,24,Carl Sneep,0,1,1,D,2011
6023,2,27,Carl Soderberg,0,6,2,C,2012
6024,32,28,Carl Soderberg,16,73,48,C,2013
6025,31,29,Carl Soderberg,13,82,44,C,2014
6026,39,30,Carl Soderberg,12,82,51,C,2015
6027,8,31,Carl Soderberg,6,80,14,C,2016
6028,21,32,Carl Soderberg,16,77,37,C,2017
6029,1,20,Carlo Colaiacovo,0,2,1,D,2002
6030,1,21,Carlo Colaiacovo,0,2,1,D,2003
6031,5,23,Carlo Colaiacovo,2,21,7,D,2005
6032,9,24,Carlo Colaiacovo,8,48,17,D,2006
6033,4,25,Carlo Colaiacovo,2,28,6,D,2007
6034,27,26,Carlo Colaiacovo,3,73,30,D,2008
6035,25,27,Carlo Colaiacovo,7,67,32,D,2009
6036,20,28,Carlo Colaiacovo,6,65,26,D,2010
6037,17,29,Carlo Colaiacovo,2,64,19,D,2011
6038,1,30,Carlo Colaiacovo,0,6,1,D,2012
6039,3,31,Carlo Colaiacovo,1,25,4,D,2013
6040,6,32,Carlo Colaiacovo,2,33,8,D,2014
6041,4,33,Carlo Colaiacovo,1,36,5,D,2015
6042,1,22,Carol Vadnais,1,31,2,D,1967
6043,27,23,Carol Vadnais,15,76,42,D,1968
6044,20,24,Carol Vadnais,24,76,44,D,1969
6045,16,25,Carol Vadnais,10,42,26,D,1970
6046,26,26,Carol Vadnais,18,68,44,D,1971
6047,24,27,Carol Vadnais,7,78,31,D,1972
6048,43,28,Carol Vadnais,16,78,59,D,1973
6049,56,29,Carol Vadnais,18,79,74,D,1974
6050,35,30,Carol Vadnais,22,76,57,D,1975
6051,37,31,Carol Vadnais,11,74,48,D,1976
6052,40,32,Carol Vadnais,6,80,46,D,1977
6053,37,33,Carol Vadnais,8,77,45,D,1978
6054,20,34,Carol Vadnais,3,66,23,D,1979
6055,20,35,Carol Vadnais,3,74,23,D,1980
6056,6,36,Carol Vadnais,5,50,11,D,1981
6057,7,37,Carol Vadnais,2,51,9,D,1982
6058,0,23,Carsen Germyn,0,2,0,C,2005
6059,0,24,Carsen Germyn,0,2,0,C,2006
6060,1,22,Carson McMillan,1,4,2,RW,2010
6061,2,23,Carson McMillan,1,11,3,RW,2011
6062,0,25,Carson McMillan,0,1,0,RW,2013
6063,0,23,Carson Soucy,0,3,0,D,2017
6064,0,20,Carter Ashton,0,15,0,RW,2011
6065,3,22,Carter Ashton,0,32,3,RW,2013
6066,0,23,Carter Ashton,0,7,0,RW,2014
6067,0,23,Carter Bancks,0,2,0,LW,2012
6068,0,23,Carter Camper,1,3,1,C,2011
6069,4,27,Carter Rowney,3,27,7,RW,2016
6070,3,28,Carter Rowney,2,44,5,RW,2017
6071,0,23,Casey Bailey,1,6,1,C,2014
6072,0,25,Casey Bailey,0,7,0,RW,2016
6073,2,22,Casey Borer,1,11,3,D,2007
6074,0,23,Casey Borer,0,3,0,D,2008
6075,0,24,Casey Borer,0,2,0,D,2009
6076,4,20,Casey Cizikas,0,15,4,C,2011
6077,9,21,Casey Cizikas,6,45,15,C,2012
6078,10,22,Casey Cizikas,6,80,16,C,2013
6079,9,23,Casey Cizikas,9,70,18,C,2014
6080,22,24,Casey Cizikas,8,80,30,C,2015
6081,17,25,Casey Cizikas,8,59,25,C,2016
6082,10,26,Casey Cizikas,7,64,17,C,2017
6083,1,24,Casey Hankinson,0,11,1,LW,2000
6084,0,25,Casey Hankinson,0,3,0,LW,2001
6085,0,27,Casey Hankinson,0,4,0,LW,2003
6086,4,19,Casey Mittelstadt,1,6,5,C,2017
6087,4,23,Casey Nelson,0,7,4,D,2015
6088,0,24,Casey Nelson,0,11,0,D,2016
6089,5,25,Casey Nelson,3,37,8,D,2017
6090,3,22,Casey Wellman,1,12,4,C,2009
6091,1,23,Casey Wellman,1,15,2,C,2010
6092,5,24,Casey Wellman,2,14,7,C,2011
6093,1,26,Casey Wellman,2,13,3,C,2013
6094,1,20,Cedric Paquette,0,2,1,C,2013
6095,7,21,Cedric Paquette,12,64,19,C,2014
6096,5,22,Cedric Paquette,6,56,11,C,2015
6097,6,23,Cedric Paquette,4,58,10,C,2016
6098,4,24,Cedric Paquette,5,56,9,C,2017
6099,3,24,Chad Billins,0,10,3,D,2013
6100,10,19,Chad Kilger,7,74,17,C,1995
6101,3,20,Chad Kilger,4,24,7,C,1996
6102,9,21,Chad Kilger,3,32,12,C,1997
6103,12,22,Chad Kilger,15,77,27,C,1998
6104,2,23,Chad Kilger,3,40,5,C,1999
6105,18,24,Chad Kilger,14,77,32,C,2000
6106,15,25,Chad Kilger,8,75,23,RW,2001
6107,7,26,Chad Kilger,9,60,16,RW,2002
6108,3,27,Chad Kilger,3,41,6,LW,2003
6109,11,29,Chad Kilger,17,79,28,C,2005
6110,14,30,Chad Kilger,14,82,28,LW,2006
6111,7,31,Chad Kilger,10,53,17,LW,2007
6112,0,24,Chad Kolarik,0,2,0,RW,2009
6113,1,25,Chad Kolarik,0,4,1,RW,2010
6114,12,23,Chad LaRose,1,49,13,RW,2005
6115,12,24,Chad LaRose,6,80,18,C,2006
6116,12,25,Chad LaRose,11,58,23,LW,2007
6117,12,26,Chad LaRose,19,81,31,LW,2008
6118,17,27,Chad LaRose,11,56,28,RW,2009
6119,15,28,Chad LaRose,16,82,31,RW,2010
6120,13,29,Chad LaRose,19,67,32,RW,2011
6121,2,30,Chad LaRose,2,35,4,RW,2012
6122,0,20,Chad Penney,0,3,0,LW,1993
6123,0,25,Chad Rau,2,9,2,C,2011
6124,0,22,Chad Ruhwedel,0,7,0,D,2012
6125,1,23,Chad Ruhwedel,0,21,1,D,2013
6126,1,24,Chad Ruhwedel,0,4,1,D,2014
6127,0,25,Chad Ruhwedel,0,1,0,D,2015
6128,8,26,Chad Ruhwedel,2,34,10,D,2016
6129,3,27,Chad Ruhwedel,2,44,5,D,2017
6130,0,21,Chad Wiseman,0,4,0,LW,2002
6131,0,22,Chad Wiseman,1,4,1,LW,2003
6132,1,24,Chad Wiseman,0,1,1,LW,2005
6133,0,21,Chandler Stephenson,0,9,0,C,2015
6134,0,22,Chandler Stephenson,0,4,0,C,2016
6135,12,23,Chandler Stephenson,6,67,18,C,2017
6136,4,20,Charles Constantin,2,20,6,LW,1974
6137,4,20,Charles Constantin,2,20,6,LW,1974
6138,7,21,Charles Constantin,8,41,15,LW,1975
6139,7,21,Charles Constantin,8,41,15,LW,1975
6140,19,22,Charles Constantin,14,77,33,LW,1976
6141,19,22,Charles Constantin,14,77,33,LW,1976
6142,5,23,Charles Constantin,4,54,9,LW,1977
6143,5,23,Charles Constantin,4,54,9,LW,1977
6144,2,21,Charles Hudon,0,3,2,LW,2015
6145,2,22,Charles Hudon,0,3,2,LW,2016
6146,20,23,Charles Hudon,10,72,30,LW,2017
6147,0,27,Charles Linglet,0,5,0,LW,2009
6148,13,22,Charlie Bourgeois,2,54,15,D,1981
6149,3,23,Charlie Bourgeois,2,15,5,D,1982
6150,3,24,Charlie Bourgeois,1,17,4,D,1983
6151,10,25,Charlie Bourgeois,2,47,12,D,1984
6152,12,26,Charlie Bourgeois,7,60,19,D,1985
6153,12,27,Charlie Bourgeois,2,66,14,D,1986
6154,1,28,Charlie Bourgeois,0,31,1,D,1987
6155,26,31,Charlie Burns,9,73,35,LW,1967
6156,38,32,Charlie Burns,13,76,51,C,1968
6157,13,33,Charlie Burns,3,50,16,LW,1969
6158,19,34,Charlie Burns,9,76,28,LW,1970
6159,14,35,Charlie Burns,11,77,25,LW,1971
6160,7,36,Charlie Burns,4,65,11,LW,1972
6161,6,20,Charlie Coyle,8,37,14,C,2012
6162,18,21,Charlie Coyle,12,70,30,C,2013
6163,24,22,Charlie Coyle,11,82,35,C,2014
6164,21,23,Charlie Coyle,21,82,42,C,2015
6165,38,24,Charlie Coyle,18,82,56,C,2016
6166,26,25,Charlie Coyle,11,66,37,C,2017
6167,5,21,Charlie Huddy,2,12,7,D,1980
6168,11,22,Charlie Huddy,4,41,15,D,1981
6169,37,23,Charlie Huddy,20,76,57,D,1982
6170,34,24,Charlie Huddy,8,75,42,D,1983
6171,44,25,Charlie Huddy,7,80,51,D,1984
6172,35,26,Charlie Huddy,6,76,41,D,1985
6173,15,27,Charlie Huddy,4,58,19,D,1986
6174,28,28,Charlie Huddy,13,77,41,D,1987
6175,33,29,Charlie Huddy,11,76,44,D,1988
6176,23,30,Charlie Huddy,1,70,24,D,1989
6177,22,31,Charlie Huddy,5,53,27,D,1990
6178,19,32,Charlie Huddy,4,56,23,D,1991
6179,25,33,Charlie Huddy,2,82,27,D,1992
6180,13,34,Charlie Huddy,5,79,18,D,1993
6181,5,35,Charlie Huddy,2,41,7,D,1994
6182,5,36,Charlie Huddy,5,64,10,D,1995
6183,0,37,Charlie Huddy,0,1,0,D,1996
6184,12,24,Charlie Luksa,8,78,20,D,1978
6185,12,24,Charlie Luksa,8,78,20,D,1978
6186,1,25,Charlie Luksa,0,8,1,D,1979
6187,25,20,Charlie McAvoy,7,63,32,D,2017
6188,13,20,Charlie Simmer,8,35,21,LW,1974
6189,1,21,Charlie Simmer,1,21,2,LW,1975
6190,0,22,Charlie Simmer,2,24,2,LW,1976
6191,0,23,Charlie Simmer,0,3,0,LW,1977
6192,27,24,Charlie Simmer,21,38,48,LW,1978
6193,45,25,Charlie Simmer,56,64,101,LW,1979
6194,49,26,Charlie Simmer,56,65,105,LW,1980
6195,24,27,Charlie Simmer,15,50,39,LW,1981
6196,51,28,Charlie Simmer,29,80,80,LW,1982
6197,48,29,Charlie Simmer,44,79,92,LW,1983
6198,30,30,Charlie Simmer,34,68,64,LW,1984
6199,24,31,Charlie Simmer,36,55,60,LW,1985
6200,40,32,Charlie Simmer,29,80,69,LW,1986
6201,17,33,Charlie Simmer,11,50,28,LW,1987
6202,0,21,Charlie Stephens,0,2,0,C,2002
6203,2,22,Charlie Stephens,0,6,2,C,2003
6204,0,25,Chase Balisy,0,8,0,C,2017
6205,0,20,Chase De Leo,0,2,0,C,2015
6206,1,25,Chay Genoway,0,1,1,D,2011
6207,16,28,Chico Maki,8,60,24,RW,1967
6208,21,29,Chico Maki,7,66,28,RW,1968
6209,24,30,Chico Maki,10,75,34,RW,1969
6210,26,31,Chico Maki,22,72,48,RW,1970
6211,34,32,Chico Maki,13,62,47,RW,1971
6212,19,33,Chico Maki,13,77,32,RW,1972
6213,25,34,Chico Maki,9,69,34,RW,1973
6214,6,36,Chico Maki,0,22,6,RW,1975
6215,1,21,Chris Ahrens,0,3,1,D,1973
6216,2,22,Chris Ahrens,0,44,2,D,1974
6217,0,23,Chris Ahrens,0,2,0,D,1975
6218,0,24,Chris Ahrens,0,2,0,D,1976
6219,0,25,Chris Ahrens,0,1,0,D,1977
6220,0,25,Chris Ahrens,0,4,0,D,1977
6221,0,25,Chris Ahrens,0,4,0,D,1977
6222,0,19,Chris Allen,0,1,0,D,1997
6223,0,20,Chris Allen,0,1,0,D,1998
6224,0,25,Chris Armstrong,0,3,0,D,2000
6225,1,28,Chris Armstrong,0,4,1,D,2003
6226,1,23,Chris Bala,0,6,1,LW,2001
6227,2,20,Chris Bigras,1,31,3,D,2015
6228,1,22,Chris Bigras,0,15,1,D,2017
6229,0,22,Chris Bourque,0,4,0,LW,2007
6230,0,23,Chris Bourque,1,8,1,LW,2008
6231,3,24,Chris Bourque,0,21,3,LW,2009
6232,3,27,Chris Bourque,1,18,4,LW,2012
6233,0,21,Chris Brown,0,5,0,C,2012
6234,1,22,Chris Brown,1,12,2,C,2013
6235,0,23,Chris Brown,1,5,1,C,2014
6236,0,24,Chris Brown,0,1,0,C,2015
6237,4,22,Chris Butler,2,47,6,D,2008
6238,20,23,Chris Butler,1,59,21,D,2009
6239,7,24,Chris Butler,2,49,9,D,2010
6240,13,25,Chris Butler,2,68,15,D,2011
6241,7,26,Chris Butler,1,44,8,D,2012
6242,14,27,Chris Butler,2,82,16,D,2013
6243,6,28,Chris Butler,3,33,9,D,2014
6244,0,29,Chris Butler,0,5,0,D,2015
6245,0,30,Chris Butler,0,1,0,D,2016
6246,0,31,Chris Butler,0,6,0,D,2017
6247,25,21,Chris Campoli,9,80,34,D,2005
6248,13,22,Chris Campoli,1,51,14,D,2006
6249,14,23,Chris Campoli,4,46,18,D,2007
6250,19,24,Chris Campoli,11,76,30,D,2008
6251,14,25,Chris Campoli,4,67,18,D,2009
6252,17,26,Chris Campoli,4,77,21,D,2010
6253,9,27,Chris Campoli,2,43,11,D,2011
6254,2,22,Chris Chelios,0,12,2,D,1983
6255,55,23,Chris Chelios,9,74,64,D,1984
6256,26,24,Chris Chelios,8,41,34,D,1985
6257,33,25,Chris Chelios,11,71,44,D,1986
6258,41,26,Chris Chelios,20,71,61,D,1987
6259,58,27,Chris Chelios,15,80,73,D,1988
6260,22,28,Chris Chelios,9,53,31,D,1989
6261,52,29,Chris Chelios,12,77,64,D,1990
6262,47,30,Chris Chelios,9,80,56,D,1991
6263,58,31,Chris Chelios,15,84,73,D,1992
6264,44,32,Chris Chelios,16,76,60,D,1993
6265,33,33,Chris Chelios,5,48,38,D,1994
6266,58,34,Chris Chelios,14,81,72,D,1995
6267,38,35,Chris Chelios,10,72,48,D,1996
6268,39,36,Chris Chelios,3,81,42,D,1997
6269,27,37,Chris Chelios,9,75,36,D,1998
6270,31,38,Chris Chelios,3,81,34,D,1999
6271,3,39,Chris Chelios,0,24,3,D,2000
6272,33,40,Chris Chelios,6,79,39,D,2001
6273,17,41,Chris Chelios,2,66,19,D,2002
6274,19,42,Chris Chelios,2,69,21,D,2003
6275,7,44,Chris Chelios,4,81,11,D,2005
6276,11,45,Chris Chelios,0,71,11,D,2006
6277,9,46,Chris Chelios,3,69,12,D,2007
6278,0,47,Chris Chelios,0,28,0,D,2008
6279,0,48,Chris Chelios,0,7,0,D,2009
6280,11,22,Chris Cichocki,10,59,21,RW,1985
6281,0,23,Chris Cichocki,0,2,0,RW,1986
6282,0,24,Chris Cichocki,1,5,1,RW,1987
6283,1,25,Chris Cichocki,0,2,1,RW,1988
6284,1,23,Chris Clark,0,22,1,RW,1999
6285,1,24,Chris Clark,5,29,6,RW,2000
6286,7,25,Chris Clark,10,64,17,RW,2001
6287,12,26,Chris Clark,10,81,22,RW,2002
6288,15,27,Chris Clark,10,82,25,RW,2003
6289,19,29,Chris Clark,20,78,39,RW,2005
6290,24,30,Chris Clark,30,74,54,RW,2006
6291,4,31,Chris Clark,5,18,9,RW,2007
6292,5,32,Chris Clark,1,32,6,RW,2008
6293,13,33,Chris Clark,7,74,20,RW,2009
6294,10,34,Chris Clark,5,53,15,RW,2010
6295,2,23,Chris Conner,1,11,3,RW,2006
6296,2,24,Chris Conner,3,22,5,RW,2007
6297,10,25,Chris Conner,3,38,13,RW,2008
6298,1,26,Chris Conner,2,8,3,RW,2009
6299,9,27,Chris Conner,7,60,16,RW,2010
6300,2,28,Chris Conner,1,8,3,RW,2011
6301,1,29,Chris Conner,1,12,2,RW,2012
6302,1,30,Chris Conner,4,19,5,RW,2013
6303,0,31,Chris Conner,0,2,0,RW,2014
6304,1,23,Chris Corrinet,0,8,1,RW,2001
6305,2,23,Chris Dahlquist,1,5,3,D,1985
6306,1,24,Chris Dahlquist,0,19,1,D,1986
6307,6,25,Chris Dahlquist,3,44,9,D,1987
6308,5,26,Chris Dahlquist,1,43,6,D,1988
6309,10,27,Chris Dahlquist,4,62,14,D,1989
6310,8,28,Chris Dahlquist,3,64,11,D,1990
6311,13,29,Chris Dahlquist,1,74,14,D,1991
6312,7,30,Chris Dahlquist,3,74,10,D,1992
6313,11,31,Chris Dahlquist,1,77,12,D,1993
6314,7,32,Chris Dahlquist,1,46,8,D,1994
6315,1,33,Chris Dahlquist,1,24,2,D,1995
6316,3,21,Chris Dingman,3,70,6,LW,1997
6317,0,22,Chris Dingman,0,3,0,LW,1998
6318,3,23,Chris Dingman,8,68,11,LW,1999
6319,1,24,Chris Dingman,1,41,2,LW,2000
6320,5,25,Chris Dingman,0,44,5,LW,2001
6321,1,26,Chris Dingman,2,51,3,LW,2002
6322,5,27,Chris Dingman,1,74,6,LW,2003
6323,1,29,Chris Dingman,0,34,1,LW,2005
6324,24,22,Chris Drury,20,79,44,C,1998
6325,47,23,Chris Drury,20,82,67,C,1999
6326,41,24,Chris Drury,24,71,65,LW,2000
6327,25,25,Chris Drury,21,82,46,LW,2001
6328,30,26,Chris Drury,23,80,53,LW,2002
6329,35,27,Chris Drury,18,76,53,C,2003
6330,37,29,Chris Drury,30,81,67,C,2005
6331,32,30,Chris Drury,37,77,69,C,2006
6332,33,31,Chris Drury,25,82,58,C,2007
6333,34,32,Chris Drury,22,81,56,C,2008
6334,18,33,Chris Drury,14,77,32,C,2009
6335,4,34,Chris Drury,1,24,5,C,2010
6336,0,28,Chris Durno,0,2,0,LW,2008
6337,4,29,Chris Durno,4,41,8,LW,2009
6338,0,23,Chris Evans,0,2,0,D,1969
6339,18,25,Chris Evans,6,63,24,LW,1971
6340,12,26,Chris Evans,9,77,21,LW,1972
6341,9,27,Chris Evans,4,77,13,D,1973
6342,3,28,Chris Evans,0,22,3,D,1974
6343,20,29,Chris Evans,3,75,23,D,1975
6344,20,29,Chris Evans,3,75,23,D,1975
6345,27,30,Chris Evans,7,81,34,D,1976
6346,27,30,Chris Evans,7,81,34,D,1976
6347,4,31,Chris Evans,1,48,5,D,1977
6348,4,31,Chris Evans,1,48,5,D,1977
6349,8,24,Chris Felix,0,21,8,D,1988
6350,0,25,Chris Felix,1,6,1,D,1989
6351,4,26,Chris Felix,0,8,4,D,1990
6352,0,23,Chris Ferraro,1,2,1,RW,1995
6353,1,24,Chris Ferraro,1,12,2,RW,1996
6354,4,25,Chris Ferraro,3,46,7,LW,1997
6355,0,26,Chris Ferraro,1,2,1,RW,1998
6356,3,27,Chris Ferraro,1,11,4,C,1999
6357,1,29,Chris Ferraro,0,1,1,C,2001
6358,1,19,Chris Govedaris,0,12,1,LW,1989
6359,3,20,Chris Govedaris,1,14,4,LW,1990
6360,0,22,Chris Govedaris,1,7,1,LW,1992
6361,2,23,Chris Govedaris,2,12,4,LW,1993
6362,29,18,Chris Gratton,13,84,42,C,1993
6363,20,19,Chris Gratton,7,46,27,C,1994
6364,21,20,Chris Gratton,17,82,38,C,1995
6365,32,21,Chris Gratton,30,82,62,C,1996
6366,40,22,Chris Gratton,22,82,62,C,1997
6367,26,23,Chris Gratton,8,78,34,C,1998
6368,34,24,Chris Gratton,15,72,49,C,1999
6369,21,25,Chris Gratton,19,82,40,C,2000
6370,24,26,Chris Gratton,15,82,39,C,2001
6371,30,27,Chris Gratton,15,80,45,C,2002
6372,19,28,Chris Gratton,13,81,32,C,2003
6373,22,30,Chris Gratton,17,76,39,C,2005
6374,22,31,Chris Gratton,13,81,35,C,2006
6375,11,32,Chris Gratton,10,60,21,C,2007
6376,3,33,Chris Gratton,0,24,3,C,2008
6377,0,22,Chris Hajt,0,1,0,D,2000
6378,0,25,Chris Hajt,0,5,0,D,2003
6379,0,25,Chris Herperger,0,9,0,C,1999
6380,15,26,Chris Herperger,10,61,25,LW,2000
6381,9,27,Chris Herperger,4,72,13,C,2001
6382,1,28,Chris Herperger,4,27,5,C,2002
6383,0,20,Chris Higgins,0,2,0,C,2003
6384,15,22,Chris Higgins,23,80,38,C,2005
6385,16,23,Chris Higgins,22,61,38,C,2006
6386,25,24,Chris Higgins,27,82,52,LW,2007
6387,11,25,Chris Higgins,12,57,23,LW,2008
6388,9,26,Chris Higgins,8,67,17,C,2009
6389,15,27,Chris Higgins,13,62,28,C,2010
6390,25,28,Chris Higgins,18,71,43,C,2011
6391,5,29,Chris Higgins,10,41,15,C,2012
6392,22,30,Chris Higgins,17,78,39,LW,2013
6393,24,31,Chris Higgins,12,77,36,LW,2014
6394,1,32,Chris Higgins,3,33,4,LW,2015
6395,3,22,Chris Jensen,1,9,4,C,1985
6396,7,23,Chris Jensen,6,37,13,C,1986
6397,1,24,Chris Jensen,0,7,1,C,1987
6398,0,26,Chris Jensen,0,1,0,RW,1989
6399,1,27,Chris Jensen,2,18,3,RW,1990
6400,0,28,Chris Jensen,0,2,0,RW,1991
6401,8,18,Chris Joseph,0,24,8,D,1987
6402,5,19,Chris Joseph,4,44,9,D,1988
6403,2,20,Chris Joseph,0,4,2,D,1989
6404,17,21,Chris Joseph,5,49,22,D,1990
6405,0,22,Chris Joseph,0,7,0,D,1991
6406,10,23,Chris Joseph,2,33,12,D,1992
6407,20,24,Chris Joseph,11,76,31,D,1993
6408,10,25,Chris Joseph,5,33,15,D,1994
6409,14,26,Chris Joseph,5,70,19,D,1995
6410,13,27,Chris Joseph,3,63,16,D,1996
6411,0,28,Chris Joseph,1,15,1,D,1997
6412,0,29,Chris Joseph,0,2,0,D,1998
6413,9,30,Chris Joseph,2,47,11,D,1999
6414,4,31,Chris Joseph,1,43,5,D,2000
6415,0,26,Chris Kelleher,0,1,0,D,2001
6416,0,23,Chris Kelly,0,4,0,C,2003
6417,20,25,Chris Kelly,10,82,30,C,2005
6418,23,26,Chris Kelly,15,82,38,C,2006
6419,19,27,Chris Kelly,11,75,30,C,2007
6420,11,28,Chris Kelly,12,82,23,C,2008
6421,17,29,Chris Kelly,15,81,32,C,2009
6422,14,30,Chris Kelly,14,81,28,C,2010
6423,19,31,Chris Kelly,20,82,39,C,2011
6424,6,32,Chris Kelly,3,34,9,C,2012
6425,9,33,Chris Kelly,9,57,18,C,2013
6426,21,34,Chris Kelly,7,80,28,C,2014
6427,0,35,Chris Kelly,2,11,2,C,2015
6428,7,36,Chris Kelly,5,82,12,C,2016
6429,2,37,Chris Kelly,0,12,2,C,2017
6430,2,24,Chris Kenady,0,5,2,RW,1997
6431,0,26,Chris Kenady,0,2,0,RW,1999
6432,7,19,Chris Kontos,8,44,15,C,1982
6433,1,20,Chris Kontos,0,6,1,C,1983
6434,8,21,Chris Kontos,4,28,12,LW,1984
6435,9,23,Chris Kontos,8,31,17,LW,1986
6436,17,24,Chris Kontos,3,42,20,C,1987
6437,1,25,Chris Kontos,2,7,3,LW,1988
6438,2,26,Chris Kontos,2,6,4,LW,1989
6439,24,29,Chris Kontos,27,66,51,RW,1992
6440,12,22,Chris Kotsopoulos,4,54,16,D,1980
6441,20,23,Chris Kotsopoulos,13,68,33,D,1981
6442,24,24,Chris Kotsopoulos,6,68,30,D,1982
6443,13,25,Chris Kotsopoulos,5,72,18,D,1983
6444,3,26,Chris Kotsopoulos,5,33,8,D,1984
6445,11,27,Chris Kotsopoulos,6,61,17,D,1985
6446,10,28,Chris Kotsopoulos,2,43,12,D,1986
6447,2,29,Chris Kotsopoulos,2,21,4,D,1987
6448,14,30,Chris Kotsopoulos,1,57,15,D,1988
6449,0,31,Chris Kotsopoulos,0,2,0,D,1989
6450,1,21,Chris Kreider,2,23,3,C,2012
6451,20,22,Chris Kreider,17,66,37,LW,2013
6452,25,23,Chris Kreider,21,80,46,LW,2014
6453,22,24,Chris Kreider,21,79,43,LW,2015
6454,25,25,Chris Kreider,28,75,53,LW,2016
6455,21,26,Chris Kreider,16,58,37,LW,2017
6456,6,24,Chris Kunitz,0,21,6,LW,2003
6457,22,26,Chris Kunitz,19,69,41,LW,2005
6458,35,27,Chris Kunitz,25,81,60,LW,2006
6459,29,28,Chris Kunitz,21,82,50,LW,2007
6460,30,29,Chris Kunitz,23,82,53,LW,2008
6461,19,30,Chris Kunitz,13,50,32,LW,2009
6462,25,31,Chris Kunitz,23,66,48,LW,2010
6463,35,32,Chris Kunitz,26,82,61,LW,2011
6464,30,33,Chris Kunitz,22,48,52,LW,2012
6465,33,34,Chris Kunitz,35,78,68,LW,2013
6466,23,35,Chris Kunitz,17,74,40,LW,2014
6467,23,36,Chris Kunitz,17,80,40,LW,2015
6468,20,37,Chris Kunitz,9,71,29,LW,2016
6469,16,38,Chris Kunitz,13,82,29,LW,2017
6470,0,24,Chris Langevin,1,6,1,LW,1983
6471,1,26,Chris Langevin,2,16,3,LW,1985
6472,5,24,Chris Lindberg,2,17,7,LW,1991
6473,12,25,Chris Lindberg,9,62,21,C,1992
6474,8,26,Chris Lindberg,6,37,14,LW,1993
6475,5,21,Chris Lipuma,0,15,5,D,1992
6476,4,22,Chris Lipuma,0,27,4,D,1993
6477,0,23,Chris Lipuma,0,1,0,D,1994
6478,0,24,Chris Lipuma,0,21,0,D,1995
6479,0,25,Chris Lipuma,0,8,0,D,1996
6480,1,23,Chris Luongo,0,4,1,D,1990
6481,9,25,Chris Luongo,3,76,12,D,1992
6482,3,26,Chris Luongo,1,17,4,D,1993
6483,3,27,Chris Luongo,1,47,4,D,1994
6484,7,28,Chris Luongo,3,74,10,D,1995
6485,4,23,Chris Marinucci,1,12,5,C,1994
6486,0,25,Chris Marinucci,0,1,0,C,1996
6487,2,22,Chris McAllister,1,36,3,D,1997
6488,3,23,Chris McAllister,1,48,4,D,1998
6489,3,24,Chris McAllister,0,36,3,D,1999
6490,2,25,Chris McAllister,2,60,4,D,2000
6491,5,26,Chris McAllister,0,42,5,D,2001
6492,1,27,Chris McAllister,0,33,1,D,2002
6493,1,28,Chris McAllister,0,46,1,LW,2003
6494,3,23,Chris McAlpine,0,24,3,D,1994
6495,0,25,Chris McAlpine,0,15,0,D,1996
6496,7,26,Chris McAlpine,3,54,10,D,1997
6497,1,27,Chris McAlpine,1,51,2,D,1998
6498,2,28,Chris McAlpine,2,34,4,D,1999
6499,6,29,Chris McAlpine,0,50,6,D,2000
6500,3,30,Chris McAlpine,0,40,3,D,2001
6501,2,31,Chris McAlpine,0,21,2,D,2002
6502,0,22,Chris McRae,0,11,0,LW,1987
6503,0,23,Chris McRae,0,3,0,LW,1988
6504,0,24,Chris McRae,1,7,1,LW,1989
6505,6,20,Chris Meloff,1,28,7,D,1972
6506,6,20,Chris Meloff,1,28,7,D,1972
6507,1,26,Chris Minard,1,15,2,LW,2007
6508,2,27,Chris Minard,1,20,3,LW,2008
6509,1,28,Chris Minard,0,5,1,LW,2009
6510,3,24,Chris Mueller,0,15,3,C,2010
6511,0,25,Chris Mueller,0,4,0,C,2011
6512,3,26,Chris Mueller,2,18,5,C,2012
6513,0,27,Chris Mueller,0,9,0,C,2013
6514,1,28,Chris Mueller,1,7,2,C,2014
6515,0,20,Chris Murray,0,3,0,RW,1994
6516,4,21,Chris Murray,3,48,7,RW,1995
6517,3,22,Chris Murray,5,64,8,RW,1996
6518,4,23,Chris Murray,5,53,9,RW,1997
6519,6,24,Chris Murray,1,42,7,RW,1998
6520,1,25,Chris Murray,2,32,3,RW,1999
6521,7,22,Chris Neil,10,72,17,RW,2001
6522,4,23,Chris Neil,6,68,10,RW,2002
6523,8,24,Chris Neil,8,82,16,RW,2003
6524,17,26,Chris Neil,16,79,33,RW,2005
6525,16,27,Chris Neil,12,82,28,RW,2006
6526,14,28,Chris Neil,6,68,20,RW,2007
6527,7,29,Chris Neil,3,60,10,RW,2008
6528,12,30,Chris Neil,10,68,22,RW,2009
6529,10,31,Chris Neil,6,80,16,RW,2010
6530,15,32,Chris Neil,13,72,28,RW,2011
6531,8,33,Chris Neil,4,48,12,RW,2012
6532,6,34,Chris Neil,8,76,14,RW,2013
6533,3,35,Chris Neil,4,38,7,RW,2014
6534,8,36,Chris Neil,5,80,13,RW,2015
6535,3,37,Chris Neil,1,53,4,RW,2016
6536,5,20,Chris Nielsen,4,29,9,LW,2000
6537,3,21,Chris Nielsen,2,23,5,RW,2001
6538,2,21,Chris Nilan,0,15,2,LW,1979
6539,8,22,Chris Nilan,7,57,15,RW,1980
6540,4,23,Chris Nilan,7,49,11,RW,1981
6541,8,24,Chris Nilan,6,66,14,RW,1982
6542,10,25,Chris Nilan,16,76,26,RW,1983
6543,16,26,Chris Nilan,21,77,37,RW,1984
6544,15,27,Chris Nilan,19,72,34,RW,1985
6545,16,28,Chris Nilan,4,44,20,RW,1986
6546,10,29,Chris Nilan,10,72,20,RW,1987
6547,7,30,Chris Nilan,7,38,14,RW,1988
6548,2,31,Chris Nilan,1,25,3,RW,1989
6549,9,32,Chris Nilan,6,41,15,RW,1990
6550,8,33,Chris Nilan,6,56,14,RW,1991
6551,8,22,Chris O'Sullivan,2,27,10,D,1996
6552,2,23,Chris O'Sullivan,0,12,2,D,1997
6553,1,24,Chris O'Sullivan,0,10,1,D,1998
6554,5,25,Chris O'Sullivan,0,11,5,D,1999
6555,1,28,Chris O'Sullivan,0,2,1,D,2002
6556,0,22,Chris Oddleifson,0,6,0,C,1972
6557,16,23,Chris Oddleifson,13,70,29,C,1973
6558,35,24,Chris Oddleifson,16,60,51,C,1974
6559,46,25,Chris Oddleifson,16,80,62,C,1975
6560,26,26,Chris Oddleifson,14,80,40,C,1976
6561,22,27,Chris Oddleifson,17,78,39,C,1977
6562,26,28,Chris Oddleifson,11,67,37,C,1978
6563,20,29,Chris Oddleifson,8,75,28,C,1979
6564,0,30,Chris Oddleifson,0,8,0,C,1980
6565,11,19,Chris Phillips,5,72,16,D,1997
6566,3,20,Chris Phillips,3,34,6,D,1998
6567,14,21,Chris Phillips,5,65,19,D,1999
6568,12,22,Chris Phillips,2,73,14,D,2000
6569,16,23,Chris Phillips,6,63,22,D,2001
6570,16,24,Chris Phillips,3,78,19,D,2002
6571,16,25,Chris Phillips,7,82,23,D,2003
6572,18,27,Chris Phillips,1,69,19,D,2005
6573,18,28,Chris Phillips,8,82,26,D,2006
6574,13,29,Chris Phillips,5,81,18,D,2007
6575,16,30,Chris Phillips,6,82,22,D,2008
6576,16,31,Chris Phillips,8,82,24,D,2009
6577,8,32,Chris Phillips,1,82,9,D,2010
6578,14,33,Chris Phillips,5,80,19,D,2011
6579,9,34,Chris Phillips,5,48,14,D,2012
6580,14,35,Chris Phillips,1,70,15,D,2013
6581,3,36,Chris Phillips,0,36,3,D,2014
6582,1,24,Chris Porter,1,6,2,C,2008
6583,4,26,Chris Porter,3,45,7,C,2010
6584,3,27,Chris Porter,4,47,7,C,2011
6585,6,28,Chris Porter,2,29,8,C,2012
6586,1,29,Chris Porter,0,22,1,LW,2013
6587,1,30,Chris Porter,1,24,2,LW,2014
6588,3,31,Chris Porter,4,61,7,LW,2015
6589,25,19,Chris Pronger,5,81,30,D,1993
6590,9,20,Chris Pronger,5,43,14,D,1994
6591,18,21,Chris Pronger,7,78,25,D,1995
6592,24,22,Chris Pronger,11,79,35,D,1996
6593,27,23,Chris Pronger,9,81,36,D,1997
6594,33,24,Chris Pronger,13,67,46,D,1998
6595,48,25,Chris Pronger,14,79,62,D,1999
6596,39,26,Chris Pronger,8,51,47,D,2000
6597,40,27,Chris Pronger,7,78,47,D,2001
6598,3,28,Chris Pronger,1,5,4,D,2002
6599,40,29,Chris Pronger,14,80,54,D,2003
6600,44,31,Chris Pronger,12,80,56,D,2005
6601,46,32,Chris Pronger,13,66,59,D,2006
6602,31,33,Chris Pronger,12,72,43,D,2007
6603,37,34,Chris Pronger,11,82,48,D,2008
6604,45,35,Chris Pronger,10,82,55,D,2009
6605,21,36,Chris Pronger,4,50,25,D,2010
6606,11,37,Chris Pronger,1,13,12,D,2011
6607,0,24,Chris Pryor,0,4,0,D,1984
6608,1,25,Chris Pryor,0,7,1,D,1985
6609,3,26,Chris Pryor,1,50,4,D,1986
6610,0,27,Chris Pryor,0,4,0,D,1987
6611,0,28,Chris Pryor,0,7,0,D,1988
6612,0,29,Chris Pryor,0,10,0,D,1989
6613,2,26,Chris Schmidt,0,10,2,C,2002
6614,1,21,Chris Simon,1,16,2,LW,1992
6615,4,22,Chris Simon,4,37,8,LW,1993
6616,9,23,Chris Simon,3,29,12,LW,1994
6617,18,24,Chris Simon,16,64,34,LW,1995
6618,13,25,Chris Simon,9,42,22,LW,1996
6619,10,26,Chris Simon,7,28,17,LW,1997
6620,7,27,Chris Simon,3,23,10,LW,1998
6621,20,28,Chris Simon,29,75,49,LW,1999
6622,10,29,Chris Simon,10,60,20,LW,2000
6623,17,30,Chris Simon,14,82,31,LW,2001
6624,8,31,Chris Simon,12,71,20,LW,2002
6625,11,32,Chris Simon,17,78,28,LW,2003
6626,14,34,Chris Simon,8,72,22,LW,2005
6627,17,35,Chris Simon,10,67,27,LW,2006
6628,2,36,Chris Simon,1,38,3,LW,2007
6629,0,22,Chris Snell,0,2,0,D,1993
6630,7,23,Chris Snell,2,32,9,D,1994
6631,8,21,Chris Stewart,11,53,19,RW,2008
6632,36,22,Chris Stewart,28,77,64,RW,2009
6633,25,23,Chris Stewart,28,62,53,RW,2010
6634,15,24,Chris Stewart,15,79,30,RW,2011
6635,18,25,Chris Stewart,18,48,36,RW,2012
6636,11,26,Chris Stewart,15,63,26,RW,2013
6637,22,27,Chris Stewart,14,81,36,RW,2014
6638,12,28,Chris Stewart,8,56,20,RW,2015
6639,8,29,Chris Stewart,13,79,21,RW,2016
6640,2,30,Chris Stewart,1,7,3,RW,2017
6641,0,22,Chris Summers,0,2,0,D,2010
6642,3,23,Chris Summers,0,21,3,D,2011
6643,0,24,Chris Summers,0,6,0,D,2012
6644,1,25,Chris Summers,2,18,3,D,2013
6645,3,26,Chris Summers,0,20,3,D,2014
6646,0,27,Chris Summers,0,3,0,D,2015
6647,0,23,Chris Tamer,0,12,0,D,1993
6648,0,24,Chris Tamer,2,36,2,D,1994
6649,10,25,Chris Tamer,4,70,14,D,1995
6650,4,26,Chris Tamer,2,45,6,D,1996
6651,7,27,Chris Tamer,0,79,7,D,1997
6652,5,28,Chris Tamer,1,63,6,D,1998
6653,8,29,Chris Tamer,2,69,10,D,1999
6654,13,30,Chris Tamer,4,82,17,D,2000
6655,3,31,Chris Tamer,3,78,6,D,2001
6656,9,32,Chris Tamer,1,72,10,D,2002
6657,5,33,Chris Tamer,2,38,7,D,2003
6658,1,22,Chris Tancill,1,9,2,C,1990
6659,0,23,Chris Tancill,0,11,0,C,1991
6660,0,24,Chris Tancill,1,4,1,C,1992
6661,3,25,Chris Tancill,1,12,4,C,1993
6662,11,26,Chris Tancill,3,26,14,LW,1994
6663,16,27,Chris Tancill,7,45,23,LW,1995
6664,0,28,Chris Tancill,4,25,4,LW,1996
6665,1,29,Chris Tancill,0,2,1,RW,1997
6666,1,21,Chris Tanev,0,29,1,D,2010
6667,2,22,Chris Tanev,0,25,2,D,2011
6668,5,23,Chris Tanev,2,38,7,D,2012
6669,11,24,Chris Tanev,6,64,17,D,2013
6670,14,26,Chris Tanev,4,69,18,D,2015
6671,8,27,Chris Tanev,2,53,10,D,2016
6672,9,28,Chris Tanev,2,42,11,D,2017
6673,3,22,Chris Taylor,0,10,3,C,1994
6674,1,23,Chris Taylor,0,11,1,C,1995
6675,0,24,Chris Taylor,0,1,0,C,1996
6676,5,26,Chris Taylor,3,37,8,C,1998
6677,1,27,Chris Taylor,1,11,2,C,1999
6678,2,28,Chris Taylor,0,14,2,C,2000
6679,3,30,Chris Taylor,1,11,4,C,2002
6680,6,31,Chris Taylor,6,54,12,C,2003
6681,0,23,Chris Terry,1,3,1,LW,2012
6682,2,24,Chris Terry,0,10,2,LW,2013
6683,9,25,Chris Terry,11,57,20,LW,2014
6684,3,26,Chris Terry,8,68,11,LW,2015
6685,2,27,Chris Terry,2,14,4,LW,2016
6686,10,23,Chris Therien,3,48,13,D,1994
6687,17,24,Chris Therien,6,82,23,D,1995
6688,22,25,Chris Therien,2,71,24,D,1996
6689,16,26,Chris Therien,3,78,19,D,1997
6690,15,27,Chris Therien,3,74,18,D,1998
6691,9,28,Chris Therien,4,80,13,D,1999
6692,12,29,Chris Therien,2,73,14,D,2000
6693,10,30,Chris Therien,4,77,14,D,2001
6694,6,31,Chris Therien,1,67,7,D,2002
6695,9,32,Chris Therien,1,67,10,D,2003
6696,4,34,Chris Therien,0,47,4,D,2005
6697,1,22,Chris Thorburn,0,2,1,C,2005
6698,2,23,Chris Thorburn,3,39,5,C,2006
6699,13,24,Chris Thorburn,5,73,18,RW,2007
6700,8,25,Chris Thorburn,7,82,15,RW,2008
6701,9,26,Chris Thorburn,4,76,13,C,2009
6702,10,27,Chris Thorburn,9,82,19,C,2010
6703,7,28,Chris Thorburn,4,72,11,C,2011
6704,2,29,Chris Thorburn,2,42,4,C,2012
6705,9,30,Chris Thorburn,2,55,11,RW,2013
6706,7,31,Chris Thorburn,7,81,14,RW,2014
6707,6,32,Chris Thorburn,6,82,12,RW,2015
6708,1,33,Chris Thorburn,3,64,4,RW,2016
6709,6,34,Chris Thorburn,1,50,7,RW,2017
6710,15,20,Chris Tierney,6,43,21,C,2014
6711,13,21,Chris Tierney,7,79,20,C,2015
6712,12,22,Chris Tierney,11,80,23,C,2016
6713,23,23,Chris Tierney,17,82,40,C,2017
6714,37,20,Chris Valentine,30,60,67,C,1981
6715,10,21,Chris Valentine,7,23,17,C,1982
6716,5,22,Chris Valentine,6,22,11,C,1983
6717,2,23,Chris VandeVelde,0,12,2,C,2010
6718,0,24,Chris VandeVelde,1,5,1,C,2011
6719,0,25,Chris VandeVelde,0,11,0,C,2012
6720,1,26,Chris VandeVelde,0,18,1,C,2013
6721,6,27,Chris VandeVelde,9,72,15,C,2014
6722,12,28,Chris VandeVelde,2,79,14,C,2015
6723,9,29,Chris VandeVelde,6,81,15,C,2016
6724,0,23,Chris Wagner,0,9,0,RW,2014
6725,2,24,Chris Wagner,4,43,6,RW,2015
6726,1,25,Chris Wagner,6,43,7,C,2016
6727,0,26,Chris Wagner,1,15,1,RW,2017
6728,2,20,Chris Wells,2,54,4,C,1995
6729,6,21,Chris Wells,2,47,8,C,1996
6730,10,22,Chris Wells,5,61,15,LW,1997
6731,2,23,Chris Wells,0,20,2,C,1998
6732,0,24,Chris Wells,0,13,0,C,1999
6733,7,26,Chris Wideman,6,64,13,D,2015
6734,12,27,Chris Wideman,5,76,17,D,2016
6735,5,28,Chris Wideman,3,16,8,D,2017
6736,3,23,Chris Winnes,1,24,4,RW,1991
6737,1,24,Chris Winnes,0,5,1,RW,1992
6738,2,25,Chris Winnes,0,4,2,RW,1993
6739,0,23,Christer Kellgren,0,5,0,RW,1981
6740,8,25,Christer Olsson,2,26,10,D,1995
6741,4,26,Christer Olsson,2,30,6,D,1996
6742,0,22,Christian Backman,0,4,0,D,2002
6743,13,23,Christian Backman,5,66,18,D,2003
6744,12,25,Christian Backman,6,52,18,D,2005
6745,11,26,Christian Backman,7,61,18,D,2006
6746,15,27,Christian Backman,3,63,18,D,2007
6747,5,28,Christian Backman,2,56,7,D,2008
6748,7,21,Christian Berglund,2,15,9,LW,2001
6749,5,22,Christian Berglund,4,38,9,LW,2002
6750,4,23,Christian Berglund,5,33,9,RW,2003
6751,3,21,Christian Bordeleau,1,13,4,C,1968
6752,13,22,Christian Bordeleau,2,48,15,LW,1969
6753,32,23,Christian Bordeleau,21,78,53,LW,1970
6754,17,24,Christian Bordeleau,14,66,31,LW,1971
6755,54,25,Christian Bordeleau,47,78,101,LW,1972
6756,54,25,Christian Bordeleau,47,78,101,LW,1972
6757,49,26,Christian Bordeleau,26,75,75,C,1973
6758,49,26,Christian Bordeleau,26,75,75,C,1973
6759,41,27,Christian Bordeleau,23,71,64,C,1974
6760,72,28,Christian Bordeleau,37,74,109,C,1975
6761,75,29,Christian Bordeleau,32,72,107,C,1976
6762,75,29,Christian Bordeleau,32,72,107,C,1976
6763,22,30,Christian Bordeleau,9,26,31,C,1977
6764,22,30,Christian Bordeleau,9,26,31,C,1977
6765,12,31,Christian Bordeleau,5,16,17,LW,1978
6766,12,31,Christian Bordeleau,5,16,17,LW,1978
6767,11,23,Christian Djoos,3,63,14,D,2017
6768,1,19,Christian Dube,1,27,2,C,1996
6769,0,21,Christian Dube,0,6,0,C,1998
6770,18,20,Christian Dvorak,15,78,33,LW,2016
6771,22,21,Christian Dvorak,15,78,37,C,2017
6772,11,21,Christian Ehrhoff,1,41,12,D,2003
6773,18,23,Christian Ehrhoff,5,64,23,D,2005
6774,23,24,Christian Ehrhoff,10,82,33,D,2006
6775,21,25,Christian Ehrhoff,1,77,22,D,2007
6776,34,26,Christian Ehrhoff,8,77,42,D,2008
6777,30,27,Christian Ehrhoff,14,80,44,D,2009
6778,36,28,Christian Ehrhoff,14,79,50,D,2010
6779,27,29,Christian Ehrhoff,5,66,32,D,2011
6780,17,30,Christian Ehrhoff,5,47,22,D,2012
6781,27,31,Christian Ehrhoff,6,79,33,D,2013
6782,11,32,Christian Ehrhoff,3,49,14,D,2014
6783,10,33,Christian Ehrhoff,2,48,12,D,2015
6784,0,19,Christian Fischer,3,7,3,RW,2016
6785,18,20,Christian Fischer,15,79,33,RW,2017
6786,1,22,Christian Folin,0,1,1,D,2013
6787,8,23,Christian Folin,2,40,10,D,2014
6788,4,24,Christian Folin,0,26,4,D,2015
6789,6,25,Christian Folin,2,51,8,D,2016
6790,10,26,Christian Folin,3,65,13,D,2017
6791,1,22,Christian Hanson,1,5,2,C,2008
6792,5,23,Christian Hanson,2,31,7,RW,2009
6793,0,24,Christian Hanson,0,6,0,RW,2010
6794,0,21,Christian Jaros,0,2,0,D,2017
6795,1,20,Christian Laflamme,0,4,1,D,1996
6796,11,21,Christian Laflamme,0,72,11,D,1997
6797,12,22,Christian Laflamme,2,73,14,D,1998
6798,7,23,Christian Laflamme,0,65,7,D,1999
6799,3,24,Christian Laflamme,0,39,3,D,2000
6800,1,25,Christian Laflamme,0,8,1,D,2001
6801,9,26,Christian Laflamme,0,47,9,D,2002
6802,1,27,Christian Laflamme,0,16,1,D,2003
6803,1,22,Christian Matte,1,5,2,RW,1996
6804,0,23,Christian Matte,0,5,0,RW,1997
6805,1,24,Christian Matte,1,7,2,RW,1998
6806,1,25,Christian Matte,0,5,1,RW,1999
6807,0,26,Christian Matte,0,3,0,RW,2000
6808,2,20,Christian Proulx,1,7,3,D,1993
6809,43,22,Christian Ruuttu,22,76,65,C,1986
6810,45,23,Christian Ruuttu,26,73,71,C,1987
6811,46,24,Christian Ruuttu,14,67,60,C,1988
6812,41,25,Christian Ruuttu,19,75,60,C,1989
6813,34,26,Christian Ruuttu,16,77,50,C,1990
6814,21,27,Christian Ruuttu,4,70,25,C,1991
6815,37,28,Christian Ruuttu,17,84,54,C,1992
6816,20,29,Christian Ruuttu,9,54,29,C,1993
6817,11,30,Christian Ruuttu,7,45,18,LW,1994
6818,0,19,Christian Tanguay,0,2,0,RW,1981
6819,0,20,Christian Thomas,0,1,0,RW,2012
6820,0,21,Christian Thomas,0,2,0,LW,2013
6821,0,22,Christian Thomas,1,18,1,LW,2014
6822,2,23,Christian Thomas,0,6,2,LW,2015
6823,2,22,Christian Wolanin,1,10,3,D,2017
6824,0,20,Christoph Bertschy,0,3,0,C,2015
6825,1,22,Christoph Bertschy,0,5,1,C,2016
6826,0,23,Christoph Bertschy,0,1,0,C,2017
6827,5,28,Christoph Brandner,4,35,9,RW,2003
6828,6,23,Christoph Schubert,4,56,10,D,2005
6829,17,24,Christoph Schubert,8,80,25,D,2006
6830,16,25,Christoph Schubert,8,82,24,D,2007
6831,3,26,Christoph Schubert,3,50,6,LW,2008
6832,5,27,Christoph Schubert,2,47,7,D,2009
6833,2,24,Christopher Breen,0,9,2,D,2013
6834,0,27,Christopher Didomenico,0,3,0,RW,2016
6835,4,28,Christopher Didomenico,6,24,10,LW,2017
6836,18,25,Christopher Tanev,2,70,20,D,2014
6837,0,20,Chuck Arnason,3,17,3,RW,1971
6838,1,21,Chuck Arnason,1,19,2,RW,1972
6839,11,22,Chuck Arnason,20,74,31,RW,1973
6840,32,23,Chuck Arnason,26,78,58,RW,1974
6841,13,24,Chuck Arnason,21,69,34,RW,1975
6842,10,25,Chuck Arnason,13,61,23,RW,1976
6843,21,26,Chuck Arnason,25,69,46,RW,1977
6844,2,27,Chuck Arnason,0,14,2,RW,1978
6845,2,34,Chuck Hamilton,0,3,2,LW,1972
6846,2,20,Chuck Kobasew,4,23,6,RW,2002
6847,11,21,Chuck Kobasew,6,70,17,RW,2003
6848,11,23,Chuck Kobasew,20,77,31,RW,2005
6849,14,24,Chuck Kobasew,5,50,19,RW,2006
6850,17,25,Chuck Kobasew,22,73,39,RW,2007
6851,21,26,Chuck Kobasew,21,68,42,RW,2008
6852,6,27,Chuck Kobasew,9,49,15,RW,2009
6853,7,28,Chuck Kobasew,9,63,16,RW,2010
6854,7,29,Chuck Kobasew,7,58,14,RW,2011
6855,4,30,Chuck Kobasew,5,37,9,RW,2012
6856,0,31,Chuck Kobasew,2,33,2,RW,2013
6857,0,21,Chuck Lefley,0,1,0,LW,1970
6858,2,22,Chuck Lefley,0,16,2,LW,1971
6859,25,23,Chuck Lefley,21,65,46,C,1972
6860,31,24,Chuck Lefley,23,74,54,C,1973
6861,28,25,Chuck Lefley,24,75,52,LW,1974
6862,42,26,Chuck Lefley,43,75,85,LW,1975
6863,30,27,Chuck Lefley,11,71,41,LW,1976
6864,6,30,Chuck Lefley,6,28,12,LW,1979
6865,0,31,Chuck Lefley,0,2,0,LW,1980
6866,11,29,Claire Alexander,7,42,18,D,1974
6867,6,30,Claire Alexander,2,33,8,D,1975
6868,12,31,Claire Alexander,1,48,13,D,1976
6869,18,32,Claire Alexander,8,32,26,D,1977
6870,23,33,Claire Alexander,8,54,31,D,1978
6871,23,33,Claire Alexander,8,54,31,D,1978
6872,3,24,Clark Donatelli,3,25,6,LW,1989
6873,1,26,Clark Donatelli,0,10,1,LW,1991
6874,22,20,Clark Gillies,25,80,47,LW,1974
6875,27,21,Clark Gillies,34,80,61,LW,1975
6876,22,22,Clark Gillies,33,70,55,LW,1976
6877,50,23,Clark Gillies,35,80,85,LW,1977
6878,56,24,Clark Gillies,35,75,91,LW,1978
6879,35,25,Clark Gillies,19,73,54,LW,1979
6880,45,26,Clark Gillies,33,80,78,LW,1980
6881,39,27,Clark Gillies,38,79,77,LW,1981
6882,20,28,Clark Gillies,21,70,41,LW,1982
6883,16,29,Clark Gillies,12,76,28,LW,1983
6884,17,30,Clark Gillies,15,54,32,LW,1984
6885,10,31,Clark Gillies,4,55,14,LW,1985
6886,17,32,Clark Gillies,10,61,27,LW,1986
6887,2,33,Clark Gillies,5,25,7,LW,1987
6888,4,21,Clarke MacArthur,3,19,7,LW,2006
6889,7,22,Clarke MacArthur,8,37,15,LW,2007
6890,14,23,Clarke MacArthur,17,71,31,LW,2008
6891,19,24,Clarke MacArthur,16,81,35,LW,2009
6892,41,25,Clarke MacArthur,21,82,62,LW,2010
6893,23,26,Clarke MacArthur,20,73,43,LW,2011
6894,12,27,Clarke MacArthur,8,40,20,LW,2012
6895,32,28,Clarke MacArthur,24,79,56,LW,2013
6896,20,29,Clarke MacArthur,16,62,36,LW,2014
6897,0,30,Clarke MacArthur,0,4,0,LW,2015
6898,0,31,Clarke MacArthur,0,4,0,LW,2016
6899,8,22,Clarke Wilm,10,78,18,C,1998
6900,12,23,Clarke Wilm,10,78,22,C,1999
6901,8,24,Clarke Wilm,7,81,15,C,2000
6902,14,25,Clarke Wilm,4,66,18,C,2001
6903,11,26,Clarke Wilm,5,82,16,C,2002
6904,0,27,Clarke Wilm,0,10,0,C,2003
6905,7,29,Clarke Wilm,1,60,8,C,2005
6906,7,24,Claude A Larose,4,25,11,LW,1979
6907,13,21,Claude Boivin,5,58,18,LW,1991
6908,4,22,Claude Boivin,5,30,9,LW,1992
6909,1,23,Claude Boivin,2,41,3,C,1993
6910,1,24,Claude Boivin,0,3,1,LW,1994
6911,0,26,Claude Cardin,0,1,0,LW,1967
6912,3,23,Claude Chartre,2,12,5,C,1972
6913,3,23,Claude Chartre,2,12,5,C,1972
6914,0,24,Claude Chartre,0,5,0,C,1973
6915,0,24,Claude Chartre,0,5,0,C,1973
6916,0,25,Claude Chartre,0,1,0,C,1974
6917,0,25,Claude Chartre,0,1,0,C,1974
6918,9,25,Claude D Larose,2,42,11,RW,1967
6919,37,26,Claude D Larose,25,67,62,RW,1968
6920,23,27,Claude D Larose,24,75,47,RW,1969
6921,13,28,Claude D Larose,10,64,23,RW,1970
6922,18,29,Claude D Larose,20,77,38,RW,1971
6923,23,30,Claude D Larose,11,73,34,RW,1972
6924,7,31,Claude D Larose,17,39,24,RW,1973
6925,19,32,Claude D Larose,11,64,30,RW,1974
6926,25,33,Claude D Larose,13,67,38,RW,1975
6927,19,34,Claude D Larose,29,80,48,RW,1976
6928,13,35,Claude D Larose,8,69,21,LW,1977
6929,0,20,Claude Giroux,0,2,0,RW,2007
6930,18,21,Claude Giroux,9,42,27,RW,2008
6931,31,22,Claude Giroux,16,82,47,RW,2009
6932,51,23,Claude Giroux,25,82,76,RW,2010
6933,65,24,Claude Giroux,28,77,93,RW,2011
6934,35,25,Claude Giroux,13,48,48,RW,2012
6935,58,26,Claude Giroux,28,82,86,C,2013
6936,48,27,Claude Giroux,25,81,73,C,2014
6937,45,28,Claude Giroux,22,78,67,C,2015
6938,44,29,Claude Giroux,14,82,58,C,2016
6939,68,30,Claude Giroux,34,82,102,C,2017
6940,4,27,Claude Houde,3,34,7,D,1974
6941,2,28,Claude Houde,0,25,2,D,1975
6942,0,24,Claude Julien,0,1,0,D,1984
6943,1,25,Claude Julien,0,13,1,D,1985
6944,16,31,Claude Laforge,9,63,25,LW,1967
6945,0,32,Claude Laforge,0,2,0,LW,1968
6946,2,22,Claude Lapointe,2,13,4,C,1990
6947,20,23,Claude Lapointe,13,78,33,C,1991
6948,26,24,Claude Lapointe,10,74,36,C,1992
6949,17,25,Claude Lapointe,11,59,28,LW,1993
6950,8,26,Claude Lapointe,4,29,12,C,1994
6951,5,27,Claude Lapointe,4,35,9,C,1995
6952,5,28,Claude Lapointe,13,73,18,C,1996
6953,10,29,Claude Lapointe,10,78,20,C,1997
6954,23,30,Claude Lapointe,14,82,37,C,1998
6955,16,31,Claude Lapointe,15,76,31,C,1999
6956,23,32,Claude Lapointe,9,80,32,LW,2000
6957,12,33,Claude Lapointe,9,80,21,C,2001
6958,8,34,Claude Lapointe,8,80,16,C,2002
6959,3,35,Claude Lapointe,5,42,8,C,2003
6960,24,20,Claude Larose,28,79,52,LW,1975
6961,46,21,Claude Larose,30,81,76,LW,1976
6962,46,21,Claude Larose,30,81,76,LW,1976
6963,36,22,Claude Larose,25,79,61,LW,1977
6964,36,22,Claude Larose,25,79,61,LW,1977
6965,8,23,Claude Larose,5,13,13,LW,1978
6966,8,23,Claude Larose,5,13,13,LW,1978
6967,1,18,Claude Lemieux,1,8,2,RW,1983
6968,1,19,Claude Lemieux,0,1,1,RW,1984
6969,2,20,Claude Lemieux,1,10,3,RW,1985
6970,26,21,Claude Lemieux,27,76,53,RW,1986
6971,30,22,Claude Lemieux,31,78,61,RW,1987
6972,22,23,Claude Lemieux,29,69,51,RW,1988
6973,10,24,Claude Lemieux,8,39,18,RW,1989
6974,17,25,Claude Lemieux,30,78,47,RW,1990
6975,27,26,Claude Lemieux,41,74,68,RW,1991
6976,51,27,Claude Lemieux,30,77,81,RW,1992
6977,26,28,Claude Lemieux,18,79,44,RW,1993
6978,13,29,Claude Lemieux,6,45,19,LW,1994
6979,32,30,Claude Lemieux,39,79,71,RW,1995
6980,17,31,Claude Lemieux,11,45,28,RW,1996
6981,27,32,Claude Lemieux,26,78,53,RW,1997
6982,24,33,Claude Lemieux,27,82,51,RW,1998
6983,27,34,Claude Lemieux,20,83,47,RW,1999
6984,16,35,Claude Lemieux,10,46,26,RW,2000
6985,25,36,Claude Lemieux,16,82,41,RW,2001
6986,12,37,Claude Lemieux,8,68,20,RW,2002
6987,1,43,Claude Lemieux,0,18,1,RW,2008
6988,0,18,Claude Loiselle,1,4,1,C,1981
6989,0,19,Claude Loiselle,2,18,2,C,1982
6990,6,20,Claude Loiselle,4,28,10,C,1983
6991,1,21,Claude Loiselle,8,30,9,RW,1984
6992,15,22,Claude Loiselle,7,48,22,C,1985
6993,24,23,Claude Loiselle,16,75,40,LW,1986
6994,18,24,Claude Loiselle,17,68,35,C,1987
6995,14,25,Claude Loiselle,7,74,21,C,1988
6996,14,26,Claude Loiselle,11,72,25,C,1989
6997,11,27,Claude Loiselle,6,66,17,C,1990
6998,10,28,Claude Loiselle,7,75,17,C,1991
6999,3,29,Claude Loiselle,5,41,8,C,1992
7000,1,30,Claude Loiselle,1,17,2,C,1993
7001,0,24,Claude Noel,0,7,0,C,1979
7002,30,34,Claude Provost,14,73,44,RW,1967
7003,15,35,Claude Provost,13,73,28,RW,1968
7004,11,36,Claude Provost,10,65,21,RW,1969
7005,0,21,Claude St. Sauveur,1,2,1,LW,1972
7006,0,21,Claude St. Sauveur,1,2,1,LW,1972
7007,30,22,Claude St. Sauveur,38,70,68,LW,1973
7008,30,22,Claude St. Sauveur,38,70,68,LW,1973
7009,23,23,Claude St. Sauveur,24,76,47,C,1974
7010,23,23,Claude St. Sauveur,24,76,47,C,1974
7011,24,24,Claude St. Sauveur,24,79,48,LW,1975
7012,10,25,Claude St. Sauveur,5,32,15,LW,1976
7013,10,25,Claude St. Sauveur,5,32,15,LW,1976
7014,42,26,Claude St. Sauveur,36,72,78,LW,1977
7015,42,26,Claude St. Sauveur,36,72,78,LW,1977
7016,7,27,Claude St. Sauveur,8,33,15,LW,1978
7017,5,20,Claude Verret,2,11,7,C,1983
7018,0,21,Claude Verret,0,3,0,C,1984
7019,1,24,Claude Vilgrain,1,6,2,LW,1987
7020,2,26,Claude Vilgrain,1,6,3,RW,1989
7021,27,28,Claude Vilgrain,19,71,46,LW,1991
7022,2,29,Claude Vilgrain,0,4,2,RW,1992
7023,0,30,Claude Vilgrain,0,2,0,RW,1993
7024,0,23,Claudio Scremin,0,13,0,D,1991
7025,1,24,Claudio Scremin,0,4,1,D,1992
7026,1,24,Clay Wilson,1,7,2,D,2007
7027,1,25,Clay Wilson,0,7,1,D,2008
7028,0,26,Clay Wilson,0,2,0,D,2009
7029,2,27,Clay Wilson,3,15,5,D,2010
7030,0,28,Clay Wilson,0,5,0,D,2011
7031,6,25,Clayton Beddoes,1,39,7,C,1995
7032,2,26,Clayton Beddoes,1,21,3,C,1996
7033,2,18,Clayton Keller,0,3,2,LW,2016
7034,42,19,Clayton Keller,23,82,65,LW,2017
7035,0,20,Clayton Pachal,0,1,0,LW,1976
7036,0,21,Clayton Pachal,0,10,0,C,1977
7037,3,22,Clayton Pachal,2,24,5,LW,1978
7038,2,24,Clayton Stoner,0,8,2,D,2009
7039,7,25,Clayton Stoner,2,57,9,D,2010
7040,4,26,Clayton Stoner,1,51,5,D,2011
7041,10,27,Clayton Stoner,0,48,10,D,2012
7042,4,28,Clayton Stoner,1,63,5,D,2013
7043,7,29,Clayton Stoner,1,69,8,D,2014
7044,5,30,Clayton Stoner,1,50,6,D,2015
7045,2,31,Clayton Stoner,1,14,3,D,2016
7046,16,38,Cleland Mortson,13,67,29,C,1972
7047,16,38,Cleland Mortson,13,67,29,C,1972
7048,1,43,Cleland Mortson,0,6,1,C,1977
7049,1,43,Cleland Mortson,0,6,1,C,1977
7050,19,23,Cliff Koroll,18,73,37,RW,1969
7051,34,24,Cliff Koroll,16,72,50,RW,1970
7052,23,25,Cliff Koroll,22,76,45,RW,1971
7053,24,26,Cliff Koroll,33,77,57,RW,1972
7054,25,27,Cliff Koroll,21,78,46,RW,1973
7055,32,28,Cliff Koroll,27,80,59,RW,1974
7056,33,29,Cliff Koroll,25,80,58,RW,1975
7057,26,30,Cliff Koroll,15,80,41,RW,1976
7058,15,31,Cliff Koroll,16,73,31,RW,1977
7059,19,32,Cliff Koroll,12,78,31,RW,1978
7060,4,33,Cliff Koroll,3,47,7,RW,1979
7061,14,21,Cliff Ronning,11,42,25,C,1986
7062,8,22,Cliff Ronning,5,26,13,C,1987
7063,31,23,Cliff Ronning,24,64,55,C,1988
7064,24,25,Cliff Ronning,20,59,44,C,1990
7065,47,26,Cliff Ronning,24,80,71,C,1991
7066,56,27,Cliff Ronning,29,79,85,C,1992
7067,43,28,Cliff Ronning,25,76,68,C,1993
7068,19,29,Cliff Ronning,6,41,25,C,1994
7069,45,30,Cliff Ronning,22,79,67,C,1995
7070,32,31,Cliff Ronning,19,69,51,C,1996
7071,44,32,Cliff Ronning,11,80,55,C,1997
7072,40,33,Cliff Ronning,20,79,60,C,1998
7073,36,34,Cliff Ronning,26,82,62,C,1999
7074,43,35,Cliff Ronning,19,80,62,C,2000
7075,35,36,Cliff Ronning,19,81,54,LW,2001
7076,31,37,Cliff Ronning,17,80,48,LW,2002
7077,15,38,Cliff Ronning,9,40,24,C,2003
7078,19,31,Cliff Schmautz,13,56,32,RW,1970
7079,0,20,Cody Almond,1,7,1,C,2009
7080,0,21,Cody Almond,0,8,0,C,2010
7081,0,22,Cody Almond,1,10,1,C,2011
7082,2,21,Cody Bass,2,21,4,C,2007
7083,0,22,Cody Bass,0,12,0,C,2008
7084,0,24,Cody Bass,0,1,0,C,2010
7085,1,25,Cody Bass,0,14,1,C,2011
7086,0,27,Cody Bass,0,1,0,C,2013
7087,0,29,Cody Bass,0,17,0,C,2015
7088,0,30,Cody Bass,0,9,0,C,2016
7089,6,20,Cody Ceci,3,49,9,D,2013
7090,16,21,Cody Ceci,5,81,21,D,2014
7091,16,22,Cody Ceci,10,75,26,D,2015
7092,15,23,Cody Ceci,2,79,17,D,2016
7093,14,24,Cody Ceci,5,82,19,D,2017
7094,4,20,Cody Eakin,4,30,8,C,2011
7095,17,21,Cody Eakin,7,48,24,C,2012
7096,19,22,Cody Eakin,16,81,35,C,2013
7097,21,23,Cody Eakin,19,78,40,C,2014
7098,19,24,Cody Eakin,16,82,35,C,2015
7099,9,25,Cody Eakin,3,60,12,C,2016
7100,16,26,Cody Eakin,11,80,27,C,2017
7101,15,22,Cody Franson,6,61,21,D,2009
7102,21,23,Cody Franson,8,80,29,D,2010
7103,16,24,Cody Franson,5,57,21,D,2011
7104,25,25,Cody Franson,4,45,29,D,2012
7105,28,26,Cody Franson,5,79,33,D,2013
7106,29,27,Cody Franson,7,78,36,D,2014
7107,13,28,Cody Franson,4,59,17,D,2015
7108,16,29,Cody Franson,3,68,19,D,2016
7109,6,30,Cody Franson,1,23,7,D,2017
7110,0,22,Cody Goloubef,0,1,0,D,2011
7111,0,23,Cody Goloubef,1,11,1,D,2012
7112,0,24,Cody Goloubef,0,5,0,D,2013
7113,9,25,Cody Goloubef,0,36,9,D,2014
7114,7,26,Cody Goloubef,1,43,8,D,2015
7115,5,27,Cody Goloubef,0,33,5,D,2016
7116,1,20,Cody Hodgson,1,8,2,C,2010
7117,22,21,Cody Hodgson,19,83,41,C,2011
7118,19,22,Cody Hodgson,15,48,34,C,2012
7119,24,23,Cody Hodgson,20,72,44,C,2013
7120,7,24,Cody Hodgson,6,78,13,C,2014
7121,5,25,Cody Hodgson,3,39,8,C,2015
7122,0,23,Cody Kunyk,0,1,0,LW,2013
7123,3,20,Cody McCormick,2,44,5,C,2003
7124,4,22,Cody McCormick,4,45,8,C,2005
7125,1,23,Cody McCormick,0,6,1,C,2006
7126,2,24,Cody McCormick,2,40,4,C,2007
7127,11,25,Cody McCormick,1,55,12,C,2008
7128,12,27,Cody McCormick,8,81,20,C,2010
7129,3,28,Cody McCormick,1,50,4,C,2011
7130,0,29,Cody McCormick,0,8,0,C,2012
7131,5,30,Cody McCormick,2,43,7,C,2013
7132,3,31,Cody McCormick,1,33,4,C,2014
7133,5,23,Cody McLeod,4,49,9,LW,2007
7134,5,24,Cody McLeod,15,79,20,LW,2008
7135,11,25,Cody McLeod,7,74,18,LW,2009
7136,3,26,Cody McLeod,5,71,8,LW,2010
7137,5,27,Cody McLeod,6,75,11,LW,2011
7138,4,28,Cody McLeod,8,48,12,LW,2012
7139,8,29,Cody McLeod,5,71,13,LW,2013
7140,5,30,Cody McLeod,7,82,12,LW,2014
7141,5,31,Cody McLeod,8,82,13,LW,2015
7142,0,32,Cody McLeod,1,28,1,LW,2016
7143,1,33,Cody McLeod,1,23,2,LW,2017
7144,24,23,Colby Armstrong,16,47,40,RW,2005
7145,22,24,Colby Armstrong,12,80,34,RW,2006
7146,22,25,Colby Armstrong,13,72,35,RW,2007
7147,18,26,Colby Armstrong,22,82,40,RW,2008
7148,14,27,Colby Armstrong,15,79,29,RW,2009
7149,15,28,Colby Armstrong,8,50,23,RW,2010
7150,2,29,Colby Armstrong,1,29,3,RW,2011
7151,3,30,Colby Armstrong,2,37,5,RW,2012
7152,0,23,Colby Cave,0,3,0,C,2017
7153,0,21,Colby Cohen,0,3,0,D,2010
7154,0,21,Colby Robak,0,3,0,D,2011
7155,1,22,Colby Robak,0,16,1,D,2012
7156,2,23,Colby Robak,0,16,2,D,2013
7157,1,24,Colby Robak,0,12,1,D,2014
7158,0,23,Cole Jarrett,0,1,0,D,2005
7159,0,25,Cole Schneider,0,2,0,LW,2015
7160,1,26,Cole Schneider,0,4,1,LW,2016
7161,20,21,Colin Campbell,3,78,23,D,1973
7162,20,21,Colin Campbell,3,78,23,D,1973
7163,15,22,Colin Campbell,4,59,19,D,1974
7164,10,23,Colin Campbell,7,64,17,D,1975
7165,8,24,Colin Campbell,3,54,11,D,1976
7166,9,25,Colin Campbell,1,55,10,D,1977
7167,18,26,Colin Campbell,2,65,20,D,1978
7168,11,27,Colin Campbell,2,72,13,D,1979
7169,8,28,Colin Campbell,1,42,9,D,1980
7170,8,29,Colin Campbell,0,47,8,D,1981
7171,7,30,Colin Campbell,1,53,8,D,1982
7172,4,31,Colin Campbell,3,68,7,D,1983
7173,5,32,Colin Campbell,1,57,6,D,1984
7174,0,23,Colin Chisholm,0,1,0,D,1986
7175,0,20,Colin Forbes,1,3,1,LW,1996
7176,7,21,Colin Forbes,12,63,19,LW,1997
7177,8,22,Colin Forbes,12,80,20,LW,1998
7178,5,23,Colin Forbes,2,53,7,LW,1999
7179,5,24,Colin Forbes,1,58,6,LW,2000
7180,3,25,Colin Forbes,5,38,8,LW,2001
7181,0,26,Colin Forbes,0,5,0,C,2002
7182,0,27,Colin Forbes,0,2,0,C,2003
7183,0,29,Colin Forbes,0,9,0,LW,2005
7184,0,22,Colin Fraser,0,1,0,C,2006
7185,0,23,Colin Fraser,0,5,0,C,2007
7186,11,24,Colin Fraser,6,81,17,C,2008
7187,12,25,Colin Fraser,7,70,19,C,2009
7188,2,26,Colin Fraser,3,67,5,C,2010
7189,6,27,Colin Fraser,2,67,8,C,2011
7190,5,28,Colin Fraser,2,34,7,C,2012
7191,2,29,Colin Fraser,0,33,2,C,2013
7192,0,30,Colin Fraser,0,1,0,C,2014
7193,7,24,Colin Greening,6,24,13,C,2010
7194,20,25,Colin Greening,17,82,37,C,2011
7195,11,26,Colin Greening,8,47,19,C,2012
7196,11,27,Colin Greening,6,76,17,C,2013
7197,0,28,Colin Greening,1,26,1,C,2014
7198,8,29,Colin Greening,7,31,15,C,2015
7199,0,25,Colin Hemingway,0,3,0,RW,2005
7200,0,25,Colin McDonald,1,2,1,C,2009
7201,0,27,Colin McDonald,0,5,0,C,2011
7202,10,28,Colin McDonald,7,45,17,C,2012
7203,10,29,Colin McDonald,8,70,18,RW,2013
7204,6,30,Colin McDonald,2,18,8,RW,2014
7205,0,31,Colin McDonald,1,5,1,RW,2015
7206,0,32,Colin McDonald,1,3,1,C,2016
7207,13,23,Colin Miller,3,42,16,D,2015
7208,7,24,Colin Miller,6,61,13,D,2016
7209,31,25,Colin Miller,10,82,41,D,2017
7210,14,23,Colin Patterson,13,56,27,RW,1983
7211,21,24,Colin Patterson,22,57,43,RW,1984
7212,13,25,Colin Patterson,14,61,27,RW,1985
7213,13,26,Colin Patterson,13,68,26,RW,1986
7214,11,27,Colin Patterson,7,39,18,LW,1987
7215,24,28,Colin Patterson,14,74,38,LW,1988
7216,3,29,Colin Patterson,5,61,8,LW,1989
7217,8,31,Colin Patterson,4,52,12,RW,1991
7218,2,32,Colin Patterson,4,36,6,RW,1992
7219,0,21,Colin Smith,0,1,0,C,2014
7220,2,25,Colin Stuart,3,18,5,LW,2007
7221,3,26,Colin Stuart,5,33,8,LW,2008
7222,0,28,Colin Stuart,0,3,0,LW,2010
7223,0,29,Colin Stuart,0,2,0,LW,2011
7224,1,22,Colin White,2,21,3,D,1999
7225,19,23,Colin White,1,82,20,D,2000
7226,3,24,Colin White,2,73,5,D,2001
7227,8,25,Colin White,5,72,13,D,2002
7228,11,26,Colin White,2,75,13,D,2003
7229,14,28,Colin White,3,73,17,D,2005
7230,8,29,Colin White,0,69,8,D,2006
7231,8,30,Colin White,2,57,10,D,2007
7232,17,31,Colin White,1,71,18,D,2008
7233,10,32,Colin White,2,81,12,D,2009
7234,6,33,Colin White,0,69,6,D,2010
7235,3,34,Colin White,1,54,4,D,2011
7236,0,20,Colin White,0,2,0,C,2016
7237,4,21,Colin White,2,21,6,C,2017
7238,7,20,Colin Wilson,8,35,15,C,2009
7239,18,21,Colin Wilson,16,82,34,C,2010
7240,20,22,Colin Wilson,15,68,35,C,2011
7241,12,23,Colin Wilson,7,25,19,C,2012
7242,22,24,Colin Wilson,11,81,33,C,2013
7243,22,25,Colin Wilson,20,77,42,C,2014
7244,18,26,Colin Wilson,6,64,24,LW,2015
7245,23,27,Colin Wilson,12,70,35,LW,2016
7246,12,28,Colin Wilson,6,56,18,C,2017
7247,1,21,Colten Teubert,0,24,1,D,2011
7248,5,19,Colton Gillies,2,45,7,C,2008
7249,0,21,Colton Gillies,1,7,1,C,2010
7250,6,22,Colton Gillies,2,75,8,C,2011
7251,1,23,Colton Gillies,1,27,2,C,2012
7252,0,21,Colton Orr,0,1,0,RW,2003
7253,1,23,Colton Orr,0,35,1,RW,2005
7254,1,24,Colton Orr,2,53,3,RW,2006
7255,1,25,Colton Orr,1,74,2,RW,2007
7256,4,26,Colton Orr,1,82,5,RW,2008
7257,2,27,Colton Orr,4,82,6,RW,2009
7258,0,28,Colton Orr,2,46,2,RW,2010
7259,0,29,Colton Orr,1,5,1,RW,2011
7260,3,30,Colton Orr,1,44,4,RW,2012
7261,0,31,Colton Orr,0,54,0,RW,2013
7262,0,32,Colton Orr,0,1,0,RW,2014
7263,24,22,Colton Parayko,9,79,33,D,2015
7264,31,23,Colton Parayko,4,81,35,D,2016
7265,29,24,Colton Parayko,6,82,35,D,2017
7266,0,21,Colton Sceviour,0,1,0,C,2010
7267,1,23,Colton Sceviour,0,1,1,C,2012
7268,4,24,Colton Sceviour,8,26,12,RW,2013
7269,17,25,Colton Sceviour,9,71,26,C,2014
7270,12,26,Colton Sceviour,11,71,23,C,2015
7271,15,27,Colton Sceviour,9,80,24,C,2016
7272,13,28,Colton Sceviour,11,76,24,RW,2017
7273,3,20,Colton Sissons,1,17,4,C,2013
7274,2,22,Colton Sissons,4,34,6,C,2015
7275,2,23,Colton Sissons,8,58,10,C,2016
7276,18,24,Colton Sissons,9,81,27,C,2017
7277,0,23,Connie Forey,0,4,0,LW,1973
7278,0,23,Connie Forey,0,1,0,LW,1973
7279,0,23,Connie Forey,0,1,0,LW,1973
7280,3,38,Connie Madigan,0,20,3,D,1972
7281,4,23,Connor Brickley,1,23,5,C,2015
7282,8,25,Connor Brickley,4,44,12,LW,2017
7283,5,22,Connor Brown,1,7,6,RW,2015
7284,16,23,Connor Brown,20,82,36,RW,2016
7285,14,24,Connor Brown,14,82,28,RW,2017
7286,5,19,Connor Carrick,1,34,6,D,2013
7287,2,21,Connor Carrick,2,19,4,D,2015
7288,6,22,Connor Carrick,2,67,8,D,2016
7289,8,23,Connor Carrick,4,47,12,D,2017
7290,0,23,Connor James,0,2,0,RW,2005
7291,0,25,Connor James,1,13,1,LW,2007
7292,0,26,Connor James,0,1,0,LW,2008
7293,0,26,Connor Jones,0,4,0,C,2016
7294,32,19,Connor McDavid,16,45,48,C,2015
7295,70,20,Connor McDavid,30,82,100,C,2016
7296,67,21,Connor McDavid,41,82,108,C,2017
7297,7,20,Connor Murphy,1,30,8,D,2013
7298,3,21,Connor Murphy,4,73,7,D,2014
7299,11,22,Connor Murphy,6,78,17,D,2015
7300,15,23,Connor Murphy,2,77,17,D,2016
7301,12,24,Connor Murphy,2,76,14,D,2017
7302,0,24,Conor Allen,0,3,0,D,2013
7303,0,25,Conor Allen,0,4,0,D,2014
7304,3,23,Conor Sheary,7,44,10,LW,2015
7305,30,24,Conor Sheary,23,61,53,LW,2016
7306,12,25,Conor Sheary,18,79,30,LW,2017
7307,0,23,Corban Knight,1,7,1,C,2013
7308,0,24,Corban Knight,0,2,0,C,2014
7309,5,25,Corban Knight,2,20,7,C,2015
7310,0,24,Corey Elkins,1,3,1,C,2009
7311,0,19,Corey Foster,0,2,0,D,1988
7312,4,22,Corey Foster,3,25,7,D,1991
7313,2,26,Corey Foster,2,11,4,D,1995
7314,0,27,Corey Foster,0,7,0,D,1996
7315,0,23,Corey Locke,0,1,0,C,2007
7316,0,25,Corey Locke,0,3,0,C,2009
7317,1,26,Corey Locke,0,5,1,C,2010
7318,0,25,Corey Millen,0,4,0,C,1989
7319,1,26,Corey Millen,3,4,4,C,1990
7320,25,27,Corey Millen,21,57,46,C,1991
7321,16,28,Corey Millen,23,42,39,C,1992
7322,30,29,Corey Millen,20,78,50,C,1993
7323,18,30,Corey Millen,5,45,23,C,1994
7324,14,31,Corey Millen,7,44,21,C,1995
7325,15,32,Corey Millen,11,61,26,C,1996
7326,12,20,Corey Perry,13,56,25,RW,2005
7327,27,21,Corey Perry,17,82,44,RW,2006
7328,25,22,Corey Perry,29,70,54,RW,2007
7329,40,23,Corey Perry,32,78,72,RW,2008
7330,49,24,Corey Perry,27,82,76,RW,2009
7331,48,25,Corey Perry,50,82,98,RW,2010
7332,23,26,Corey Perry,37,80,60,RW,2011
7333,21,27,Corey Perry,15,44,36,RW,2012
7334,39,28,Corey Perry,43,81,82,RW,2013
7335,22,29,Corey Perry,33,67,55,RW,2014
7336,28,30,Corey Perry,34,82,62,RW,2015
7337,34,31,Corey Perry,19,82,53,RW,2016
7338,32,32,Corey Perry,17,71,49,RW,2017
7339,1,25,Corey Potter,1,5,2,D,2008
7340,0,26,Corey Potter,0,3,0,D,2009
7341,0,27,Corey Potter,0,1,0,D,2010
7342,17,28,Corey Potter,4,62,21,D,2011
7343,1,29,Corey Potter,3,33,4,D,2012
7344,5,30,Corey Potter,0,19,5,D,2013
7345,0,31,Corey Potter,0,6,0,D,2014
7346,0,32,Corey Potter,0,1,0,D,2015
7347,0,26,Corey Spring,1,8,1,C,1997
7348,1,27,Corey Spring,0,8,1,RW,1998
7349,5,22,Corey Tropp,3,34,8,RW,2011
7350,9,24,Corey Tropp,2,53,11,RW,2013
7351,7,25,Corey Tropp,1,61,8,RW,2014
7352,0,27,Corey Tropp,0,1,0,RW,2016
7353,18,23,Cory Conacher,11,47,29,LW,2012
7354,19,24,Cory Conacher,7,79,26,C,2013
7355,2,25,Cory Conacher,1,15,3,LW,2014
7356,3,27,Cory Conacher,1,11,4,LW,2016
7357,4,28,Cory Conacher,8,36,12,LW,2017
7358,0,23,Cory Cross,0,5,0,D,1993
7359,5,24,Cory Cross,1,43,6,D,1994
7360,14,25,Cory Cross,2,75,16,D,1995
7361,5,26,Cory Cross,4,72,9,D,1996
7362,6,27,Cory Cross,3,74,9,D,1997
7363,16,28,Cory Cross,2,67,18,D,1998
7364,11,29,Cory Cross,4,71,15,D,1999
7365,5,30,Cory Cross,3,41,8,D,2000
7366,9,31,Cory Cross,3,50,12,D,2001
7367,7,32,Cory Cross,2,37,9,D,2002
7368,14,33,Cory Cross,7,68,21,D,2003
7369,5,35,Cory Cross,3,56,8,D,2005
7370,0,22,Cory Emmerton,1,2,1,C,2010
7371,4,23,Cory Emmerton,6,71,10,C,2011
7372,3,24,Cory Emmerton,5,48,8,C,2012
7373,2,25,Cory Emmerton,0,18,2,C,2013
7374,1,28,Cory Larose,0,7,1,C,2003
7375,15,29,Cory Murphy,2,47,17,D,2007
7376,11,30,Cory Murphy,5,32,16,D,2008
7377,1,31,Cory Murphy,2,12,3,D,2009
7378,0,20,Cory Sarich,0,4,0,D,1998
7379,6,21,Cory Sarich,0,59,6,D,1999
7380,8,22,Cory Sarich,1,73,9,D,2000
7381,11,23,Cory Sarich,0,72,11,D,2001
7382,9,24,Cory Sarich,5,82,14,D,2002
7383,16,25,Cory Sarich,3,82,19,D,2003
7384,14,27,Cory Sarich,1,82,15,D,2005
7385,15,28,Cory Sarich,0,82,15,D,2006
7386,5,29,Cory Sarich,2,80,7,D,2007
7387,18,30,Cory Sarich,2,76,20,D,2008
7388,5,31,Cory Sarich,1,57,6,D,2009
7389,13,32,Cory Sarich,4,76,17,D,2010
7390,6,33,Cory Sarich,1,62,7,D,2011
7391,2,34,Cory Sarich,0,28,2,D,2012
7392,9,35,Cory Sarich,1,54,10,D,2013
7393,2,21,Cory Stillman,0,10,2,C,1994
7394,19,22,Cory Stillman,16,74,35,LW,1995
7395,20,23,Cory Stillman,6,58,26,LW,1996
7396,22,24,Cory Stillman,27,72,49,LW,1997
7397,30,25,Cory Stillman,27,76,57,C,1998
7398,9,26,Cory Stillman,12,37,21,C,1999
7399,28,27,Cory Stillman,24,78,52,LW,2000
7400,22,28,Cory Stillman,23,80,45,LW,2001
7401,43,29,Cory Stillman,24,79,67,LW,2002
7402,55,30,Cory Stillman,25,81,80,LW,2003
7403,55,32,Cory Stillman,21,72,76,LW,2005
7404,22,33,Cory Stillman,5,43,27,LW,2006
7405,41,34,Cory Stillman,24,79,65,LW,2007
7406,32,35,Cory Stillman,17,63,49,LW,2008
7407,22,36,Cory Stillman,15,58,37,LW,2009
7408,27,37,Cory Stillman,12,65,39,LW,2010
7409,0,23,Craig Adams,1,44,1,RW,2000
7410,1,24,Craig Adams,0,33,1,RW,2001
7411,12,25,Craig Adams,6,81,18,RW,2002
7412,10,26,Craig Adams,7,80,17,LW,2003
7413,11,28,Craig Adams,10,67,21,RW,2005
7414,7,29,Craig Adams,7,82,14,RW,2006
7415,7,30,Craig Adams,4,75,11,RW,2007
7416,5,31,Craig Adams,2,45,7,RW,2008
7417,10,32,Craig Adams,0,82,10,RW,2009
7418,11,33,Craig Adams,4,80,15,RW,2010
7419,13,34,Craig Adams,5,82,18,RW,2011
7420,6,35,Craig Adams,3,48,9,RW,2012
7421,6,36,Craig Adams,5,82,11,RW,2013
7422,6,37,Craig Adams,1,70,7,RW,2014
7423,0,21,Craig Berube,0,7,0,LW,1986
7424,2,22,Craig Berube,3,27,5,LW,1987
7425,1,23,Craig Berube,1,53,2,LW,1988
7426,14,24,Craig Berube,4,74,18,LW,1989
7427,9,25,Craig Berube,8,74,17,LW,1990
7428,11,26,Craig Berube,6,76,17,LW,1991
7429,8,27,Craig Berube,4,77,12,LW,1992
7430,7,28,Craig Berube,7,84,14,LW,1993
7431,4,29,Craig Berube,2,43,6,LW,1994
7432,10,30,Craig Berube,2,50,12,LW,1995
7433,3,31,Craig Berube,4,80,7,LW,1996
7434,9,32,Craig Berube,6,74,15,LW,1997
7435,4,33,Craig Berube,5,77,9,LW,1998
7436,8,34,Craig Berube,4,77,12,LW,1999
7437,3,35,Craig Berube,0,60,3,LW,2000
7438,1,36,Craig Berube,3,66,4,LW,2001
7439,4,37,Craig Berube,2,55,6,LW,2002
7440,2,22,Craig Cameron,7,32,9,RW,1967
7441,5,23,Craig Cameron,11,72,16,RW,1968
7442,6,25,Craig Cameron,14,78,20,RW,1970
7443,1,26,Craig Cameron,2,64,3,RW,1971
7444,14,27,Craig Cameron,19,72,33,RW,1972
7445,14,28,Craig Cameron,15,78,29,RW,1973
7446,13,29,Craig Cameron,11,77,24,RW,1974
7447,10,30,Craig Cameron,8,78,18,RW,1975
7448,0,23,Craig Conroy,1,6,1,C,1994
7449,0,24,Craig Conroy,0,7,0,C,1995
7450,11,25,Craig Conroy,6,61,17,C,1996
7451,29,26,Craig Conroy,14,81,43,RW,1997
7452,25,27,Craig Conroy,14,69,39,C,1998
7453,15,28,Craig Conroy,12,79,27,C,1999
7454,18,29,Craig Conroy,14,83,32,C,2000
7455,48,30,Craig Conroy,27,81,75,C,2001
7456,37,31,Craig Conroy,22,79,59,C,2002
7457,39,32,Craig Conroy,8,63,47,C,2003
7458,44,34,Craig Conroy,22,78,66,C,2005
7459,24,35,Craig Conroy,13,80,37,C,2006
7460,22,36,Craig Conroy,12,79,34,C,2007
7461,36,37,Craig Conroy,12,82,48,C,2008
7462,12,38,Craig Conroy,3,63,15,C,2009
7463,0,39,Craig Conroy,2,18,2,C,2010
7464,0,21,Craig Coxe,0,9,0,C,1984
7465,5,22,Craig Coxe,3,57,8,C,1985
7466,0,23,Craig Coxe,1,15,1,C,1986
7467,15,24,Craig Coxe,7,71,22,C,1987
7468,7,25,Craig Coxe,0,41,7,C,1988
7469,4,26,Craig Coxe,1,25,5,C,1989
7470,0,27,Craig Coxe,0,7,0,C,1990
7471,0,28,Craig Coxe,2,10,2,C,1991
7472,0,23,Craig Cunningham,0,2,0,RW,2013
7473,4,24,Craig Cunningham,3,51,7,RW,2014
7474,1,25,Craig Cunningham,0,10,1,RW,2015
7475,2,22,Craig Darby,0,13,2,C,1994
7476,2,23,Craig Darby,0,10,2,C,1995
7477,4,24,Craig Darby,1,9,5,C,1996
7478,0,25,Craig Darby,1,3,1,C,1997
7479,10,27,Craig Darby,7,76,17,C,1999
7480,16,28,Craig Darby,12,78,28,C,2000
7481,0,29,Craig Darby,0,2,0,C,2001
7482,1,30,Craig Darby,0,3,1,C,2002
7483,0,31,Craig Darby,0,2,0,C,2003
7484,1,18,Craig Duncanson,0,2,1,LW,1985
7485,0,19,Craig Duncanson,0,2,0,LW,1986
7486,0,20,Craig Duncanson,0,9,0,LW,1987
7487,0,21,Craig Duncanson,0,5,0,LW,1988
7488,2,22,Craig Duncanson,3,10,5,LW,1989
7489,0,23,Craig Duncanson,2,7,2,LW,1990
7490,1,25,Craig Duncanson,0,3,1,LW,1992
7491,1,18,Craig Endean,0,2,1,LW,1986
7492,5,29,Craig Falkman,1,45,6,RW,1972
7493,5,29,Craig Falkman,1,45,6,RW,1972
7494,1,23,Craig Ferguson,0,2,1,RW,1993
7495,0,24,Craig Ferguson,0,1,0,C,1994
7496,0,25,Craig Ferguson,1,18,1,C,1995
7497,0,26,Craig Ferguson,0,3,0,C,1996
7498,0,29,Craig Ferguson,0,3,0,RW,1999
7499,0,19,Craig Fisher,0,2,0,C,1989
7500,0,20,Craig Fisher,0,2,0,C,1990
7501,0,23,Craig Fisher,0,4,0,C,1993
7502,0,26,Craig Fisher,0,4,0,C,1996
7503,0,19,Craig Hamner,1,27,1,D,1974
7504,0,19,Craig Hamner,1,27,1,D,1974
7505,40,19,Craig Hartsburg,9,77,49,D,1978
7506,40,19,Craig Hartsburg,9,77,49,D,1978
7507,30,20,Craig Hartsburg,14,79,44,D,1979
7508,30,21,Craig Hartsburg,13,74,43,D,1980
7509,60,22,Craig Hartsburg,17,76,77,D,1981
7510,50,23,Craig Hartsburg,12,78,62,D,1982
7511,7,24,Craig Hartsburg,7,26,14,D,1983
7512,11,25,Craig Hartsburg,7,32,18,D,1984
7513,47,26,Craig Hartsburg,10,75,57,D,1985
7514,50,27,Craig Hartsburg,11,73,61,D,1986
7515,16,28,Craig Hartsburg,3,27,19,D,1987
7516,14,29,Craig Hartsburg,4,30,18,D,1988
7517,9,20,Craig Janney,7,15,16,C,1987
7518,46,21,Craig Janney,16,62,62,C,1988
7519,38,22,Craig Janney,24,55,62,C,1989
7520,66,23,Craig Janney,26,77,92,C,1990
7521,69,24,Craig Janney,18,78,87,C,1991
7522,82,25,Craig Janney,24,84,106,C,1992
7523,68,26,Craig Janney,16,69,84,C,1993
7524,20,27,Craig Janney,7,35,27,C,1994
7525,62,28,Craig Janney,20,84,82,C,1995
7526,38,29,Craig Janney,15,77,53,C,1996
7527,43,30,Craig Janney,10,68,53,C,1997
7528,22,31,Craig Janney,5,56,27,C,1998
7529,3,22,Craig Johnson,3,15,6,LW,1994
7530,11,23,Craig Johnson,13,60,24,RW,1995
7531,3,24,Craig Johnson,4,31,7,LW,1996
7532,21,25,Craig Johnson,17,74,38,RW,1997
7533,12,26,Craig Johnson,7,69,19,LW,1998
7534,14,27,Craig Johnson,9,76,23,LW,1999
7535,5,28,Craig Johnson,4,26,9,RW,2000
7536,14,29,Craig Johnson,13,72,27,LW,2001
7537,6,30,Craig Johnson,3,70,9,LW,2002
7538,9,31,Craig Johnson,2,64,11,C,2003
7539,11,24,Craig Laughlin,12,36,23,RW,1981
7540,27,25,Craig Laughlin,17,75,44,LW,1982
7541,32,26,Craig Laughlin,20,80,52,RW,1983
7542,34,27,Craig Laughlin,16,78,50,RW,1984
7543,45,28,Craig Laughlin,30,75,75,RW,1985
7544,30,29,Craig Laughlin,22,80,52,RW,1986
7545,13,30,Craig Laughlin,9,59,22,RW,1987
7546,13,31,Craig Laughlin,10,66,23,C,1988
7547,9,22,Craig Levie,4,40,13,D,1981
7548,5,23,Craig Levie,4,22,9,D,1982
7549,13,24,Craig Levie,6,37,19,D,1983
7550,23,25,Craig Levie,6,61,29,D,1984
7551,2,26,Craig Levie,2,14,4,D,1985
7552,1,27,Craig Levie,0,9,1,D,1986
7553,25,21,Craig Ludwig,0,80,25,D,1982
7554,18,22,Craig Ludwig,7,80,25,D,1983
7555,14,23,Craig Ludwig,5,72,19,D,1984
7556,4,24,Craig Ludwig,2,69,6,D,1985
7557,12,25,Craig Ludwig,4,75,16,D,1986
7558,10,26,Craig Ludwig,4,74,14,D,1987
7559,13,27,Craig Ludwig,3,74,16,D,1988
7560,15,28,Craig Ludwig,1,73,16,D,1989
7561,8,29,Craig Ludwig,1,75,9,D,1990
7562,9,30,Craig Ludwig,2,73,11,D,1991
7563,10,31,Craig Ludwig,1,78,11,D,1992
7564,13,32,Craig Ludwig,1,84,14,D,1993
7565,7,33,Craig Ludwig,2,47,9,D,1994
7566,2,34,Craig Ludwig,1,65,3,D,1995
7567,11,35,Craig Ludwig,2,77,13,D,1996
7568,7,36,Craig Ludwig,0,80,7,D,1997
7569,6,37,Craig Ludwig,2,80,8,D,1998
7570,0,21,Craig MacDonald,0,11,0,C,1998
7571,1,24,Craig MacDonald,1,12,2,C,2001
7572,3,25,Craig MacDonald,1,35,4,LW,2002
7573,6,26,Craig MacDonald,0,52,6,LW,2003
7574,2,28,Craig MacDonald,3,25,5,C,2005
7575,2,29,Craig MacDonald,3,25,5,C,2006
7576,9,30,Craig MacDonald,2,65,11,C,2007
7577,1,31,Craig MacDonald,1,8,2,C,2008
7578,17,21,Craig MacTavish,11,46,28,C,1979
7579,5,22,Craig MacTavish,3,24,8,C,1980
7580,1,23,Craig MacTavish,0,2,1,C,1981
7581,20,24,Craig MacTavish,10,75,30,C,1982
7582,23,25,Craig MacTavish,20,70,43,C,1983
7583,24,27,Craig MacTavish,23,74,47,C,1985
7584,19,28,Craig MacTavish,20,79,39,C,1986
7585,17,29,Craig MacTavish,15,80,32,C,1987
7586,31,30,Craig MacTavish,21,80,52,C,1988
7587,22,31,Craig MacTavish,21,80,43,C,1989
7588,15,32,Craig MacTavish,17,80,32,C,1990
7589,18,33,Craig MacTavish,12,80,30,C,1991
7590,20,34,Craig MacTavish,10,82,30,C,1992
7591,12,35,Craig MacTavish,20,78,32,C,1993
7592,9,36,Craig MacTavish,3,45,12,C,1994
7593,9,37,Craig MacTavish,5,68,14,C,1995
7594,5,38,Craig MacTavish,2,50,7,C,1996
7595,1,24,Craig Martin,0,20,1,RW,1994
7596,0,26,Craig Martin,0,1,0,RW,1996
7597,0,20,Craig Millar,0,1,0,D,1996
7598,0,21,Craig Millar,4,11,4,D,1997
7599,2,22,Craig Millar,0,24,2,D,1998
7600,11,23,Craig Millar,3,57,14,D,1999
7601,1,24,Craig Millar,1,21,2,D,2000
7602,2,19,Craig Mills,0,4,2,RW,1995
7603,3,21,Craig Mills,0,20,3,RW,1997
7604,0,22,Craig Mills,0,7,0,RW,1998
7605,0,19,Craig Muni,0,3,0,D,1981
7606,1,20,Craig Muni,0,2,1,D,1982
7607,0,22,Craig Muni,0,8,0,D,1984
7608,1,23,Craig Muni,0,6,1,D,1985
7609,22,24,Craig Muni,7,79,29,D,1986
7610,15,25,Craig Muni,4,72,19,D,1987
7611,13,26,Craig Muni,5,69,18,D,1988
7612,12,27,Craig Muni,5,71,17,D,1989
7613,9,28,Craig Muni,1,76,10,D,1990
7614,5,29,Craig Muni,2,54,7,D,1991
7615,11,30,Craig Muni,0,81,11,D,1992
7616,12,31,Craig Muni,2,82,14,D,1993
7617,6,32,Craig Muni,0,40,6,D,1994
7618,7,33,Craig Muni,1,72,8,D,1995
7619,4,34,Craig Muni,0,64,4,D,1996
7620,1,35,Craig Muni,1,40,2,D,1997
7621,23,22,Craig Norwich,7,65,30,D,1977
7622,23,22,Craig Norwich,7,65,30,D,1977
7623,51,23,Craig Norwich,6,80,57,D,1978
7624,51,23,Craig Norwich,6,80,57,D,1978
7625,35,24,Craig Norwich,10,70,45,D,1979
7626,23,25,Craig Norwich,7,34,30,D,1980
7627,3,25,Craig Patrick,8,59,11,RW,1971
7628,22,26,Craig Patrick,20,71,42,RW,1972
7629,20,27,Craig Patrick,10,59,30,RW,1973
7630,10,28,Craig Patrick,8,57,18,RW,1974
7631,18,29,Craig Patrick,17,80,35,RW,1975
7632,10,30,Craig Patrick,7,28,17,RW,1976
7633,7,31,Craig Patrick,1,44,8,RW,1977
7634,1,32,Craig Patrick,1,3,2,RW,1978
7635,11,30,Craig Patrick*,6,30,17,C,1976
7636,10,20,Craig Ramsay,6,57,16,LW,1971
7637,17,21,Craig Ramsay,11,76,28,LW,1972
7638,26,22,Craig Ramsay,20,78,46,LW,1973
7639,38,23,Craig Ramsay,26,80,64,LW,1974
7640,49,24,Craig Ramsay,22,80,71,LW,1975
7641,41,25,Craig Ramsay,20,80,61,LW,1976
7642,43,26,Craig Ramsay,28,80,71,LW,1977
7643,31,27,Craig Ramsay,26,80,57,LW,1978
7644,39,28,Craig Ramsay,21,80,60,LW,1979
7645,35,29,Craig Ramsay,24,80,59,LW,1980
7646,35,30,Craig Ramsay,16,80,51,LW,1981
7647,18,31,Craig Ramsay,11,64,29,LW,1982
7648,17,32,Craig Ramsay,9,76,26,LW,1983
7649,21,33,Craig Ramsay,12,79,33,LW,1984
7650,33,19,Craig Redmond,6,79,39,D,1984
7651,18,20,Craig Redmond,6,73,24,D,1985
7652,7,21,Craig Redmond,1,16,8,D,1986
7653,0,22,Craig Redmond,0,2,0,D,1987
7654,10,23,Craig Redmond,3,21,13,D,1988
7655,0,22,Craig Reichert,0,3,0,RW,1996
7656,14,25,Craig Reichmuth,13,73,27,LW,1972
7657,14,25,Craig Reichmuth,13,73,27,LW,1972
7658,8,26,Craig Reichmuth,10,72,18,LW,1973
7659,8,26,Craig Reichmuth,10,72,18,LW,1973
7660,3,27,Craig Reichmuth,2,44,5,LW,1974
7661,1,20,Craig Rivet,0,5,1,D,1994
7662,4,21,Craig Rivet,1,19,5,D,1995
7663,4,22,Craig Rivet,0,35,4,D,1996
7664,2,23,Craig Rivet,0,61,2,D,1997
7665,8,24,Craig Rivet,2,66,10,D,1998
7666,14,25,Craig Rivet,3,61,17,D,1999
7667,2,26,Craig Rivet,1,26,3,D,2000
7668,17,27,Craig Rivet,8,82,25,D,2001
7669,15,28,Craig Rivet,7,82,22,D,2002
7670,8,29,Craig Rivet,4,80,12,D,2003
7671,27,31,Craig Rivet,7,82,34,D,2005
7672,17,32,Craig Rivet,7,71,24,D,2006
7673,30,33,Craig Rivet,5,74,35,D,2007
7674,22,34,Craig Rivet,2,64,24,D,2008
7675,14,35,Craig Rivet,1,78,15,D,2009
7676,2,36,Craig Rivet,2,37,4,D,2010
7677,0,25,Craig Sarner,0,7,0,RW,1974
7678,0,26,Craig Sarner,0,1,0,RW,1975
7679,0,26,Craig Sarner,0,1,0,RW,1975
7680,17,18,Craig Simpson,11,76,28,C,1985
7681,25,19,Craig Simpson,26,72,51,RW,1986
7682,34,20,Craig Simpson,56,80,90,RW,1987
7683,41,21,Craig Simpson,35,66,76,LW,1988
7684,32,22,Craig Simpson,29,80,61,LW,1989
7685,27,23,Craig Simpson,30,75,57,LW,1990
7686,37,24,Craig Simpson,24,79,61,LW,1991
7687,22,25,Craig Simpson,24,60,46,LW,1992
7688,8,26,Craig Simpson,8,22,16,LW,1993
7689,7,27,Craig Simpson,4,24,11,LW,1994
7690,22,22,Craig Smith,14,72,36,C,2011
7691,8,23,Craig Smith,4,44,12,C,2012
7692,28,24,Craig Smith,24,79,52,C,2013
7693,21,25,Craig Smith,23,82,44,C,2014
7694,16,26,Craig Smith,21,82,37,RW,2015
7695,17,27,Craig Smith,12,78,29,RW,2016
7696,26,28,Craig Smith,25,79,51,RW,2017
7697,2,20,Craig Topolnisky,0,10,2,D,1977
7698,2,20,Craig Topolnisky,0,10,2,D,1977
7699,8,27,Craig Weller,3,59,11,RW,2007
7700,2,28,Craig Weller,1,36,3,RW,2008
7701,16,18,Craig Wolanin,2,44,18,D,1985
7702,6,19,Craig Wolanin,4,68,10,D,1986
7703,25,20,Craig Wolanin,6,78,31,D,1987
7704,8,21,Craig Wolanin,3,56,11,D,1988
7705,10,22,Craig Wolanin,1,50,11,D,1989
7706,13,23,Craig Wolanin,5,80,18,D,1990
7707,11,24,Craig Wolanin,2,69,13,D,1991
7708,4,25,Craig Wolanin,1,24,5,D,1992
7709,10,26,Craig Wolanin,6,63,16,D,1993
7710,6,27,Craig Wolanin,3,40,9,D,1994
7711,20,28,Craig Wolanin,7,75,27,D,1995
7712,4,29,Craig Wolanin,0,38,4,D,1996
7713,0,30,Craig Wolanin,0,10,0,D,1997
7714,0,22,Curt Bennett,2,4,2,LW,1970
7715,5,23,Curt Bennett,3,31,8,LW,1971
7716,18,24,Curt Bennett,18,68,36,C,1972
7717,24,25,Curt Bennett,17,71,41,LW,1973
7718,33,26,Curt Bennett,31,80,64,LW,1974
7719,31,27,Curt Bennett,34,80,65,LW,1975
7720,25,28,Curt Bennett,22,76,47,LW,1976
7721,24,29,Curt Bennett,10,75,34,LW,1977
7722,19,30,Curt Bennett,14,74,33,LW,1978
7723,3,31,Curt Bennett,1,21,4,LW,1979
7724,1,22,Curt Brackenbury,0,4,1,RW,1973
7725,1,22,Curt Brackenbury,0,4,1,RW,1973
7726,0,23,Curt Brackenbury,0,7,0,RW,1974
7727,0,23,Curt Brackenbury,0,7,0,RW,1974
7728,14,24,Curt Brackenbury,8,74,22,LW,1975
7729,14,24,Curt Brackenbury,8,74,22,LW,1975
7730,13,25,Curt Brackenbury,16,77,29,RW,1976
7731,13,25,Curt Brackenbury,16,77,29,RW,1976
7732,9,26,Curt Brackenbury,4,33,13,RW,1977
7733,9,26,Curt Brackenbury,4,33,13,RW,1977
7734,13,27,Curt Brackenbury,13,70,26,RW,1978
7735,13,27,Curt Brackenbury,13,70,26,RW,1978
7736,8,28,Curt Brackenbury,6,63,14,RW,1979
7737,7,29,Curt Brackenbury,2,58,9,RW,1980
7738,2,30,Curt Brackenbury,0,14,2,RW,1981
7739,0,31,Curt Brackenbury,1,6,1,RW,1982
7740,19,21,Curt Fraser,16,78,35,LW,1978
7741,25,22,Curt Fraser,17,78,42,LW,1979
7742,24,23,Curt Fraser,25,77,49,LW,1980
7743,39,24,Curt Fraser,28,79,67,LW,1981
7744,20,25,Curt Fraser,12,74,32,LW,1982
7745,12,26,Curt Fraser,5,29,17,LW,1983
7746,25,27,Curt Fraser,25,73,50,LW,1984
7747,39,28,Curt Fraser,29,61,68,LW,1985
7748,25,29,Curt Fraser,25,75,50,LW,1986
7749,7,30,Curt Fraser,5,37,12,LW,1987
7750,5,31,Curt Fraser,5,35,10,LW,1988
7751,0,32,Curt Fraser,1,8,1,LW,1989
7752,7,21,Curt Giles,2,37,9,D,1979
7753,22,22,Curt Giles,5,67,27,D,1980
7754,12,23,Curt Giles,3,74,15,D,1981
7755,21,24,Curt Giles,2,76,23,D,1982
7756,22,25,Curt Giles,6,70,28,D,1983
7757,25,26,Curt Giles,5,77,30,D,1984
7758,21,27,Curt Giles,6,69,27,D,1985
7759,20,28,Curt Giles,2,72,22,D,1986
7760,12,29,Curt Giles,1,72,13,D,1987
7761,10,30,Curt Giles,5,76,15,D,1988
7762,12,31,Curt Giles,1,74,13,D,1989
7763,10,32,Curt Giles,4,70,14,D,1990
7764,1,33,Curt Giles,1,13,2,D,1991
7765,4,34,Curt Giles,0,48,4,D,1992
7766,1,18,Curtis Brown,1,1,2,C,1994
7767,0,19,Curtis Brown,0,4,0,C,1995
7768,3,20,Curtis Brown,4,28,7,C,1996
7769,12,21,Curtis Brown,12,63,24,C,1997
7770,31,22,Curtis Brown,16,78,47,C,1998
7771,29,23,Curtis Brown,22,74,51,C,1999
7772,22,24,Curtis Brown,10,70,32,C,2000
7773,17,25,Curtis Brown,20,82,37,C,2001
7774,16,26,Curtis Brown,15,74,31,C,2002
7775,14,27,Curtis Brown,11,80,25,C,2003
7776,10,29,Curtis Brown,5,71,15,C,2005
7777,12,30,Curtis Brown,8,78,20,C,2006
7778,4,31,Curtis Brown,5,33,9,C,2007
7779,0,24,Curtis Glencross,1,9,1,LW,2006
7780,10,25,Curtis Glencross,15,62,25,LW,2007
7781,27,26,Curtis Glencross,13,74,40,LW,2008
7782,18,27,Curtis Glencross,15,67,33,LW,2009
7783,19,28,Curtis Glencross,24,79,43,LW,2010
7784,22,29,Curtis Glencross,26,67,48,LW,2011
7785,11,30,Curtis Glencross,15,40,26,LW,2012
7786,12,31,Curtis Glencross,12,38,24,LW,2013
7787,22,32,Curtis Glencross,13,71,35,LW,2014
7788,0,23,Curtis Hamilton,0,1,0,LW,2014
7789,9,19,Curtis Lazar,6,67,15,C,2014
7790,14,20,Curtis Lazar,6,76,20,RW,2015
7791,2,21,Curtis Lazar,1,4,3,RW,2016
7792,10,22,Curtis Lazar,2,65,12,RW,2017
7793,9,19,Curtis Leschyshyn,4,71,13,D,1988
7794,6,20,Curtis Leschyshyn,2,68,8,D,1989
7795,7,21,Curtis Leschyshyn,3,55,10,D,1990
7796,12,22,Curtis Leschyshyn,5,42,17,D,1991
7797,23,23,Curtis Leschyshyn,9,82,32,D,1992
7798,17,24,Curtis Leschyshyn,5,72,22,D,1993
7799,13,25,Curtis Leschyshyn,2,44,15,D,1994
7800,15,26,Curtis Leschyshyn,4,77,19,D,1995
7801,18,27,Curtis Leschyshyn,4,77,22,D,1996
7802,10,28,Curtis Leschyshyn,2,73,12,D,1997
7803,7,29,Curtis Leschyshyn,2,65,9,D,1998
7804,2,30,Curtis Leschyshyn,0,53,2,D,1999
7805,7,31,Curtis Leschyshyn,2,65,9,D,2000
7806,9,32,Curtis Leschyshyn,1,79,10,D,2001
7807,6,33,Curtis Leschyshyn,1,54,7,D,2002
7808,4,34,Curtis Leschyshyn,1,56,5,D,2003
7809,1,23,Curtis McKenzie,4,36,5,LW,2014
7810,0,24,Curtis McKenzie,0,3,0,LW,2015
7811,10,25,Curtis McKenzie,6,53,16,LW,2016
7812,2,26,Curtis McKenzie,0,7,2,LW,2017
7813,0,27,Curtis Murphy,0,1,0,D,2002
7814,0,24,Curtis Valk,0,1,0,LW,2017
7815,1,23,D.J. King,1,27,2,LW,2006
7816,3,24,D.J. King,3,61,6,LW,2007
7817,1,25,D.J. King,0,1,1,LW,2008
7818,0,26,D.J. King,0,12,0,LW,2009
7819,2,27,D.J. King,0,16,2,LW,2010
7820,0,28,D.J. King,0,1,0,LW,2011
7821,1,19,D.J. Smith,0,8,1,D,1996
7822,0,22,D.J. Smith,0,3,0,D,1999
7823,0,25,D.J. Smith,1,34,1,D,2002
7824,13,18,Dainius Zubrus,8,68,21,LW,1996
7825,25,19,Dainius Zubrus,8,69,33,RW,1997
7826,10,20,Dainius Zubrus,6,80,16,RW,1998
7827,28,21,Dainius Zubrus,14,73,42,RW,1999
7828,13,22,Dainius Zubrus,13,61,26,RW,2000
7829,26,23,Dainius Zubrus,17,71,43,RW,2001
7830,22,24,Dainius Zubrus,13,63,35,C,2002
7831,15,25,Dainius Zubrus,12,54,27,C,2003
7832,34,27,Dainius Zubrus,23,71,57,RW,2005
7833,36,28,Dainius Zubrus,24,79,60,RW,2006
7834,25,29,Dainius Zubrus,13,82,38,C,2007
7835,25,30,Dainius Zubrus,15,82,40,C,2008
7836,17,31,Dainius Zubrus,10,51,27,RW,2009
7837,17,32,Dainius Zubrus,13,79,30,RW,2010
7838,27,33,Dainius Zubrus,17,82,44,RW,2011
7839,7,34,Dainius Zubrus,2,22,9,RW,2012
7840,13,35,Dainius Zubrus,13,82,26,C,2013
7841,6,36,Dainius Zubrus,4,74,10,C,2014
7842,4,37,Dainius Zubrus,3,50,7,C,2015
7843,0,24,Dakota Mermis,0,9,0,D,2017
7844,0,22,Dale Clarke,0,3,0,D,2000
7845,11,20,Dale Craigwell,5,32,16,C,1991
7846,1,21,Dale Craigwell,3,8,4,C,1992
7847,6,22,Dale Craigwell,3,58,9,C,1993
7848,0,22,Dale DeGray,0,1,0,D,1985
7849,7,23,Dale DeGray,6,27,13,D,1986
7850,18,24,Dale DeGray,6,56,24,D,1987
7851,22,25,Dale DeGray,6,63,28,D,1988
7852,0,26,Dale DeGray,0,6,0,D,1989
7853,0,24,Dale Dunbar,0,1,0,D,1985
7854,0,27,Dale Dunbar,0,1,0,D,1988
7855,58,18,Dale Hawerchuk,45,80,103,C,1981
7856,51,19,Dale Hawerchuk,40,79,91,C,1982
7857,65,20,Dale Hawerchuk,37,80,102,C,1983
7858,77,21,Dale Hawerchuk,53,80,130,C,1984
7859,59,22,Dale Hawerchuk,46,80,105,C,1985
7860,53,23,Dale Hawerchuk,47,80,100,C,1986
7861,77,24,Dale Hawerchuk,44,80,121,C,1987
7862,55,25,Dale Hawerchuk,41,75,96,C,1988
7863,55,26,Dale Hawerchuk,26,79,81,C,1989
7864,58,27,Dale Hawerchuk,31,80,89,C,1990
7865,75,28,Dale Hawerchuk,23,77,98,C,1991
7866,80,29,Dale Hawerchuk,16,81,96,C,1992
7867,51,30,Dale Hawerchuk,35,81,86,C,1993
7868,11,31,Dale Hawerchuk,5,23,16,C,1994
7869,44,32,Dale Hawerchuk,17,82,61,RW,1995
7870,22,33,Dale Hawerchuk,12,51,34,C,1996
7871,1,20,Dale Henry,2,16,3,LW,1984
7872,3,21,Dale Henry,1,7,4,LW,1985
7873,3,22,Dale Henry,3,19,6,LW,1986
7874,15,23,Dale Henry,5,48,20,LW,1987
7875,2,24,Dale Henry,2,22,4,LW,1988
7876,2,25,Dale Henry,0,20,2,LW,1989
7877,7,20,Dale Hoganson,1,49,8,D,1969
7878,10,21,Dale Hoganson,4,70,14,D,1970
7879,2,22,Dale Hoganson,1,31,3,D,1971
7880,2,23,Dale Hoganson,0,25,2,D,1972
7881,33,24,Dale Hoganson,8,62,41,D,1973
7882,33,24,Dale Hoganson,8,62,41,D,1973
7883,35,25,Dale Hoganson,9,78,44,D,1974
7884,35,25,Dale Hoganson,9,78,44,D,1974
7885,14,26,Dale Hoganson,3,45,17,D,1975
7886,14,26,Dale Hoganson,3,45,17,D,1975
7887,48,27,Dale Hoganson,7,81,55,D,1976
7888,12,28,Dale Hoganson,1,43,13,D,1977
7889,19,29,Dale Hoganson,2,69,21,D,1978
7890,19,29,Dale Hoganson,2,69,21,D,1978
7891,36,30,Dale Hoganson,4,77,40,D,1979
7892,14,31,Dale Hoganson,3,61,17,D,1980
7893,6,32,Dale Hoganson,0,30,6,D,1981
7894,44,20,Dale Hunter,19,80,63,C,1980
7895,50,21,Dale Hunter,22,80,72,C,1981
7896,46,22,Dale Hunter,17,80,63,C,1982
7897,55,23,Dale Hunter,24,77,79,C,1983
7898,52,24,Dale Hunter,20,80,72,C,1984
7899,42,25,Dale Hunter,28,80,70,C,1985
7900,29,26,Dale Hunter,10,46,39,C,1986
7901,37,27,Dale Hunter,22,79,59,C,1987
7902,37,28,Dale Hunter,20,80,57,C,1988
7903,39,29,Dale Hunter,23,80,62,C,1989
7904,30,30,Dale Hunter,16,76,46,C,1990
7905,50,31,Dale Hunter,28,80,78,C,1991
7906,59,32,Dale Hunter,20,84,79,C,1992
7907,29,33,Dale Hunter,9,52,38,C,1993
7908,15,34,Dale Hunter,8,45,23,C,1994
7909,24,35,Dale Hunter,13,82,37,C,1995
7910,32,36,Dale Hunter,14,82,46,C,1996
7911,18,37,Dale Hunter,8,82,26,C,1997
7912,9,38,Dale Hunter,2,62,11,C,1998
7913,0,25,Dale Krentz,0,8,0,LW,1986
7914,0,26,Dale Krentz,2,6,2,LW,1987
7915,3,27,Dale Krentz,3,16,6,LW,1988
7916,0,23,Dale Kushner,0,2,0,LW,1989
7917,11,24,Dale Kushner,7,63,18,RW,1990
7918,2,25,Dale Kushner,3,19,5,LW,1991
7919,0,23,Dale Lewis,0,8,0,LW,1975
7920,39,21,Dale McCourt,33,76,72,C,1977
7921,43,22,Dale McCourt,28,79,71,C,1978
7922,51,23,Dale McCourt,30,80,81,C,1979
7923,56,24,Dale McCourt,30,80,86,C,1980
7924,36,25,Dale McCourt,33,78,69,C,1981
7925,32,26,Dale McCourt,20,62,52,C,1982
7926,27,27,Dale McCourt,20,77,47,C,1983
7927,0,22,Dale McMullin,0,1,0,LW,1977
7928,0,22,Dale McMullin,0,1,0,LW,1977
7929,2,24,Dale McTavish,1,9,3,C,1996
7930,0,23,Dale Purinton,0,1,0,D,1999
7931,2,24,Dale Purinton,0,42,2,D,2000
7932,4,25,Dale Purinton,0,40,4,D,2001
7933,9,26,Dale Purinton,3,58,12,D,2002
7934,1,27,Dale Purinton,1,40,2,D,2003
7935,13,27,Dale Rolfe,3,68,16,D,1967
7936,19,28,Dale Rolfe,3,75,22,D,1968
7937,18,29,Dale Rolfe,3,75,21,D,1969
7938,16,30,Dale Rolfe,3,58,19,D,1970
7939,14,31,Dale Rolfe,2,68,16,D,1971
7940,25,32,Dale Rolfe,7,72,32,D,1972
7941,12,33,Dale Rolfe,3,48,15,D,1973
7942,8,34,Dale Rolfe,1,42,9,D,1974
7943,1,24,Dale Rominski,0,3,1,RW,1999
7944,0,21,Dale Smedsmo,0,4,0,LW,1972
7945,14,24,Dale Smedsmo,8,66,22,LW,1975
7946,14,24,Dale Smedsmo,8,66,22,LW,1975
7947,5,25,Dale Smedsmo,2,38,7,LW,1976
7948,5,25,Dale Smedsmo,2,38,7,LW,1976
7949,3,26,Dale Smedsmo,0,6,3,LW,1977
7950,3,26,Dale Smedsmo,0,6,3,LW,1977
7951,42,20,Dale Tallon,14,78,56,D,1970
7952,27,21,Dale Tallon,17,69,44,D,1971
7953,24,22,Dale Tallon,13,75,37,D,1972
7954,19,23,Dale Tallon,15,65,34,C,1973
7955,10,24,Dale Tallon,5,35,15,D,1974
7956,47,25,Dale Tallon,15,80,62,D,1975
7957,16,26,Dale Tallon,5,70,21,D,1976
7958,20,27,Dale Tallon,4,75,24,D,1977
7959,24,28,Dale Tallon,5,63,29,D,1978
7960,9,29,Dale Tallon,5,32,14,D,1979
7961,0,22,Dale Weise,0,10,0,RW,2010
7962,4,23,Dale Weise,4,68,8,RW,2011
7963,3,24,Dale Weise,3,40,6,RW,2012
7964,10,25,Dale Weise,6,61,16,RW,2013
7965,19,26,Dale Weise,10,79,29,RW,2014
7966,13,27,Dale Weise,14,71,27,RW,2015
7967,7,28,Dale Weise,8,64,15,RW,2016
7968,4,29,Dale Weise,4,46,8,RW,2017
7969,0,20,Dale Yakiwchuk,0,4,0,LW,1978
7970,0,20,Dale Yakiwchuk,0,4,0,LW,1978
7971,26,23,Dallas Drake,18,72,44,LW,1992
7972,27,24,Dallas Drake,13,62,40,LW,1993
7973,18,25,Dallas Drake,8,43,26,RW,1994
7974,20,26,Dallas Drake,19,69,39,RW,1995
7975,19,27,Dallas Drake,17,63,36,LW,1996
7976,29,28,Dallas Drake,11,60,40,RW,1997
7977,22,29,Dallas Drake,9,53,31,RW,1998
7978,30,30,Dallas Drake,15,79,45,RW,1999
7979,29,31,Dallas Drake,12,82,41,LW,2000
7980,15,32,Dallas Drake,11,80,26,LW,2001
7981,10,33,Dallas Drake,20,80,30,LW,2002
7982,22,34,Dallas Drake,13,79,35,LW,2003
7983,24,36,Dallas Drake,2,62,26,LW,2005
7984,6,37,Dallas Drake,6,60,12,RW,2006
7985,3,38,Dallas Drake,3,65,6,RW,2007
7986,2,25,Dallas Eakins,0,14,2,D,1992
7987,0,26,Dallas Eakins,0,1,0,D,1993
7988,1,27,Dallas Eakins,0,17,1,D,1994
7989,1,28,Dallas Eakins,0,18,1,D,1995
7990,0,29,Dallas Eakins,0,7,0,D,1996
7991,1,30,Dallas Eakins,0,23,1,D,1997
7992,2,31,Dallas Eakins,0,18,2,D,1998
7993,1,32,Dallas Eakins,0,2,1,D,1999
7994,1,33,Dallas Eakins,0,17,1,D,2000
7995,0,34,Dallas Eakins,0,3,0,D,2001
7996,1,25,Dallas Gaume,1,4,2,C,1988
7997,23,26,Dallas Smith,4,74,27,D,1967
7998,24,27,Dallas Smith,4,75,28,D,1968
7999,17,28,Dallas Smith,7,75,24,D,1969
8000,38,29,Dallas Smith,7,73,45,D,1970
8001,22,30,Dallas Smith,8,78,30,D,1971
8002,27,31,Dallas Smith,4,78,31,D,1972
8003,21,32,Dallas Smith,6,77,27,D,1973
8004,20,33,Dallas Smith,3,79,23,D,1974
8005,25,34,Dallas Smith,7,77,32,D,1975
8006,20,35,Dallas Smith,2,58,22,D,1976
8007,4,36,Dallas Smith,1,29,5,D,1977
8008,0,21,Dalton Prout,0,5,0,D,2011
8009,6,22,Dalton Prout,1,28,7,D,2012
8010,4,23,Dalton Prout,2,49,6,D,2013
8011,8,24,Dalton Prout,0,63,8,D,2014
8012,6,25,Dalton Prout,3,64,9,D,2015
8013,3,26,Dalton Prout,0,14,3,D,2016
8014,0,27,Dalton Prout,0,4,0,D,2017
8015,0,22,Damian Surma,1,1,1,C,2002
8016,1,23,Damian Surma,0,1,1,LW,2003
8017,14,26,Damien Brunner,12,44,26,C,2012
8018,14,27,Damien Brunner,11,60,25,RW,2013
8019,5,28,Damien Brunner,2,17,7,RW,2014
8020,12,20,Damon Severson,5,51,17,D,2014
8021,20,21,Damon Severson,1,72,21,D,2015
8022,28,22,Damon Severson,3,80,31,D,2016
8023,15,23,Damon Severson,9,76,24,D,2017
8024,15,24,Dan Bonar,11,71,26,C,1980
8025,23,25,Dan Bonar,13,79,36,C,1981
8026,1,26,Dan Bonar,1,20,2,C,1982
8027,9,19,Dan Bourbonnais,3,24,12,LW,1981
8028,16,21,Dan Bourbonnais,0,35,16,LW,1983
8029,5,22,Dan Boyle,3,22,8,D,1998
8030,3,23,Dan Boyle,0,13,3,D,1999
8031,18,24,Dan Boyle,4,69,22,D,2000
8032,18,25,Dan Boyle,8,66,26,D,2001
8033,40,26,Dan Boyle,13,77,53,D,2002
8034,30,27,Dan Boyle,9,78,39,D,2003
8035,38,29,Dan Boyle,15,79,53,D,2005
8036,43,30,Dan Boyle,20,82,63,D,2006
8037,21,31,Dan Boyle,4,37,25,D,2007
8038,41,32,Dan Boyle,16,77,57,D,2008
8039,43,33,Dan Boyle,15,76,58,D,2009
8040,41,34,Dan Boyle,9,76,50,D,2010
8041,39,35,Dan Boyle,9,81,48,D,2011
8042,13,36,Dan Boyle,7,46,20,D,2012
8043,24,37,Dan Boyle,12,75,36,D,2013
8044,11,38,Dan Boyle,9,65,20,D,2014
8045,14,39,Dan Boyle,10,74,24,D,2015
8046,0,21,Dan Brennan,0,2,0,LW,1983
8047,1,23,Dan Brennan,0,6,1,LW,1985
8048,0,25,Dan Bylsma,0,4,0,LW,1995
8049,6,26,Dan Bylsma,3,79,9,RW,1996
8050,9,27,Dan Bylsma,3,65,12,C,1997
8051,0,28,Dan Bylsma,0,8,0,RW,1998
8052,6,29,Dan Bylsma,3,64,9,LW,1999
8053,9,30,Dan Bylsma,1,82,10,LW,2000
8054,9,31,Dan Bylsma,8,77,17,RW,2001
8055,4,32,Dan Bylsma,1,39,5,RW,2002
8056,0,33,Dan Bylsma,0,11,0,RW,2003
8057,0,20,Dan Chicoine,0,6,0,RW,1977
8058,0,21,Dan Chicoine,0,1,0,RW,1978
8059,2,22,Dan Chicoine,1,24,3,RW,1979
8060,1,21,Dan Clark,0,4,1,D,1978
8061,0,19,Dan Cleary,0,6,0,LW,1997
8062,5,20,Dan Cleary,4,35,9,LW,1998
8063,2,21,Dan Cleary,3,17,5,LW,1999
8064,21,22,Dan Cleary,14,81,35,RW,2000
8065,19,23,Dan Cleary,10,65,29,RW,2001
8066,13,24,Dan Cleary,4,57,17,RW,2002
8067,11,25,Dan Cleary,6,68,17,LW,2003
8068,12,27,Dan Cleary,3,77,15,LW,2005
8069,20,28,Dan Cleary,20,71,40,RW,2006
8070,22,29,Dan Cleary,20,63,42,RW,2007
8071,26,30,Dan Cleary,14,74,40,RW,2008
8072,19,31,Dan Cleary,15,64,34,LW,2009
8073,20,32,Dan Cleary,26,68,46,LW,2010
8074,21,33,Dan Cleary,12,75,33,LW,2011
8075,6,34,Dan Cleary,9,48,15,LW,2012
8076,4,35,Dan Cleary,4,52,8,RW,2013
8077,0,22,Dan Currie,0,5,0,LW,1990
8078,0,23,Dan Currie,1,7,1,LW,1991
8079,0,24,Dan Currie,0,5,0,LW,1992
8080,1,25,Dan Currie,1,5,2,C,1993
8081,34,22,Dan Daoust,18,52,52,C,1982
8082,56,23,Dan Daoust,18,78,74,C,1983
8083,37,24,Dan Daoust,17,79,54,C,1984
8084,13,25,Dan Daoust,7,80,20,C,1985
8085,3,26,Dan Daoust,4,33,7,C,1986
8086,8,27,Dan Daoust,9,67,17,C,1987
8087,5,28,Dan Daoust,7,68,12,C,1988
8088,11,29,Dan Daoust,7,65,18,C,1989
8089,1,22,Dan Dorion,1,3,2,C,1985
8090,0,24,Dan Dorion,0,1,0,RW,1987
8091,0,24,Dan Focht,0,8,0,D,2001
8092,3,25,Dan Focht,0,22,3,D,2002
8093,3,26,Dan Focht,2,52,5,D,2003
8094,0,21,Dan Frawley,0,3,0,RW,1983
8095,3,22,Dan Frawley,4,30,7,RW,1984
8096,11,23,Dan Frawley,10,69,21,RW,1985
8097,14,24,Dan Frawley,14,78,28,RW,1986
8098,8,25,Dan Frawley,6,47,14,RW,1987
8099,4,26,Dan Frawley,3,46,7,RW,1988
8100,1,22,Dan Fridgen,0,2,1,LW,1981
8101,2,23,Dan Fridgen,2,11,4,LW,1982
8102,0,18,Dan Fritsche,1,19,1,C,2003
8103,7,20,Dan Fritsche,6,59,13,RW,2005
8104,15,21,Dan Fritsche,12,59,27,C,2006
8105,12,22,Dan Fritsche,10,69,22,C,2007
8106,8,23,Dan Fritsche,5,50,13,C,2008
8107,6,22,Dan Girardi,0,34,6,D,2006
8108,18,23,Dan Girardi,10,82,28,D,2007
8109,18,24,Dan Girardi,4,82,22,D,2008
8110,18,25,Dan Girardi,6,82,24,D,2009
8111,27,26,Dan Girardi,4,80,31,D,2010
8112,24,27,Dan Girardi,5,82,29,D,2011
8113,12,28,Dan Girardi,2,46,14,D,2012
8114,19,29,Dan Girardi,5,81,24,D,2013
8115,16,30,Dan Girardi,4,82,20,D,2014
8116,15,31,Dan Girardi,2,74,17,D,2015
8117,11,32,Dan Girardi,4,63,15,D,2016
8118,12,33,Dan Girardi,6,77,18,D,2017
8119,0,21,Dan Gloor,0,2,0,C,1973
8120,0,21,Dan Gratton,1,7,1,C,1987
8121,19,21,Dan Hamhuis,7,80,26,D,2003
8122,31,23,Dan Hamhuis,7,82,38,D,2005
8123,14,24,Dan Hamhuis,6,81,20,D,2006
8124,23,25,Dan Hamhuis,4,80,27,D,2007
8125,23,26,Dan Hamhuis,3,82,26,D,2008
8126,19,27,Dan Hamhuis,5,78,24,D,2009
8127,17,28,Dan Hamhuis,6,64,23,D,2010
8128,33,29,Dan Hamhuis,4,82,37,D,2011
8129,20,30,Dan Hamhuis,4,47,24,D,2012
8130,17,31,Dan Hamhuis,5,79,22,D,2013
8131,22,32,Dan Hamhuis,1,59,23,D,2014
8132,10,33,Dan Hamhuis,3,58,13,D,2015
8133,15,34,Dan Hamhuis,1,79,16,D,2016
8134,21,35,Dan Hamhuis,3,80,24,D,2017
8135,3,23,Dan Hinote,1,27,4,RW,1999
8136,10,24,Dan Hinote,5,76,15,C,2000
8137,6,25,Dan Hinote,6,58,12,C,2001
8138,4,26,Dan Hinote,6,60,10,C,2002
8139,7,27,Dan Hinote,4,59,11,RW,2003
8140,8,29,Dan Hinote,5,73,13,C,2005
8141,5,30,Dan Hinote,5,41,10,RW,2006
8142,5,31,Dan Hinote,5,58,10,RW,2007
8143,4,32,Dan Hinote,1,51,5,RW,2008
8144,0,23,Dan Hinton,0,14,0,LW,1976
8145,12,20,Dan Hodgson,13,40,25,C,1985
8146,13,21,Dan Hodgson,9,43,22,C,1986
8147,7,22,Dan Hodgson,3,8,10,C,1987
8148,13,23,Dan Hodgson,4,23,17,C,1988
8149,0,24,Dan Jancevski,0,2,0,D,2005
8150,0,26,Dan Jancevski,0,4,0,D,2007
8151,0,27,Dan Jancevski,0,3,0,D,2008
8152,0,20,Dan Justin,0,17,0,D,1975
8153,0,20,Dan Justin,0,17,0,D,1975
8154,2,21,Dan Justin,0,6,2,D,1976
8155,2,21,Dan Justin,0,6,2,D,1976
8156,1,22,Dan Keczmer,0,9,1,D,1990
8157,0,23,Dan Keczmer,0,1,0,D,1991
8158,4,24,Dan Keczmer,4,23,8,D,1992
8159,21,25,Dan Keczmer,1,69,22,D,1993
8160,3,26,Dan Keczmer,2,28,5,D,1994
8161,0,27,Dan Keczmer,0,13,0,D,1995
8162,1,28,Dan Keczmer,0,13,1,D,1996
8163,2,29,Dan Keczmer,1,17,3,D,1997
8164,1,30,Dan Keczmer,0,38,1,D,1998
8165,5,31,Dan Keczmer,0,24,5,D,1999
8166,4,22,Dan Kesa,2,19,6,RW,1993
8167,0,24,Dan Kesa,0,3,0,RW,1995
8168,8,27,Dan Kesa,2,67,10,RW,1998
8169,10,28,Dan Kesa,4,50,14,C,1999
8170,3,20,Dan Kordic,1,46,4,D,1991
8171,0,22,Dan Kordic,0,4,0,D,1993
8172,0,24,Dan Kordic,1,9,1,D,1995
8173,4,25,Dan Kordic,1,75,5,LW,1996
8174,1,26,Dan Kordic,1,61,2,LW,1997
8175,0,27,Dan Kordic,0,2,0,LW,1998
8185,27,25,Dan Labraaten,24,64,51,LW,1976
8186,27,25,Dan Labraaten,24,64,51,LW,1976
8187,16,26,Dan Labraaten,18,47,34,LW,1977
8188,16,26,Dan Labraaten,18,47,34,LW,1977
8189,19,27,Dan Labraaten,19,78,38,LW,1978
8190,27,28,Dan Labraaten,30,76,57,LW,1979
8191,15,29,Dan Labraaten,12,71,27,LW,1980
8192,12,30,Dan Labraaten,10,43,22,LW,1981
8176,0,21,Dan LaCouture,0,3,0,LW,1998
8177,0,22,Dan LaCouture,0,5,0,LW,1999
8178,4,23,Dan LaCouture,2,48,6,LW,2000
8179,11,24,Dan LaCouture,6,82,17,LW,2001
8180,6,25,Dan LaCouture,3,68,9,LW,2002
8181,2,26,Dan LaCouture,5,59,7,LW,2003
8182,2,28,Dan LaCouture,2,55,4,LW,2005
8183,0,29,Dan LaCouture,0,6,0,LW,2006
8184,0,31,Dan LaCouture,2,11,2,LW,2008
8193,0,21,Dan Lambert,0,1,0,D,1990
8194,9,22,Dan Lambert,6,28,15,D,1991
8195,18,26,Dan Lodboa,15,58,33,LW,1972
8196,18,26,Dan Lodboa,15,58,33,LW,1972
8197,14,20,Dan Maloney,12,74,26,LW,1970
8198,24,22,Dan Maloney,17,71,41,LW,1972
8199,17,23,Dan Maloney,15,65,32,LW,1973
8200,39,24,Dan Maloney,27,80,66,LW,1974
8201,39,25,Dan Maloney,27,77,66,LW,1975
8202,13,26,Dan Maloney,13,34,26,LW,1976
8203,33,27,Dan Maloney,19,79,52,LW,1977
8204,36,28,Dan Maloney,17,77,53,LW,1978
8205,16,29,Dan Maloney,17,71,33,LW,1979
8206,21,30,Dan Maloney,20,65,41,LW,1980
8207,7,31,Dan Maloney,8,44,15,LW,1981
8208,4,22,Dan Mandich,3,67,7,D,1982
8209,7,23,Dan Mandich,2,31,9,D,1983
8210,0,24,Dan Mandich,0,10,0,D,1984
8211,0,25,Dan Mandich,0,3,0,D,1985
8212,0,22,Dan McCarthy,4,5,4,C,1980
8213,0,21,Dan McFall,0,2,0,D,1984
8214,1,22,Dan McFall,0,7,1,D,1985
8215,16,24,Dan McGillis,6,73,22,D,1996
8216,20,25,Dan McGillis,11,80,31,D,1997
8217,37,26,Dan McGillis,8,78,45,D,1998
8218,14,27,Dan McGillis,4,68,18,D,1999
8219,35,28,Dan McGillis,14,82,49,D,2000
8220,14,29,Dan McGillis,5,75,19,D,2001
8221,17,30,Dan McGillis,3,71,20,D,2002
8222,23,31,Dan McGillis,5,80,28,D,2003
8223,6,33,Dan McGillis,0,27,6,D,2005
8224,8,25,Dan Newman,9,41,17,LW,1976
8225,13,26,Dan Newman,5,59,18,LW,1977
8226,2,27,Dan Newman,0,16,2,LW,1978
8227,1,28,Dan Newman,3,10,4,LW,1979
8228,1,22,Dan Plante,0,12,1,RW,1993
8229,3,24,Dan Plante,5,73,8,LW,1995
8230,9,25,Dan Plante,4,67,13,RW,1996
8231,1,26,Dan Plante,0,7,1,RW,1997
8232,33,18,Dan Quinn,19,54,52,C,1983
8233,38,19,Dan Quinn,20,74,58,C,1984
8234,42,20,Dan Quinn,30,78,72,C,1985
8235,49,21,Dan Quinn,31,80,80,C,1986
8236,39,22,Dan Quinn,40,70,79,C,1987
8237,60,23,Dan Quinn,34,79,94,C,1988
8238,38,24,Dan Quinn,25,78,63,C,1989
8239,38,25,Dan Quinn,22,78,60,C,1990
8240,26,26,Dan Quinn,11,67,37,C,1991
8241,4,27,Dan Quinn,0,11,4,C,1992
8242,0,28,Dan Quinn,7,13,7,RW,1993
8243,17,29,Dan Quinn,14,44,31,C,1994
8244,32,30,Dan Quinn,13,63,45,C,1995
8245,3,31,Dan Quinn,0,16,3,C,1996
8246,1,22,Dan Ratushny,0,1,1,D,1992
8247,0,22,Dan Renouf,0,1,0,D,2016
8248,6,22,Dan Seguin,1,36,7,LW,1970
8249,0,25,Dan Seguin,1,1,1,LW,1973
8250,10,22,Dan Sexton,9,41,19,RW,2009
8251,9,23,Dan Sexton,4,47,13,RW,2010
8252,0,22,Dan Smith,0,12,0,D,1998
8253,0,23,Dan Smith,0,3,0,D,1999
8254,0,29,Dan Smith,0,7,0,D,2005
8255,0,22,Dan Snyder,0,2,0,C,2000
8256,1,23,Dan Snyder,1,11,2,C,2001
8257,4,24,Dan Snyder,10,36,14,C,2002
8258,16,22,Dan Spring,8,66,24,C,1973
8259,16,22,Dan Spring,8,66,24,C,1973
8260,24,23,Dan Spring,19,60,43,C,1974
8261,24,23,Dan Spring,19,60,43,C,1974
8262,11,24,Dan Spring,12,75,23,C,1975
8263,11,24,Dan Spring,12,75,23,C,1975
8264,3,22,Dan Trebil,3,29,6,D,1996
8265,1,23,Dan Trebil,0,21,1,D,1997
8266,0,24,Dan Trebil,0,6,0,D,1998
8267,0,25,Dan Trebil,1,3,1,D,1999
8268,0,26,Dan Trebil,0,26,0,D,2000
8269,11,20,Dan Vincelette,6,69,17,LW,1987
8270,4,21,Dan Vincelette,11,66,15,LW,1988
8271,1,22,Dan Vincelette,0,13,1,LW,1989
8272,1,23,Dan Vincelette,0,16,1,LW,1990
8273,5,24,Dan Vincelette,3,29,8,LW,1991
8274,0,20,Dan Woodley,2,5,2,C,1987
8275,23,19,Dana Murzyn,3,78,26,D,1985
8276,19,20,Dana Murzyn,9,74,28,D,1986
8277,11,21,Dana Murzyn,7,74,18,D,1987
8278,19,22,Dana Murzyn,3,63,22,D,1988
8279,13,23,Dana Murzyn,7,78,20,D,1989
8280,2,24,Dana Murzyn,1,29,3,D,1990
8281,11,25,Dana Murzyn,3,70,14,D,1991
8282,11,26,Dana Murzyn,5,79,16,D,1992
8283,14,27,Dana Murzyn,6,80,20,D,1993
8284,8,28,Dana Murzyn,0,40,8,D,1994
8285,10,29,Dana Murzyn,2,69,12,D,1995
8286,7,30,Dana Murzyn,1,61,8,D,1996
8287,2,31,Dana Murzyn,5,31,7,D,1997
8288,2,32,Dana Murzyn,0,12,2,D,1998
8289,9,21,Dana Tyrell,6,78,15,C,2010
8290,5,22,Dana Tyrell,0,26,5,C,2011
8291,3,23,Dana Tyrell,1,21,4,C,2012
8292,0,24,Dana Tyrell,0,7,0,C,2013
8293,0,25,Dana Tyrell,0,3,0,C,2014
8294,0,21,Dane Byers,0,1,0,LW,2007
8295,0,23,Dane Byers,1,5,1,LW,2009
8296,0,25,Dane Byers,0,8,0,LW,2011
8297,1,23,Dane Jackson,5,12,6,RW,1993
8298,0,24,Dane Jackson,1,3,1,RW,1994
8299,4,25,Dane Jackson,5,22,9,RW,1995
8300,1,27,Dane Jackson,1,8,2,RW,1997
8301,0,23,Danick Martel,0,4,0,LW,2017
8302,35,23,Daniel Alfredsson,26,82,61,RW,1995
8303,47,24,Daniel Alfredsson,24,76,71,RW,1996
8304,28,25,Daniel Alfredsson,17,55,45,RW,1997
8305,22,26,Daniel Alfredsson,11,58,33,RW,1998
8306,38,27,Daniel Alfredsson,21,57,59,RW,1999
8307,46,28,Daniel Alfredsson,24,68,70,RW,2000
8308,34,29,Daniel Alfredsson,37,78,71,RW,2001
8309,51,30,Daniel Alfredsson,27,78,78,RW,2002
8310,48,31,Daniel Alfredsson,32,77,80,RW,2003
8311,60,33,Daniel Alfredsson,43,77,103,RW,2005
8312,58,34,Daniel Alfredsson,29,77,87,RW,2006
8313,49,35,Daniel Alfredsson,40,70,89,RW,2007
8314,50,36,Daniel Alfredsson,24,79,74,RW,2008
8315,51,37,Daniel Alfredsson,20,70,71,RW,2009
8316,17,38,Daniel Alfredsson,14,54,31,RW,2010
8317,32,39,Daniel Alfredsson,27,75,59,RW,2011
8318,16,40,Daniel Alfredsson,10,47,26,RW,2012
8319,31,41,Daniel Alfredsson,18,68,49,RW,2013
8320,2,25,Daniel Bang,0,8,2,RW,2012
8321,1,22,Daniel Brickley,0,1,1,D,2017
8322,0,20,Daniel Briere,1,5,1,C,1997
8323,14,21,Daniel Briere,8,64,22,C,1998
8324,1,22,Daniel Briere,1,13,2,C,1999
8325,4,23,Daniel Briere,11,30,15,C,2000
8326,28,24,Daniel Briere,32,78,60,C,2001
8327,34,25,Daniel Briere,24,82,58,C,2002
8328,37,26,Daniel Briere,28,82,65,C,2003
8329,33,28,Daniel Briere,25,48,58,C,2005
8330,63,29,Daniel Briere,32,81,95,C,2006
8331,41,30,Daniel Briere,31,79,72,C,2007
8332,14,31,Daniel Briere,11,29,25,C,2008
8333,27,32,Daniel Briere,26,75,53,C,2009
8334,34,33,Daniel Briere,34,77,68,C,2010
8335,33,34,Daniel Briere,16,70,49,C,2011
8336,10,35,Daniel Briere,6,34,16,C,2012
8337,12,36,Daniel Briere,13,69,25,C,2013
8338,4,37,Daniel Briere,8,57,12,C,2014
8339,3,22,Daniel Carcillo,4,18,7,LW,2006
8340,11,23,Daniel Carcillo,13,57,24,LW,2007
8341,11,24,Daniel Carcillo,3,74,14,LW,2008
8342,10,25,Daniel Carcillo,12,76,22,LW,2009
8343,2,26,Daniel Carcillo,4,57,6,LW,2010
8344,9,27,Daniel Carcillo,2,28,11,LW,2011
8345,1,28,Daniel Carcillo,2,23,3,LW,2012
8346,1,29,Daniel Carcillo,4,57,5,LW,2013
8347,4,30,Daniel Carcillo,4,39,8,LW,2014
8348,3,24,Daniel Carr,6,23,9,LW,2015
8349,7,25,Daniel Carr,2,33,9,LW,2016
8350,10,26,Daniel Carr,6,38,16,LW,2017
8351,0,22,Daniel Catenacci,0,11,0,C,2015
8352,0,24,Daniel Catenacci,0,1,0,C,2017
8353,1,36,Daniel Cleary,1,17,2,RW,2014
8354,3,22,Daniel Corso,10,28,13,C,2000
8355,7,23,Daniel Corso,4,41,11,C,2001
8356,0,24,Daniel Corso,0,1,0,C,2002
8357,1,25,Daniel Corso,0,7,1,C,2003
8358,3,19,Daniel Dore,2,16,5,RW,1989
8359,0,20,Daniel Dore,0,1,0,RW,1990
8360,0,24,Daniel Gauthier,0,5,0,LW,1994
8361,3,21,Daniel Goneau,10,41,13,LW,1996
8362,0,22,Daniel Goneau,2,11,2,LW,1997
8363,0,24,Daniel Goneau,0,1,0,LW,1999
8364,0,20,Daniel Guerard,0,2,0,RW,1994
8365,0,24,Daniel Lacroix,0,4,0,C,1993
8366,0,25,Daniel Lacroix,1,24,1,C,1994
8367,2,26,Daniel Lacroix,2,25,4,LW,1995
8368,1,27,Daniel Lacroix,7,74,8,C,1996
8369,4,28,Daniel Lacroix,1,56,5,C,1997
8370,0,29,Daniel Lacroix,0,4,0,LW,1998
8371,0,30,Daniel Lacroix,0,1,0,C,1999
8372,1,23,Daniel Laperriere,0,5,1,D,1992
8373,3,24,Daniel Laperriere,1,20,4,D,1993
8374,1,25,Daniel Laperriere,1,17,2,D,1994
8375,0,26,Daniel Laperriere,0,6,0,D,1995
8376,23,20,Daniel Marois,31,76,54,RW,1988
8377,37,21,Daniel Marois,39,68,76,RW,1989
8378,9,22,Daniel Marois,21,78,30,RW,1990
8379,16,23,Daniel Marois,17,75,33,RW,1991
8380,5,24,Daniel Marois,2,28,7,RW,1992
8381,3,25,Daniel Marois,7,22,10,LW,1993
8382,0,27,Daniel Marois,0,3,0,RW,1995
8383,0,23,Daniel O'Regan,1,3,1,C,2016
8384,0,24,Daniel O'Regan,0,2,0,C,2017
8385,2,21,Daniel Paille,1,14,3,LW,2005
8386,8,22,Daniel Paille,3,29,11,LW,2006
8387,16,23,Daniel Paille,19,77,35,LW,2007
8388,15,24,Daniel Paille,12,73,27,LW,2008
8389,10,25,Daniel Paille,10,76,20,LW,2009
8390,7,26,Daniel Paille,6,43,13,LW,2010
8391,6,27,Daniel Paille,9,69,15,LW,2011
8392,7,28,Daniel Paille,10,46,17,LW,2012
8393,9,29,Daniel Paille,9,72,18,LW,2013
8394,7,30,Daniel Paille,6,71,13,LW,2014
8395,0,31,Daniel Paille,0,12,0,LW,2015
8396,5,21,Daniel Poudrier,1,13,6,D,1985
8397,0,22,Daniel Poudrier,0,6,0,D,1986
8398,0,23,Daniel Poudrier,0,6,0,D,1987
8399,1,24,Daniel Poulin,1,3,2,D,1981
8400,14,20,Daniel Sedin,20,75,34,C,2000
8401,23,21,Daniel Sedin,9,79,32,LW,2001
8402,17,22,Daniel Sedin,14,79,31,LW,2002
8403,36,23,Daniel Sedin,18,82,54,LW,2003
8404,49,25,Daniel Sedin,22,82,71,LW,2005
8405,48,26,Daniel Sedin,36,81,84,LW,2006
8406,45,27,Daniel Sedin,29,82,74,LW,2007
8407,51,28,Daniel Sedin,31,82,82,LW,2008
8408,56,29,Daniel Sedin,29,63,85,LW,2009
8409,63,30,Daniel Sedin,41,82,104,LW,2010
8410,37,31,Daniel Sedin,30,72,67,LW,2011
8411,28,32,Daniel Sedin,12,47,40,LW,2012
8412,31,33,Daniel Sedin,16,73,47,LW,2013
8413,56,34,Daniel Sedin,20,82,76,LW,2014
8414,33,35,Daniel Sedin,28,82,61,LW,2015
8415,29,36,Daniel Sedin,15,82,44,LW,2016
8416,32,37,Daniel Sedin,23,81,55,LW,2017
8417,13,22,Daniel Shank,11,57,24,RW,1989
8418,1,23,Daniel Shank,0,7,1,RW,1990
8419,0,24,Daniel Shank,2,13,2,RW,1991
8420,0,18,Daniel Sprong,2,18,2,RW,2015
8421,1,20,Daniel Sprong,2,8,3,RW,2017
8422,16,25,Daniel Tjarnqvist,2,75,18,D,2001
8423,12,26,Daniel Tjarnqvist,3,75,15,D,2002
8424,15,27,Daniel Tjarnqvist,5,68,20,D,2003
8425,15,29,Daniel Tjarnqvist,3,60,18,D,2005
8426,12,30,Daniel Tjarnqvist,3,37,15,D,2006
8427,2,32,Daniel Tjarnqvist,2,37,4,D,2008
8428,7,21,Daniel Tkaczuk,4,19,11,C,2000
8429,15,22,Daniel Winnik,11,79,26,C,2007
8430,4,23,Daniel Winnik,3,49,7,C,2008
8431,15,24,Daniel Winnik,4,74,19,C,2009
8432,15,25,Daniel Winnik,11,80,26,C,2010
8433,15,26,Daniel Winnik,8,84,23,C,2011
8434,13,27,Daniel Winnik,6,48,19,C,2012
8435,24,28,Daniel Winnik,6,76,30,C,2013
8436,25,29,Daniel Winnik,9,79,34,C,2014
8437,13,30,Daniel Winnik,6,76,19,C,2015
8438,13,31,Daniel Winnik,12,72,25,LW,2016
8439,17,32,Daniel Winnik,6,81,23,LW,2017
8440,1,23,Daniil Tarasov,0,5,1,RW,2014
8441,8,20,Danny Arndt,8,69,16,LW,1975
8442,8,20,Danny Arndt,8,69,16,LW,1975
8443,14,21,Danny Arndt,8,47,22,LW,1976
8444,14,21,Danny Arndt,8,47,22,LW,1976
8445,1,22,Danny Arndt,0,4,1,LW,1977
8446,1,22,Danny Arndt,0,4,1,LW,1977
8447,2,23,Danny Biega,0,10,2,D,2014
8448,0,23,Danny Bois,0,1,0,RW,2006
8449,5,22,Danny Bolduc,2,14,7,RW,1975
8450,5,22,Danny Bolduc,2,14,7,RW,1975
8451,3,23,Danny Bolduc,8,33,11,RW,1976
8452,3,23,Danny Bolduc,8,33,11,RW,1976
8453,5,24,Danny Bolduc,5,41,10,RW,1977
8454,5,24,Danny Bolduc,5,41,10,RW,1977
8455,13,25,Danny Bolduc,16,56,29,RW,1978
8456,5,26,Danny Bolduc,6,44,11,RW,1979
8457,1,30,Danny Bolduc,0,2,1,LW,1983
8458,1,22,Danny DeKeyser,0,11,1,D,2012
8459,19,23,Danny DeKeyser,4,65,23,D,2013
8460,29,24,Danny DeKeyser,2,80,31,D,2014
8461,12,25,Danny DeKeyser,8,78,20,D,2015
8462,8,26,Danny DeKeyser,4,82,12,D,2016
8463,6,27,Danny DeKeyser,6,65,12,D,2017
8464,31,20,Danny Gare,31,78,62,RW,1974
8465,23,21,Danny Gare,50,79,73,RW,1975
8466,15,22,Danny Gare,11,35,26,RW,1976
8467,38,23,Danny Gare,39,69,77,RW,1977
8468,40,24,Danny Gare,27,71,67,RW,1978
8469,33,25,Danny Gare,56,76,89,RW,1979
8470,39,26,Danny Gare,46,73,85,RW,1980
8471,23,27,Danny Gare,20,58,43,RW,1981
8472,35,28,Danny Gare,26,79,61,RW,1982
8473,13,29,Danny Gare,13,63,26,RW,1983
8474,29,30,Danny Gare,27,71,56,RW,1984
8475,9,31,Danny Gare,7,57,16,RW,1985
8476,3,32,Danny Gare,1,18,4,RW,1986
8477,14,21,Danny Geoffrion,12,77,26,RW,1978
8478,14,21,Danny Geoffrion,12,77,26,RW,1978
8479,6,22,Danny Geoffrion,0,32,6,RW,1979
8480,26,23,Danny Geoffrion,20,78,46,RW,1980
8481,0,24,Danny Geoffrion,0,1,0,RW,1981
8482,4,21,Danny Grant,3,22,7,LW,1967
8483,31,22,Danny Grant,34,75,65,LW,1968
8484,28,23,Danny Grant,29,76,57,LW,1969
8485,23,24,Danny Grant,34,78,57,LW,1970
8486,25,25,Danny Grant,18,78,43,LW,1971
8487,35,26,Danny Grant,32,78,67,LW,1972
8488,35,27,Danny Grant,29,78,64,LW,1973
8489,37,28,Danny Grant,50,80,87,LW,1974
8490,13,29,Danny Grant,10,39,23,LW,1975
8491,10,30,Danny Grant,2,42,12,LW,1976
8492,21,31,Danny Grant,12,54,33,C,1977
8493,11,32,Danny Grant,10,35,21,C,1978
8494,0,20,Danny Gruen,0,2,0,LW,1972
8495,3,21,Danny Gruen,1,18,4,LW,1973
8496,28,22,Danny Gruen,19,66,47,LW,1974
8497,28,22,Danny Gruen,19,66,47,LW,1974
8498,24,23,Danny Gruen,26,80,50,LW,1975
8499,24,23,Danny Gruen,26,80,50,LW,1975
8500,10,24,Danny Gruen,8,29,18,LW,1976
8501,9,24,Danny Gruen,11,35,20,LW,1976
8502,9,24,Danny Gruen,11,35,20,LW,1976
8503,0,25,Danny Irmen,0,2,0,C,2009
8504,0,25,Danny Johnson,0,1,0,LW,1969
8505,11,26,Danny Johnson,15,66,26,LW,1970
8506,8,27,Danny Johnson,3,54,11,LW,1971
8507,23,28,Danny Johnson,19,76,42,C,1972
8508,21,29,Danny Johnson,16,78,37,C,1973
8509,14,30,Danny Johnson,18,78,32,LW,1974
8510,14,30,Danny Johnson,18,78,32,LW,1974
8511,0,20,Danny Lawson,0,1,0,RW,1967
8512,10,21,Danny Lawson,8,62,18,RW,1968
8513,8,22,Danny Lawson,9,45,17,RW,1969
8514,5,23,Danny Lawson,1,33,6,RW,1970
8515,6,24,Danny Lawson,10,78,16,RW,1971
8516,45,25,Danny Lawson,61,78,106,RW,1972
8517,45,25,Danny Lawson,61,78,106,RW,1972
8518,38,26,Danny Lawson,50,78,88,RW,1973
8519,38,26,Danny Lawson,50,78,88,RW,1973
8520,43,27,Danny Lawson,33,78,76,RW,1974
8521,43,27,Danny Lawson,33,78,76,RW,1974
8522,52,28,Danny Lawson,44,80,96,RW,1975
8523,52,28,Danny Lawson,44,80,96,RW,1975
8524,26,29,Danny Lawson,30,78,56,RW,1976
8525,26,29,Danny Lawson,30,78,56,RW,1976
8526,0,20,Danny Lucas,1,6,1,LW,1978
8527,5,21,Danny Markov,2,25,7,D,1997
8528,8,22,Danny Markov,4,57,12,D,1998
8529,10,23,Danny Markov,0,59,10,D,1999
8530,13,24,Danny Markov,3,59,16,D,2000
8531,30,25,Danny Markov,6,72,36,D,2001
8532,16,26,Danny Markov,4,64,20,D,2002
8533,13,27,Danny Markov,6,78,19,D,2003
8534,11,29,Danny Markov,0,58,11,D,2005
8535,12,30,Danny Markov,4,66,16,D,2006
8536,34,23,Danny O'Shea,15,74,49,C,1968
8537,24,24,Danny O'Shea,10,75,34,C,1969
8538,19,25,Danny O'Shea,18,77,37,C,1970
8539,12,26,Danny O'Shea,9,68,21,C,1971
8540,26,27,Danny O'Shea,12,75,38,C,1972
8541,25,29,Danny O'Shea,16,76,41,C,1974
8542,25,29,Danny O'Shea,16,76,41,C,1974
8543,1,21,Danny Richmond,0,20,1,D,2005
8544,2,22,Danny Richmond,0,22,2,D,2006
8545,0,23,Danny Richmond,0,7,0,D,2007
8546,2,22,Danny Schock,1,20,3,LW,1970
8547,0,20,Danny Syvret,0,10,0,D,2005
8548,1,21,Danny Syvret,0,16,1,D,2006
8549,0,23,Danny Syvret,0,2,0,D,2008
8550,2,24,Danny Syvret,2,21,4,D,2009
8551,1,25,Danny Syvret,1,10,2,D,2010
8552,1,23,Danton Cole,1,2,2,RW,1989
8553,11,24,Danton Cole,13,66,24,RW,1990
8554,5,25,Danton Cole,7,52,12,RW,1991
8555,15,26,Danton Cole,12,67,27,RW,1992
8556,23,27,Danton Cole,20,81,43,RW,1993
8557,5,28,Danton Cole,4,38,9,LW,1994
8558,0,29,Danton Cole,1,12,1,RW,1995
8559,0,21,Danton Heinen,0,8,0,C,2016
8560,31,22,Danton Heinen,16,77,47,C,2017
8561,41,21,Dany Heatley,26,82,67,RW,2001
8562,48,22,Dany Heatley,41,77,89,RW,2002
8563,12,23,Dany Heatley,13,31,25,RW,2003
8564,53,25,Dany Heatley,50,82,103,LW,2005
8565,55,26,Dany Heatley,50,82,105,RW,2006
8566,41,27,Dany Heatley,41,71,82,LW,2007
8567,33,28,Dany Heatley,39,82,72,LW,2008
8568,43,29,Dany Heatley,39,82,82,RW,2009
8569,38,30,Dany Heatley,26,80,64,RW,2010
8570,29,31,Dany Heatley,24,82,53,RW,2011
8571,10,32,Dany Heatley,11,36,21,RW,2012
8572,16,33,Dany Heatley,12,76,28,LW,2013
8573,0,34,Dany Heatley,0,6,0,LW,2014
8574,1,22,Darby Hendrickson,0,8,1,C,1994
8575,10,23,Darby Hendrickson,7,62,17,LW,1995
8576,6,24,Darby Hendrickson,11,64,17,C,1996
8577,4,25,Darby Hendrickson,8,80,12,C,1997
8578,5,26,Darby Hendrickson,4,62,9,C,1998
8579,4,27,Darby Hendrickson,5,40,9,C,1999
8580,11,28,Darby Hendrickson,18,72,29,LW,2000
8581,15,29,Darby Hendrickson,9,68,24,C,2001
8582,5,30,Darby Hendrickson,1,28,6,C,2002
8583,3,31,Darby Hendrickson,2,34,5,C,2003
8584,0,22,Darcy Campbell,0,1,0,D,2006
8585,0,20,Darcy Hordichuk,0,11,0,LW,2000
8586,1,21,Darcy Hordichuk,1,34,2,LW,2001
8587,0,22,Darcy Hordichuk,0,28,0,LW,2002
8588,1,23,Darcy Hordichuk,3,57,4,LW,2003
8589,6,25,Darcy Hordichuk,7,74,13,LW,2005
8590,3,26,Darcy Hordichuk,1,53,4,LW,2006
8591,2,27,Darcy Hordichuk,1,45,3,LW,2007
8592,1,28,Darcy Hordichuk,4,73,5,LW,2008
8593,1,29,Darcy Hordichuk,1,56,2,LW,2009
8594,4,30,Darcy Hordichuk,1,64,5,LW,2010
8595,2,31,Darcy Hordichuk,1,43,3,LW,2011
8596,0,32,Darcy Hordichuk,0,4,0,LW,2012
8597,0,20,Darcy Loewen,0,4,0,LW,1989
8598,0,21,Darcy Loewen,0,6,0,LW,1990
8599,0,22,Darcy Loewen,0,2,0,LW,1991
8600,5,23,Darcy Loewen,4,79,9,LW,1992
8601,3,24,Darcy Loewen,0,44,3,LW,1993
8602,0,25,Darcy Martini,0,2,0,D,1993
8603,1,21,Darcy Regier,0,15,1,D,1977
8604,0,26,Darcy Regier,0,6,0,D,1982
8605,1,27,Darcy Regier,0,5,1,D,1983
8606,12,20,Darcy Rota,21,74,33,LW,1973
8607,22,21,Darcy Rota,22,78,44,LW,1974
8608,17,22,Darcy Rota,20,79,37,LW,1975
8609,22,23,Darcy Rota,24,76,46,LW,1976
8610,20,24,Darcy Rota,17,78,37,LW,1977
8611,22,25,Darcy Rota,22,76,44,RW,1978
8612,14,26,Darcy Rota,15,70,29,RW,1979
8613,31,27,Darcy Rota,25,80,56,LW,1980
8614,20,28,Darcy Rota,20,51,40,LW,1981
8615,39,29,Darcy Rota,42,73,81,LW,1982
8616,20,30,Darcy Rota,28,59,48,LW,1983
8617,0,20,Darcy Tucker,0,3,0,C,1995
8618,13,21,Darcy Tucker,7,73,20,C,1996
8619,13,22,Darcy Tucker,7,74,20,C,1997
8620,22,23,Darcy Tucker,21,82,43,C,1998
8621,30,24,Darcy Tucker,21,77,51,LW,1999
8622,21,25,Darcy Tucker,16,82,37,RW,2000
8623,35,26,Darcy Tucker,24,77,59,LW,2001
8624,26,27,Darcy Tucker,10,77,36,LW,2002
8625,11,28,Darcy Tucker,21,64,32,LW,2003
8626,33,30,Darcy Tucker,28,74,61,C,2005
8627,19,31,Darcy Tucker,24,56,43,RW,2006
8628,16,32,Darcy Tucker,18,74,34,RW,2007
8629,8,33,Darcy Tucker,8,63,16,RW,2008
8630,14,34,Darcy Tucker,10,71,24,C,2009
8631,2,27,Darcy Verot,0,37,2,C,2003
8632,1,20,Darin Kimble,3,26,4,RW,1988
8633,5,21,Darin Kimble,5,44,10,RW,1989
8634,6,22,Darin Kimble,3,61,9,RW,1990
8635,3,23,Darin Kimble,1,46,4,RW,1991
8636,3,24,Darin Kimble,7,55,10,RW,1992
8637,2,25,Darin Kimble,4,65,6,RW,1993
8638,0,26,Darin Kimble,0,14,0,RW,1994
8639,0,21,Darin Sceviour,0,1,0,RW,1986
8640,17,20,Darius Kasparaitis,4,79,21,D,1992
8641,10,21,Darius Kasparaitis,1,76,11,D,1993
8642,1,22,Darius Kasparaitis,0,13,1,D,1994
8643,7,23,Darius Kasparaitis,1,46,8,D,1995
8644,21,24,Darius Kasparaitis,2,75,23,D,1996
8645,8,25,Darius Kasparaitis,4,81,12,D,1997
8646,4,26,Darius Kasparaitis,1,48,5,D,1998
8647,12,27,Darius Kasparaitis,3,73,15,D,1999
8648,16,28,Darius Kasparaitis,3,77,19,D,2000
8649,12,29,Darius Kasparaitis,2,80,14,D,2001
8650,11,30,Darius Kasparaitis,3,80,14,D,2002
8651,9,31,Darius Kasparaitis,1,44,10,D,2003
8652,6,33,Darius Kasparaitis,0,67,6,D,2005
8653,2,34,Darius Kasparaitis,2,24,4,D,2006
8654,0,19,Darnell Nurse,0,2,0,D,2014
8655,7,20,Darnell Nurse,3,69,10,D,2015
8656,6,21,Darnell Nurse,5,44,11,D,2016
8657,20,22,Darnell Nurse,6,82,26,D,2017
8658,0,21,Darrel Anholt,0,1,0,D,1983
8659,8,23,Darrel Knibbs,3,41,11,C,1972
8660,8,23,Darrel Knibbs,3,41,11,C,1972
8661,0,24,Darrel Scoville,0,6,0,D,1999
8662,0,27,Darrel Scoville,0,2,0,D,2002
8663,1,28,Darrel Scoville,0,8,1,D,2003
8664,2,23,Darren Archibald,1,16,3,RW,2013
8665,5,27,Darren Archibald,4,27,9,RW,2017
8666,1,26,Darren Banks,2,16,3,LW,1992
8667,1,27,Darren Banks,0,4,1,LW,1993
8668,0,25,Darren Boyko,0,1,0,C,1988
8669,4,22,Darren Dietz,1,13,5,D,2015
8670,0,23,Darren Haydar,0,2,0,RW,2002
8671,0,27,Darren Haydar,0,4,0,RW,2006
8672,7,28,Darren Haydar,1,16,8,RW,2007
8673,0,30,Darren Haydar,0,1,0,RW,2009
8674,0,21,Darren Helm,0,7,0,C,2007
8675,1,22,Darren Helm,0,16,1,C,2008
8676,13,23,Darren Helm,11,75,24,C,2009
8677,20,24,Darren Helm,12,82,32,C,2010
8678,17,25,Darren Helm,9,68,26,C,2011
8679,0,26,Darren Helm,0,1,0,C,2012
8680,8,27,Darren Helm,12,42,20,C,2013
8681,18,28,Darren Helm,15,75,33,C,2014
8682,13,29,Darren Helm,13,77,26,C,2015
8683,9,30,Darren Helm,8,50,17,C,2016
8684,18,31,Darren Helm,13,75,31,LW,2017
8685,1,24,Darren Langdon,1,18,2,LW,1994
8686,4,25,Darren Langdon,7,64,11,LW,1995
8687,6,26,Darren Langdon,3,60,9,LW,1996
8688,3,27,Darren Langdon,3,70,6,LW,1997
8689,0,28,Darren Langdon,0,44,0,LW,1998
8690,1,29,Darren Langdon,0,21,1,LW,1999
8691,2,30,Darren Langdon,0,54,2,LW,2000
8692,1,31,Darren Langdon,2,58,3,LW,2001
8693,1,32,Darren Langdon,0,54,1,LW,2002
8694,3,33,Darren Langdon,0,64,3,LW,2003
8695,1,35,Darren Langdon,0,14,1,LW,2005
8696,2,23,Darren Lowe,1,8,3,RW,1983
8697,17,21,Darren McCarty,9,67,26,RW,1993
8698,8,22,Darren McCarty,5,31,13,RW,1994
8699,14,23,Darren McCarty,15,63,29,RW,1995
8700,30,24,Darren McCarty,19,68,49,RW,1996
8701,22,25,Darren McCarty,15,71,37,RW,1997
8702,26,26,Darren McCarty,14,69,40,RW,1998
8703,6,27,Darren McCarty,6,24,12,RW,1999
8704,10,28,Darren McCarty,12,72,22,RW,2000
8705,7,29,Darren McCarty,5,62,12,RW,2001
8706,9,30,Darren McCarty,13,73,22,RW,2002
8707,5,31,Darren McCarty,6,43,11,RW,2003
8708,6,33,Darren McCarty,7,67,13,RW,2005
8709,0,34,Darren McCarty,0,32,0,RW,2006
8710,1,35,Darren McCarty,0,3,1,RW,2007
8711,0,36,Darren McCarty,1,13,1,RW,2008
8712,1,22,Darren Reid,0,7,1,RW,2005
8713,0,23,Darren Reid,0,14,0,RW,2006
8714,0,22,Darren Rumble,1,3,1,D,1990
8715,13,24,Darren Rumble,3,69,16,D,1992
8716,9,25,Darren Rumble,6,70,15,D,1993
8717,0,27,Darren Rumble,0,5,0,D,1995
8718,0,28,Darren Rumble,0,10,0,D,1996
8719,4,32,Darren Rumble,0,12,4,D,2000
8720,0,34,Darren Rumble,0,19,0,D,2002
8721,0,35,Darren Rumble,0,5,0,D,2003
8722,3,20,Darren Turcotte,7,20,10,C,1988
8723,34,21,Darren Turcotte,32,76,66,LW,1989
8724,41,22,Darren Turcotte,26,74,67,C,1990
8725,23,23,Darren Turcotte,30,71,53,C,1991
8726,28,24,Darren Turcotte,25,71,53,C,1992
8727,15,25,Darren Turcotte,4,32,19,C,1993
8728,18,26,Darren Turcotte,17,47,35,LW,1994
8729,21,27,Darren Turcotte,22,68,43,C,1995
8730,21,28,Darren Turcotte,16,65,37,C,1996
8731,6,29,Darren Turcotte,12,62,18,C,1997
8732,5,30,Darren Turcotte,4,40,9,C,1998
8733,1,31,Darren Turcotte,0,9,1,C,1999
8734,1,21,Darren Van Impe,0,1,1,D,1994
8735,2,22,Darren Van Impe,1,16,3,D,1995
8736,19,23,Darren Van Impe,4,74,23,D,1996
8737,11,24,Darren Van Impe,3,69,14,D,1997
8738,15,25,Darren Van Impe,5,60,20,D,1998
8739,23,26,Darren Van Impe,5,79,28,D,1999
8740,10,27,Darren Van Impe,3,31,13,D,2000
8741,8,28,Darren Van Impe,3,67,11,D,2001
8742,1,29,Darren Van Impe,1,14,2,D,2002
8743,21,20,Darren Veitch,4,59,25,D,1980
8744,44,21,Darren Veitch,9,67,53,D,1981
8745,8,22,Darren Veitch,0,10,8,D,1982
8746,18,23,Darren Veitch,6,46,24,D,1983
8747,18,24,Darren Veitch,3,75,21,D,1984
8748,14,25,Darren Veitch,3,75,17,D,1985
8749,45,26,Darren Veitch,13,77,58,D,1986
8750,33,27,Darren Veitch,7,63,40,D,1987
8751,7,28,Darren Veitch,3,37,10,D,1988
8752,1,30,Darren Veitch,0,2,1,D,1990
8753,0,19,Darrin Shannon,0,3,0,LW,1988
8754,7,20,Darrin Shannon,2,17,9,LW,1989
8755,6,21,Darrin Shannon,8,34,14,LW,1990
8756,27,22,Darrin Shannon,13,69,40,LW,1991
8757,40,23,Darrin Shannon,20,84,60,LW,1992
8758,37,24,Darrin Shannon,21,77,58,LW,1993
8759,3,25,Darrin Shannon,5,19,8,LW,1994
8760,18,26,Darrin Shannon,5,63,23,LW,1995
8761,13,27,Darrin Shannon,11,82,24,LW,1996
8762,12,28,Darrin Shannon,2,58,14,LW,1997
8763,5,23,Darroll Powe,6,60,11,C,2008
8764,6,24,Darroll Powe,9,63,15,C,2009
8765,10,25,Darroll Powe,7,81,17,C,2010
8766,7,26,Darroll Powe,6,82,13,C,2011
8767,0,27,Darroll Powe,0,42,0,C,2012
8768,0,28,Darroll Powe,0,1,0,C,2013
8769,1,22,Darryl Bootland,1,22,2,RW,2003
8770,0,25,Darryl Bootland,0,6,0,RW,2006
8771,1,26,Darryl Bootland,0,4,1,RW,2007
8772,0,23,Darryl Boyce,0,1,0,C,2007
8773,8,26,Darryl Boyce,5,46,13,C,2010
8774,4,27,Darryl Boyce,1,37,5,C,2011
8775,0,22,Darryl Edestrand,0,12,0,D,1967
8776,0,24,Darryl Edestrand,0,2,0,D,1969
8777,23,26,Darryl Edestrand,10,77,33,D,1971
8778,24,27,Darryl Edestrand,15,78,39,D,1972
8779,8,28,Darryl Edestrand,3,55,11,D,1973
8780,9,29,Darryl Edestrand,1,68,10,D,1974
8781,17,30,Darryl Edestrand,4,77,21,D,1975
8782,3,31,Darryl Edestrand,0,17,3,D,1976
8783,2,32,Darryl Edestrand,0,14,2,D,1977
8784,4,33,Darryl Edestrand,1,55,5,D,1978
8785,0,20,Darryl Laplante,0,2,0,C,1997
8786,0,21,Darryl Laplante,0,3,0,C,1998
8787,6,22,Darryl Laplante,0,30,6,C,1999
8788,4,22,Darryl Maggs,7,59,11,D,1971
8789,15,23,Darryl Maggs,7,71,22,D,1972
8790,22,24,Darryl Maggs,8,78,30,D,1973
8791,27,25,Darryl Maggs,6,77,33,D,1974
8792,39,26,Darryl Maggs,9,77,48,D,1975
8793,55,27,Darryl Maggs,16,81,71,D,1976
8794,20,28,Darryl Maggs,8,62,28,D,1977
8795,20,28,Darryl Maggs,8,62,28,D,1977
8796,14,29,Darryl Maggs,4,27,18,D,1978
8797,14,29,Darryl Maggs,4,27,18,D,1978
8798,0,30,Darryl Maggs,0,5,0,D,1979
8799,0,25,Darryl Olsen,0,1,0,D,1991
8800,3,20,Darryl Shannon,1,14,4,D,1988
8801,1,21,Darryl Shannon,0,10,1,D,1989
8802,1,22,Darryl Shannon,0,10,1,D,1990
8803,8,23,Darryl Shannon,2,48,10,D,1991
8804,0,24,Darryl Shannon,0,16,0,D,1992
8805,4,25,Darryl Shannon,0,20,4,D,1993
8806,9,26,Darryl Shannon,5,40,14,D,1994
8807,13,27,Darryl Shannon,4,74,17,D,1995
8808,19,28,Darryl Shannon,4,82,23,D,1996
8809,19,29,Darryl Shannon,3,76,22,D,1997
8810,12,30,Darryl Shannon,3,71,15,D,1998
8811,21,31,Darryl Shannon,6,76,27,D,1999
8812,1,32,Darryl Shannon,0,7,1,D,2000
8813,8,20,Darryl Sittler,10,49,18,C,1970
8814,17,21,Darryl Sittler,15,74,32,C,1971
8815,48,22,Darryl Sittler,29,78,77,C,1972
8816,46,23,Darryl Sittler,38,78,84,C,1973
8817,44,24,Darryl Sittler,36,72,80,C,1974
8818,59,25,Darryl Sittler,41,79,100,C,1975
8819,52,26,Darryl Sittler,38,73,90,C,1976
8820,72,27,Darryl Sittler,45,80,117,C,1977
8821,51,28,Darryl Sittler,36,70,87,C,1978
8822,57,29,Darryl Sittler,40,73,97,C,1979
8823,53,30,Darryl Sittler,43,80,96,C,1980
8824,38,31,Darryl Sittler,32,73,70,C,1981
8825,40,32,Darryl Sittler,43,80,83,C,1982
8826,36,33,Darryl Sittler,27,76,63,C,1983
8827,16,34,Darryl Sittler,11,61,27,C,1984
8828,0,28,Darryl Sly,0,17,0,D,1967
8829,0,30,Darryl Sly,1,29,1,D,1969
8830,2,31,Darryl Sly,0,31,2,D,1970
8831,0,21,Darryl Sutter,2,8,2,LW,1979
8832,22,22,Darryl Sutter,40,76,62,LW,1980
8833,12,23,Darryl Sutter,23,40,35,LW,1981
8834,30,24,Darryl Sutter,31,80,61,LW,1982
8835,20,25,Darryl Sutter,20,59,40,LW,1983
8836,18,26,Darryl Sutter,20,49,38,LW,1984
8837,10,27,Darryl Sutter,17,50,27,LW,1985
8838,6,28,Darryl Sutter,8,44,14,LW,1986
8839,5,19,Darryl Sydor,1,18,6,D,1991
8840,23,20,Darryl Sydor,6,80,29,D,1992
8841,27,21,Darryl Sydor,8,84,35,D,1993
8842,19,22,Darryl Sydor,4,48,23,D,1994
8843,17,23,Darryl Sydor,3,84,20,D,1995
8844,40,24,Darryl Sydor,8,82,48,D,1996
8845,35,25,Darryl Sydor,11,79,46,D,1997
8846,34,26,Darryl Sydor,14,74,48,D,1998
8847,26,27,Darryl Sydor,8,74,34,D,1999
8848,37,28,Darryl Sydor,10,81,47,D,2000
8849,29,29,Darryl Sydor,4,78,33,D,2001
8850,31,30,Darryl Sydor,5,81,36,D,2002
8851,19,31,Darryl Sydor,3,80,22,D,2003
8852,19,33,Darryl Sydor,4,80,23,D,2005
8853,16,34,Darryl Sydor,5,74,21,D,2006
8854,12,35,Darryl Sydor,1,74,13,D,2007
8855,12,36,Darryl Sydor,3,73,15,D,2008
8856,8,37,Darryl Sydor,0,47,8,D,2009
8857,0,24,Darryl Williams,0,2,0,LW,1992
8858,0,19,Darwin McCutcheon,0,1,0,D,1981
8859,0,22,Darwin Mott,0,1,0,LW,1972
8860,0,22,Darwin Mott,0,1,0,LW,1972
8861,6,21,Daryl Evans,2,14,8,LW,1981
8862,22,22,Daryl Evans,18,80,40,LW,1982
8863,1,23,Daryl Evans,0,4,1,LW,1983
8864,0,24,Daryl Evans,1,7,1,LW,1984
8865,1,25,Daryl Evans,0,6,1,LW,1985
8866,0,26,Daryl Evans,1,2,1,LW,1986
8867,4,21,Daryl Stanley,1,23,5,D,1983
8868,2,23,Daryl Stanley,0,33,2,D,1985
8869,2,24,Daryl Stanley,1,33,3,D,1986
8870,7,25,Daryl Stanley,2,57,9,D,1987
8871,1,26,Daryl Stanley,3,20,4,D,1988
8872,1,27,Daryl Stanley,1,23,2,D,1989
8873,0,24,Dave Allison,0,3,0,D,1983
8874,6,28,Dave Amadio,4,58,10,D,1967
8875,5,29,Dave Amadio,1,65,6,D,1968
8876,23,19,Dave Andreychuk,14,43,37,C,1982
8877,42,20,Dave Andreychuk,38,78,80,C,1983
8878,30,21,Dave Andreychuk,31,64,61,LW,1984
8879,51,22,Dave Andreychuk,36,80,87,RW,1985
8880,48,23,Dave Andreychuk,25,77,73,RW,1986
8881,48,24,Dave Andreychuk,30,80,78,LW,1987
8882,24,25,Dave Andreychuk,28,56,52,LW,1988
8883,42,26,Dave Andreychuk,40,73,82,LW,1989
8884,33,27,Dave Andreychuk,36,80,69,LW,1990
8885,50,28,Dave Andreychuk,41,80,91,LW,1991
8886,45,29,Dave Andreychuk,54,83,99,LW,1992
8887,46,30,Dave Andreychuk,53,83,99,RW,1993
8888,16,31,Dave Andreychuk,22,48,38,LW,1994
8889,29,32,Dave Andreychuk,28,76,57,LW,1995
8890,34,33,Dave Andreychuk,27,82,61,LW,1996
8891,34,34,Dave Andreychuk,14,75,48,LW,1997
8892,13,35,Dave Andreychuk,15,52,28,LW,1998
8893,16,36,Dave Andreychuk,20,77,36,LW,1999
8894,13,37,Dave Andreychuk,20,74,33,LW,2000
8895,17,38,Dave Andreychuk,21,82,38,LW,2001
8896,14,39,Dave Andreychuk,20,72,34,LW,2002
8897,18,40,Dave Andreychuk,21,82,39,RW,2003
8898,12,42,Dave Andreychuk,6,42,18,LW,2005
8899,20,18,Dave Archibald,13,78,33,C,1987
8900,19,19,Dave Archibald,14,72,33,C,1988
8901,8,20,Dave Archibald,3,31,11,C,1989
8902,6,23,Dave Archibald,9,44,15,RW,1992
8903,8,24,Dave Archibald,10,33,18,RW,1993
8904,2,25,Dave Archibald,2,14,4,C,1994
8905,4,26,Dave Archibald,6,44,10,C,1995
8906,0,27,Dave Archibald,0,7,0,C,1996
8907,38,19,Dave Babych,6,69,44,D,1980
8908,49,20,Dave Babych,19,79,68,D,1981
8909,61,21,Dave Babych,13,79,74,D,1982
8910,39,22,Dave Babych,18,66,57,D,1983
8911,49,23,Dave Babych,13,78,62,D,1984
8912,55,24,Dave Babych,14,81,69,D,1985
8913,33,25,Dave Babych,8,66,41,D,1986
8914,36,26,Dave Babych,14,71,50,D,1987
8915,41,27,Dave Babych,6,70,47,D,1988
8916,37,28,Dave Babych,6,72,43,D,1989
8917,6,29,Dave Babych,0,8,6,D,1990
8918,24,30,Dave Babych,5,75,29,D,1991
8919,16,31,Dave Babych,3,43,19,D,1992
8920,28,32,Dave Babych,4,73,32,D,1993
8921,11,33,Dave Babych,3,40,14,D,1994
8922,21,34,Dave Babych,3,53,24,D,1995
8923,22,35,Dave Babych,5,78,27,D,1996
8924,9,36,Dave Babych,0,53,9,D,1997
8925,6,37,Dave Babych,2,41,8,D,1998
8926,32,29,Dave Balon,15,73,47,LW,1967
8927,21,30,Dave Balon,10,75,31,LW,1968
8928,37,31,Dave Balon,33,76,70,LW,1969
8929,24,32,Dave Balon,36,78,60,LW,1970
8930,24,33,Dave Balon,23,75,47,LW,1971
8931,2,34,Dave Balon,3,57,5,LW,1972
8932,0,35,Dave Balon,0,9,0,LW,1973
8933,0,35,Dave Balon,0,9,0,LW,1973
8934,0,21,Dave Barr,0,2,0,C,1981
8935,1,22,Dave Barr,1,10,2,RW,1982
8936,0,23,Dave Barr,0,7,0,C,1983
8937,18,24,Dave Barr,16,75,34,C,1984
8938,38,25,Dave Barr,13,72,51,RW,1985
8939,17,26,Dave Barr,15,69,32,RW,1986
8940,26,27,Dave Barr,14,51,40,RW,1987
8941,32,28,Dave Barr,27,73,59,RW,1988
8942,25,29,Dave Barr,10,62,35,RW,1989
8943,22,30,Dave Barr,18,70,40,RW,1990
8944,12,31,Dave Barr,6,41,18,C,1991
8945,8,32,Dave Barr,6,62,14,C,1992
8946,5,33,Dave Barr,2,20,7,C,1993
8947,0,20,Dave Bolland,0,1,0,C,2006
8948,13,21,Dave Bolland,4,39,17,C,2007
8949,28,22,Dave Bolland,19,81,47,C,2008
8950,10,23,Dave Bolland,6,39,16,C,2009
8951,22,24,Dave Bolland,15,61,37,C,2010
8952,18,25,Dave Bolland,19,76,37,C,2011
8953,7,26,Dave Bolland,7,35,14,C,2012
8954,4,27,Dave Bolland,8,23,12,C,2013
8955,17,28,Dave Bolland,6,53,23,C,2014
8956,4,29,Dave Bolland,1,25,5,C,2015
8957,0,20,Dave Brown,0,2,0,RW,1982
8958,5,21,Dave Brown,1,19,6,RW,1983
8959,6,22,Dave Brown,3,57,9,RW,1984
8960,7,23,Dave Brown,10,76,17,RW,1985
8961,3,24,Dave Brown,7,62,10,RW,1986
8962,5,25,Dave Brown,12,47,17,RW,1987
8963,5,26,Dave Brown,0,72,5,RW,1988
8964,6,27,Dave Brown,0,60,6,RW,1989
8965,4,28,Dave Brown,3,58,7,RW,1990
8966,2,29,Dave Brown,4,70,6,RW,1991
8967,2,30,Dave Brown,0,70,2,RW,1992
8968,4,31,Dave Brown,1,71,5,RW,1993
8969,2,32,Dave Brown,1,28,3,RW,1994
8970,1,33,Dave Brown,3,37,4,RW,1995
8971,10,23,Dave Burrows,2,77,12,D,1971
8972,24,24,Dave Burrows,3,78,27,D,1972
8973,14,25,Dave Burrows,3,71,17,D,1973
8974,15,26,Dave Burrows,2,78,17,D,1974
8975,22,27,Dave Burrows,7,80,29,D,1975
8976,6,28,Dave Burrows,3,69,9,D,1976
8977,15,29,Dave Burrows,4,67,19,D,1977
8978,11,30,Dave Burrows,2,65,13,D,1978
8979,16,31,Dave Burrows,3,80,19,D,1979
8980,2,32,Dave Burrows,0,59,2,D,1980
8981,12,23,Dave Cameron,11,66,23,C,1981
8982,4,24,Dave Cameron,5,35,9,C,1982
8983,12,25,Dave Cameron,9,67,21,C,1983
8984,5,21,Dave Capuano,3,33,8,C,1989
8985,31,22,Dave Capuano,13,61,44,C,1990
8986,1,24,Dave Capuano,1,6,2,LW,1992
8987,1,25,Dave Capuano,0,4,1,LW,1993
8988,0,19,Dave Chartier,0,1,0,C,1980
8989,10,20,Dave Christian,8,15,18,RW,1979
8990,43,21,Dave Christian,28,80,71,C,1980
8991,51,22,Dave Christian,25,80,76,C,1981
8992,26,23,Dave Christian,18,55,44,C,1982
8993,52,24,Dave Christian,29,80,81,C,1983
8994,43,25,Dave Christian,26,80,69,C,1984
8995,42,26,Dave Christian,41,80,83,RW,1985
8996,27,27,Dave Christian,23,76,50,C,1986
8997,21,28,Dave Christian,37,80,58,RW,1987
8998,31,29,Dave Christian,34,80,65,C,1988
8999,25,30,Dave Christian,15,78,40,RW,1989
9000,21,31,Dave Christian,32,78,53,RW,1990
9001,24,32,Dave Christian,20,78,44,RW,1991
9002,14,33,Dave Christian,4,60,18,C,1992
9003,3,34,Dave Christian,0,9,3,RW,1993
9004,6,18,Dave Chyzowski,8,34,14,LW,1989
9005,9,19,Dave Chyzowski,5,56,14,RW,1990
9006,1,20,Dave Chyzowski,1,12,2,LW,1991
9007,0,22,Dave Chyzowski,1,3,1,RW,1993
9008,0,23,Dave Chyzowski,0,13,0,LW,1994
9009,0,25,Dave Chyzowski,0,8,0,LW,1996
9010,0,25,Dave Cressman,2,5,2,LW,1974
9011,8,26,Dave Cressman,4,80,12,LW,1975
9012,2,21,Dave Debol,3,9,5,C,1977
9013,27,22,Dave Debol,10,59,37,C,1978
9014,14,23,Dave Debol,12,48,26,C,1979
9015,12,24,Dave Debol,14,44,26,C,1980
9016,4,21,Dave Donnelly,3,16,7,LW,1983
9017,8,22,Dave Donnelly,6,38,14,C,1984
9018,0,23,Dave Donnelly,0,8,0,C,1985
9019,12,24,Dave Donnelly,6,71,18,C,1986
9020,0,25,Dave Donnelly,0,4,0,C,1987
9021,1,21,Dave Dornseif,0,3,1,D,1977
9022,1,21,Dave Dornseif,0,3,1,D,1977
9023,0,22,Dave Dornseif,0,1,0,D,1978
9024,0,22,Dave Dornseif,0,1,0,D,1978
9025,0,22,Dave Duerden,0,2,0,LW,1999
9026,22,25,Dave Dunn,11,68,33,D,1973
9027,11,26,Dave Dunn,3,73,14,D,1974
9028,8,27,Dave Dunn,0,43,8,D,1975
9029,11,28,Dave Dunn,3,40,14,D,1976
9030,11,28,Dave Dunn,3,40,14,D,1976
9031,20,29,Dave Dunn,6,66,26,D,1977
9032,20,29,Dave Dunn,6,66,26,D,1977
9033,27,20,Dave Ellett,11,80,38,D,1984
9034,31,21,Dave Ellett,15,80,46,D,1985
9035,31,22,Dave Ellett,13,78,44,D,1986
9036,45,23,Dave Ellett,13,68,58,D,1987
9037,34,24,Dave Ellett,22,75,56,D,1988
9038,29,25,Dave Ellett,17,77,46,D,1989
9039,37,26,Dave Ellett,12,77,49,D,1990
9040,33,27,Dave Ellett,18,79,51,D,1991
9041,34,28,Dave Ellett,6,70,40,D,1992
9042,36,29,Dave Ellett,7,68,43,D,1993
9043,10,30,Dave Ellett,5,33,15,D,1994
9044,19,31,Dave Ellett,3,80,22,D,1995
9045,15,32,Dave Ellett,6,76,21,D,1996
9046,20,33,Dave Ellett,3,82,23,D,1997
9047,6,34,Dave Ellett,0,54,6,D,1998
9048,8,35,Dave Ellett,2,52,10,D,1999
9049,17,20,Dave Farrish,2,80,19,D,1976
9050,5,21,Dave Farrish,3,66,8,D,1977
9051,19,22,Dave Farrish,1,71,20,D,1978
9052,8,23,Dave Farrish,1,24,9,D,1979
9053,18,24,Dave Farrish,2,74,20,D,1980
9054,24,26,Dave Farrish,4,56,28,D,1982
9055,19,27,Dave Farrish,4,59,23,D,1983
9056,2,23,Dave Feamster,0,29,2,D,1981
9057,12,24,Dave Feamster,6,78,18,D,1982
9058,7,25,Dave Feamster,6,46,13,D,1983
9059,3,26,Dave Feamster,1,16,4,D,1984
9060,16,25,Dave Forbes,10,63,26,LW,1973
9061,12,26,Dave Forbes,18,69,30,LW,1974
9062,13,27,Dave Forbes,16,79,29,LW,1975
9063,11,28,Dave Forbes,9,73,20,LW,1976
9064,11,29,Dave Forbes,11,77,22,LW,1977
9065,1,30,Dave Forbes,0,2,1,LW,1978
9066,5,30,Dave Forbes,6,73,11,LW,1978
9067,5,30,Dave Forbes,6,73,11,LW,1978
9068,4,21,Dave Fortier,1,23,5,D,1972
9069,12,23,Dave Fortier,6,65,18,D,1974
9070,2,24,Dave Fortier,0,59,2,D,1975
9071,3,25,Dave Fortier,1,58,4,D,1976
9072,15,26,Dave Fortier,1,54,16,D,1977
9073,15,26,Dave Fortier,1,54,16,D,1977
9074,6,20,Dave Gagner,6,38,12,C,1984
9075,6,21,Dave Gagner,4,32,10,C,1985
9076,4,22,Dave Gagner,1,10,5,C,1986
9077,11,23,Dave Gagner,8,51,19,RW,1987
9078,43,24,Dave Gagner,35,75,78,C,1988
9079,38,25,Dave Gagner,40,79,78,C,1989
9080,42,26,Dave Gagner,40,73,82,C,1990
9081,40,27,Dave Gagner,31,78,71,C,1991
9082,43,28,Dave Gagner,33,84,76,LW,1992
9083,29,29,Dave Gagner,32,76,61,LW,1993
9084,28,30,Dave Gagner,14,48,42,LW,1994
9085,28,31,Dave Gagner,21,73,49,LW,1995
9086,33,32,Dave Gagner,27,82,60,C,1996
9087,28,33,Dave Gagner,20,78,48,C,1997
9088,22,34,Dave Gagner,6,69,28,C,1998
9089,0,18,Dave Gans,0,3,0,C,1982
9090,0,21,Dave Gans,0,3,0,C,1985
9091,1,20,Dave Gardner,1,5,2,C,1972
9092,12,21,Dave Gardner,6,46,18,C,1973
9093,22,22,Dave Gardner,16,72,38,C,1974
9094,32,23,Dave Gardner,16,74,48,C,1975
9095,22,24,Dave Gardner,16,76,38,C,1976
9096,25,25,Dave Gardner,19,75,44,C,1977
9097,1,27,Dave Gardner,1,2,2,C,1979
9098,0,25,Dave Gilmour,0,1,0,LW,1975
9099,0,25,Dave Gilmour,0,1,0,LW,1975
9100,0,20,Dave Given,0,1,0,RW,1974
9101,0,20,Dave Given,0,1,0,RW,1974
9102,0,22,Dave Goertz,0,2,0,D,1987
9103,5,19,Dave Gorman,3,13,8,RW,1974
9104,5,19,Dave Gorman,3,13,8,RW,1974
9105,20,20,Dave Gorman,11,67,31,RW,1975
9106,13,21,Dave Gorman,9,57,22,RW,1976
9107,21,22,Dave Gorman,19,63,40,RW,1977
9108,21,22,Dave Gorman,19,63,40,RW,1977
9109,24,23,Dave Gorman,14,60,38,LW,1978
9110,24,23,Dave Gorman,14,60,38,LW,1978
9111,0,24,Dave Gorman,0,3,0,RW,1979
9112,0,20,Dave Hannan,0,1,0,C,1981
9113,22,21,Dave Hannan,11,74,33,C,1982
9114,3,22,Dave Hannan,2,24,5,C,1983
9115,7,23,Dave Hannan,6,30,13,LW,1984
9116,18,24,Dave Hannan,17,75,35,LW,1985
9117,15,25,Dave Hannan,10,58,25,C,1986
9118,14,26,Dave Hannan,13,72,27,C,1987
9119,20,27,Dave Hannan,10,72,30,C,1988
9120,9,28,Dave Hannan,6,39,15,C,1989
9121,23,29,Dave Hannan,11,74,34,C,1990
9122,6,30,Dave Hannan,4,47,10,C,1991
9123,15,31,Dave Hannan,5,55,20,C,1992
9124,15,32,Dave Hannan,6,83,21,C,1993
9125,12,33,Dave Hannan,4,42,16,C,1994
9126,10,34,Dave Hannan,7,61,17,LW,1995
9127,2,35,Dave Hannan,2,34,4,C,1996
9128,2,22,Dave Hanson,0,8,2,D,1976
9129,2,22,Dave Hanson,0,7,2,D,1976
9130,0,22,Dave Hanson,0,1,0,D,1976
9131,2,22,Dave Hanson,0,8,2,D,1976
9132,2,22,Dave Hanson,0,7,2,D,1976
9133,0,22,Dave Hanson,0,1,0,D,1976
9134,16,23,Dave Hanson,7,42,23,D,1977
9135,16,23,Dave Hanson,7,42,23,D,1977
9136,0,24,Dave Hanson,0,11,0,D,1978
9137,22,24,Dave Hanson,6,53,28,D,1978
9138,22,24,Dave Hanson,6,53,28,D,1978
9139,1,25,Dave Hanson,1,22,2,D,1979
9140,0,22,Dave Hindmarch,1,1,1,RW,1980
9141,0,23,Dave Hindmarch,3,9,3,RW,1981
9142,12,24,Dave Hindmarch,11,60,23,RW,1982
9143,5,25,Dave Hindmarch,6,29,11,RW,1983
9144,3,20,Dave Hoyda,1,41,4,LW,1977
9145,13,21,Dave Hoyda,3,67,16,LW,1978
9146,1,22,Dave Hoyda,1,15,2,LW,1979
9147,0,23,Dave Hoyda,1,9,1,LW,1980
9148,0,22,Dave Hrechkosy,0,2,0,LW,1973
9149,14,23,Dave Hrechkosy,29,72,43,LW,1974
9150,8,24,Dave Hrechkosy,12,51,20,LW,1975
9151,2,25,Dave Hrechkosy,1,15,3,LW,1976
9152,19,23,Dave Hudson,12,69,31,C,1972
9153,10,24,Dave Hudson,2,63,12,C,1973
9154,32,25,Dave Hudson,9,70,41,C,1974
9155,20,26,Dave Hudson,11,74,31,C,1975
9156,21,27,Dave Hudson,15,73,36,C,1976
9157,22,28,Dave Hudson,10,60,32,C,1977
9158,25,21,Dave Hunter,7,72,32,LW,1978
9159,25,21,Dave Hunter,7,72,32,LW,1978
9160,31,22,Dave Hunter,12,80,43,LW,1979
9161,16,23,Dave Hunter,12,78,28,LW,1980
9162,22,24,Dave Hunter,16,63,38,LW,1981
9163,18,25,Dave Hunter,13,80,31,LW,1982
9164,26,26,Dave Hunter,22,80,48,LW,1983
9165,19,27,Dave Hunter,17,80,36,LW,1984
9166,22,28,Dave Hunter,15,62,37,LW,1985
9167,9,29,Dave Hunter,6,77,15,LW,1986
9168,21,30,Dave Hunter,14,80,35,LW,1987
9169,6,31,Dave Hunter,6,66,12,LW,1988
9170,2,20,Dave Hutchison,0,28,2,D,1972
9171,2,20,Dave Hutchison,0,28,2,D,1972
9172,13,21,Dave Hutchison,0,69,13,D,1973
9173,13,21,Dave Hutchison,0,69,13,D,1973
9174,6,22,Dave Hutchison,0,68,6,D,1974
9175,10,23,Dave Hutchison,0,50,10,D,1975
9176,11,24,Dave Hutchison,6,70,17,D,1976
9177,10,25,Dave Hutchison,0,44,10,D,1977
9178,15,26,Dave Hutchison,4,79,19,D,1978
9179,11,27,Dave Hutchison,1,69,12,D,1979
9180,9,28,Dave Hutchison,2,59,11,D,1980
9181,18,29,Dave Hutchison,5,66,23,D,1981
9182,4,30,Dave Hutchison,1,32,5,D,1982
9183,3,31,Dave Hutchison,0,47,3,D,1983
9184,0,22,Dave Hynes,0,3,0,LW,1973
9185,0,23,Dave Hynes,4,19,4,LW,1974
9186,4,25,Dave Hynes,5,22,9,LW,1976
9187,4,25,Dave Hynes,5,22,9,LW,1976
9188,24,21,Dave Inkpen,4,80,28,D,1975
9189,24,21,Dave Inkpen,4,80,28,D,1975
9190,26,22,Dave Inkpen,7,80,33,D,1976
9191,14,22,Dave Inkpen,3,48,17,D,1976
9192,12,22,Dave Inkpen,4,32,16,D,1976
9193,26,22,Dave Inkpen,7,80,33,D,1976
9194,14,22,Dave Inkpen,3,48,17,D,1976
9195,12,22,Dave Inkpen,4,32,16,D,1976
9196,11,23,Dave Inkpen,1,67,12,D,1977
9197,9,23,Dave Inkpen,1,24,10,D,1977
9198,1,23,Dave Inkpen,0,24,1,D,1977
9199,1,23,Dave Inkpen,0,19,1,D,1977
9200,11,23,Dave Inkpen,1,67,12,D,1977
9201,9,23,Dave Inkpen,1,24,10,D,1977
9202,15,24,Dave Inkpen,1,66,16,D,1978
9203,15,24,Dave Inkpen,1,66,16,D,1978
9204,0,20,Dave Karpa,0,4,0,D,1991
9205,1,21,Dave Karpa,0,12,1,D,1992
9206,12,22,Dave Karpa,5,60,17,D,1993
9207,5,23,Dave Karpa,1,28,6,D,1994
9208,16,24,Dave Karpa,3,72,19,D,1995
9209,11,25,Dave Karpa,2,69,13,D,1996
9210,11,26,Dave Karpa,1,78,12,D,1997
9211,2,27,Dave Karpa,0,33,2,D,1998
9212,4,28,Dave Karpa,1,27,5,D,1999
9213,6,29,Dave Karpa,4,80,10,D,2000
9214,10,30,Dave Karpa,1,75,11,D,2001
9215,2,31,Dave Karpa,0,19,2,D,2002
9216,0,24,Dave Kelly,2,16,2,RW,1976
9217,37,27,Dave Keon,11,67,48,C,1967
9218,34,28,Dave Keon,27,75,61,C,1968
9219,30,29,Dave Keon,32,72,62,C,1969
9220,38,30,Dave Keon,38,76,76,C,1970
9221,30,31,Dave Keon,18,72,48,C,1971
9222,36,32,Dave Keon,37,76,73,C,1972
9223,28,33,Dave Keon,25,74,53,C,1973
9224,43,34,Dave Keon,16,78,59,C,1974
9225,52,39,Dave Keon,10,76,62,C,1979
9226,34,40,Dave Keon,13,80,47,C,1980
9227,11,41,Dave Keon,8,78,19,C,1981
9228,45,35,Dave Keon*,29,69,74,C,1975
9229,45,35,Dave Keon*,29,69,74,C,1975
9230,63,36,Dave Keon*,27,76,90,C,1976
9231,38,36,Dave Keon*,13,42,51,C,1976
9232,25,36,Dave Keon*,14,34,39,C,1976
9233,63,36,Dave Keon*,27,76,90,C,1976
9234,38,36,Dave Keon*,13,42,51,C,1976
9235,25,36,Dave Keon*,14,34,39,C,1976
9236,38,37,Dave Keon*,24,77,62,C,1977
9237,38,37,Dave Keon*,24,77,62,C,1977
9238,43,38,Dave Keon*,22,79,65,C,1978
9239,43,38,Dave Keon*,22,79,65,C,1978
9240,0,21,Dave Kryskow,1,11,1,LW,1972
9241,12,22,Dave Kryskow,7,72,19,LW,1973
9242,19,23,Dave Kryskow,10,69,29,LW,1974
9243,25,24,Dave Kryskow,15,79,40,LW,1975
9244,17,25,Dave Kryskow,16,45,33,LW,1976
9245,17,25,Dave Kryskow,16,45,33,LW,1976
9246,21,26,Dave Kryskow,20,71,41,LW,1977
9247,21,26,Dave Kryskow,20,71,41,LW,1977
9248,16,22,Dave Langevin,7,77,23,D,1976
9249,16,22,Dave Langevin,7,77,23,D,1976
9250,22,23,Dave Langevin,6,62,28,D,1977
9251,22,23,Dave Langevin,6,62,28,D,1977
9252,21,24,Dave Langevin,6,77,27,D,1978
9253,21,24,Dave Langevin,6,77,27,D,1978
9254,13,25,Dave Langevin,3,76,16,D,1979
9255,16,26,Dave Langevin,1,75,17,D,1980
9256,20,27,Dave Langevin,1,73,21,D,1981
9257,17,28,Dave Langevin,4,73,21,D,1982
9258,16,29,Dave Langevin,3,69,19,D,1983
9259,13,30,Dave Langevin,0,56,13,D,1984
9260,8,31,Dave Langevin,0,80,8,D,1985
9261,4,32,Dave Langevin,0,11,4,D,1986
9262,15,20,Dave Lewis,2,66,17,D,1973
9263,14,21,Dave Lewis,5,78,19,D,1974
9264,19,22,Dave Lewis,0,73,19,D,1975
9265,24,23,Dave Lewis,4,79,28,D,1976
9266,11,24,Dave Lewis,3,77,14,D,1977
9267,18,25,Dave Lewis,5,79,23,D,1978
9268,17,26,Dave Lewis,6,73,23,D,1979
9269,12,27,Dave Lewis,1,67,13,D,1980
9270,13,28,Dave Lewis,1,64,14,D,1981
9271,10,29,Dave Lewis,2,79,12,D,1982
9272,5,30,Dave Lewis,2,66,7,D,1983
9273,9,31,Dave Lewis,3,74,12,D,1984
9274,15,32,Dave Lewis,0,69,15,D,1985
9275,5,33,Dave Lewis,2,58,7,D,1986
9276,0,34,Dave Lewis,0,6,0,D,1987
9277,0,21,Dave Logan,0,2,0,D,1975
9278,2,22,Dave Logan,0,34,2,D,1976
9279,5,23,Dave Logan,1,54,6,D,1977
9280,14,24,Dave Logan,1,76,15,D,1978
9281,8,25,Dave Logan,3,45,11,D,1979
9282,0,26,Dave Logan,0,7,0,D,1980
9283,8,20,Dave Lowry,10,73,18,LW,1985
9284,10,21,Dave Lowry,8,70,18,LW,1986
9285,3,22,Dave Lowry,1,22,4,LW,1987
9286,3,23,Dave Lowry,3,21,6,LW,1988
9287,6,24,Dave Lowry,19,78,25,LW,1989
9288,21,25,Dave Lowry,19,79,40,LW,1990
9289,13,26,Dave Lowry,7,75,20,LW,1991
9290,8,27,Dave Lowry,5,58,13,LW,1992
9291,22,28,Dave Lowry,15,80,37,LW,1993
9292,10,29,Dave Lowry,10,45,20,LW,1994
9293,14,30,Dave Lowry,10,63,24,LW,1995
9294,14,31,Dave Lowry,15,77,29,LW,1996
9295,4,32,Dave Lowry,4,57,8,LW,1997
9296,9,33,Dave Lowry,6,61,15,LW,1998
9297,4,34,Dave Lowry,1,32,5,LW,1999
9298,17,35,Dave Lowry,18,79,35,LW,2000
9299,6,36,Dave Lowry,7,62,13,LW,2001
9300,14,37,Dave Lowry,5,34,19,LW,2002
9301,1,38,Dave Lowry,1,18,2,LW,2003
9302,0,24,Dave Lumley,0,3,0,RW,1978
9303,38,25,Dave Lumley,20,80,58,RW,1979
9304,9,26,Dave Lumley,7,53,16,RW,1980
9305,42,27,Dave Lumley,32,66,74,RW,1981
9306,24,28,Dave Lumley,13,72,37,RW,1982
9307,15,29,Dave Lumley,6,56,21,RW,1983
9308,23,30,Dave Lumley,9,60,32,RW,1984
9309,9,31,Dave Lumley,11,46,20,RW,1985
9310,0,32,Dave Lumley,0,1,0,RW,1986
9311,2,18,Dave Maloney,0,4,2,D,1974
9312,3,19,Dave Maloney,1,21,4,D,1975
9313,18,20,Dave Maloney,3,66,21,D,1976
9314,19,21,Dave Maloney,2,56,21,D,1977
9315,17,22,Dave Maloney,11,76,28,D,1978
9316,25,23,Dave Maloney,12,77,37,D,1979
9317,36,24,Dave Maloney,11,79,47,D,1980
9318,36,25,Dave Maloney,13,64,49,D,1981
9319,42,26,Dave Maloney,8,78,50,D,1982
9320,26,27,Dave Maloney,7,68,33,D,1983
9321,22,28,Dave Maloney,3,68,25,D,1984
9322,8,20,Dave Manson,1,63,9,D,1986
9323,6,21,Dave Manson,1,54,7,D,1987
9324,36,22,Dave Manson,18,79,54,D,1988
9325,23,23,Dave Manson,5,59,28,D,1989
9326,15,24,Dave Manson,14,75,29,D,1990
9327,32,25,Dave Manson,15,79,47,D,1991
9328,30,26,Dave Manson,15,83,45,D,1992
9329,17,27,Dave Manson,4,70,21,D,1993
9330,15,28,Dave Manson,3,44,18,D,1994
9331,23,29,Dave Manson,7,82,30,D,1995
9332,18,30,Dave Manson,4,75,22,D,1996
9333,30,31,Dave Manson,4,81,34,D,1997
9334,17,32,Dave Manson,6,75,23,D,1998
9335,9,33,Dave Manson,1,63,10,D,1999
9336,7,34,Dave Manson,4,74,11,D,2000
9337,2,35,Dave Manson,0,47,2,D,2001
9338,1,23,Dave Marcinyshyn,0,9,1,D,1990
9339,0,24,Dave Marcinyshyn,0,5,0,D,1991
9340,0,25,Dave Marcinyshyn,0,2,0,D,1992
9341,8,21,Dave McLlwain,11,66,19,C,1987
9342,2,22,Dave McLlwain,1,24,3,C,1988
9343,26,23,Dave McLlwain,25,80,51,C,1989
9344,11,24,Dave McLlwain,14,60,25,C,1990
9345,18,25,Dave McLlwain,10,73,28,C,1991
9346,4,26,Dave McLlwain,14,66,18,C,1992
9347,26,27,Dave McLlwain,17,66,43,LW,1993
9348,6,28,Dave McLlwain,5,43,11,C,1994
9349,5,29,Dave McLlwain,2,19,7,RW,1995
9350,1,30,Dave McLlwain,1,4,2,C,1996
9351,0,19,Dave Michayluk,0,1,0,RW,1981
9352,6,20,Dave Michayluk,2,13,8,RW,1982
9353,0,20,Dave Morisset,0,4,0,RW,2001
9354,0,27,Dave Morissette,0,10,0,LW,1998
9355,0,28,Dave Morissette,0,1,0,LW,1999
9356,0,18,Dave Morrison,0,3,0,RW,1980
9357,0,19,Dave Morrison,0,4,0,RW,1981
9358,3,20,Dave Morrison,3,24,6,RW,1982
9359,0,22,Dave Morrison,0,8,0,RW,1984
9360,10,21,Dave Morrow,2,10,12,C,1978
9361,10,21,Dave Morrow,2,10,12,C,1978
9362,8,25,Dave Moss,10,41,18,LW,2006
9363,7,26,Dave Moss,4,41,11,RW,2007
9364,19,27,Dave Moss,20,81,39,RW,2008
9365,9,28,Dave Moss,8,64,17,LW,2009
9366,13,29,Dave Moss,17,58,30,LW,2010
9367,7,30,Dave Moss,2,32,9,LW,2011
9368,15,31,Dave Moss,5,45,20,LW,2012
9369,14,32,Dave Moss,8,79,22,RW,2013
9370,0,21,Dave Orleski,0,1,0,LW,1980
9371,0,22,Dave Orleski,0,1,0,LW,1981
9372,19,19,Dave Pasin,18,71,37,RW,1985
9373,0,22,Dave Pasin,0,5,0,RW,1988
9374,16,20,Dave Pichette,4,46,20,D,1980
9375,30,21,Dave Pichette,7,67,37,D,1981
9376,21,22,Dave Pichette,3,53,24,D,1982
9377,18,23,Dave Pichette,2,46,20,D,1983
9378,40,24,Dave Pichette,17,71,57,D,1984
9379,12,25,Dave Pichette,7,33,19,D,1985
9380,3,27,Dave Pichette,1,6,4,D,1987
9381,0,24,Dave Poulin,2,2,2,C,1982
9382,45,25,Dave Poulin,31,73,76,LW,1983
9383,44,26,Dave Poulin,30,73,74,C,1984
9384,42,27,Dave Poulin,27,79,69,C,1985
9385,45,28,Dave Poulin,25,75,70,C,1986
9386,32,29,Dave Poulin,19,68,51,C,1987
9387,17,30,Dave Poulin,18,69,35,C,1988
9388,27,31,Dave Poulin,15,60,42,C,1989
9389,12,32,Dave Poulin,8,31,20,C,1990
9390,4,33,Dave Poulin,4,18,8,C,1991
9391,33,34,Dave Poulin,16,84,49,C,1992
9392,19,35,Dave Poulin,6,63,25,C,1993
9393,5,36,Dave Poulin,4,29,9,LW,1994
9394,0,23,Dave Pulkkinen,0,2,0,D,1972
9395,0,19,Dave Reid,1,8,1,LW,1983
9396,13,20,Dave Reid,14,35,27,LW,1984
9397,10,21,Dave Reid,10,37,20,LW,1985
9398,3,22,Dave Reid,3,12,6,LW,1986
9399,0,23,Dave Reid,0,3,0,LW,1987
9400,21,24,Dave Reid,9,77,30,LW,1988
9401,19,25,Dave Reid,9,70,28,LW,1989
9402,13,26,Dave Reid,15,69,28,LW,1990
9403,7,27,Dave Reid,7,43,14,C,1991
9404,16,28,Dave Reid,20,65,36,LW,1992
9405,17,29,Dave Reid,6,83,23,LW,1993
9406,5,30,Dave Reid,5,38,10,C,1994
9407,21,31,Dave Reid,23,63,44,C,1995
9408,20,32,Dave Reid,19,82,39,LW,1996
9409,12,33,Dave Reid,6,65,18,LW,1997
9410,11,34,Dave Reid,6,73,17,LW,1998
9411,7,35,Dave Reid,11,65,18,LW,1999
9412,9,36,Dave Reid,1,73,10,RW,2000
9413,0,24,Dave Reierson,0,2,0,D,1988
9414,0,27,Dave Richardson,0,1,0,LW,1967
9415,0,21,Dave Richter,0,3,0,D,1981
9416,0,22,Dave Richter,0,6,0,D,1982
9417,3,23,Dave Richter,2,42,5,D,1983
9418,8,24,Dave Richter,2,55,10,D,1984
9419,5,25,Dave Richter,0,64,5,D,1985
9420,15,26,Dave Richter,2,78,17,D,1986
9421,4,27,Dave Richter,2,49,6,D,1987
9422,5,28,Dave Richter,1,66,6,D,1988
9423,0,29,Dave Richter,0,2,0,D,1989
9424,7,20,Dave Roche,7,71,14,LW,1995
9425,5,21,Dave Roche,5,61,10,LW,1996
9426,3,23,Dave Roche,3,36,6,C,1998
9427,0,24,Dave Roche,0,2,0,LW,1999
9428,0,26,Dave Roche,0,1,0,LW,2001
9429,11,21,Dave Scatchard,13,76,24,C,1997
9430,13,22,Dave Scatchard,13,82,26,C,1998
9431,18,23,Dave Scatchard,12,65,30,C,1999
9432,24,24,Dave Scatchard,21,81,45,C,2000
9433,15,25,Dave Scatchard,12,80,27,RW,2001
9434,18,26,Dave Scatchard,27,81,45,RW,2002
9435,16,27,Dave Scatchard,9,61,25,C,2003
9436,18,29,Dave Scatchard,15,63,33,C,2005
9437,5,30,Dave Scatchard,3,46,8,C,2006
9438,2,33,Dave Scatchard,3,16,5,C,2009
9439,1,34,Dave Scatchard,0,8,1,C,2010
9440,0,22,Dave Schultz,0,1,0,LW,1971
9441,12,23,Dave Schultz,9,76,21,LW,1972
9442,16,24,Dave Schultz,20,73,36,LW,1973
9443,17,25,Dave Schultz,9,76,26,LW,1974
9444,19,26,Dave Schultz,13,71,32,LW,1975
9445,20,27,Dave Schultz,10,76,30,LW,1976
9446,25,28,Dave Schultz,11,74,36,LW,1977
9447,12,29,Dave Schultz,6,75,18,LW,1978
9448,0,30,Dave Schultz,1,13,1,C,1979
9449,6,20,Dave Semenko,6,65,12,LW,1977
9450,6,20,Dave Semenko,6,65,12,LW,1977
9451,14,21,Dave Semenko,10,77,24,RW,1978
9452,14,21,Dave Semenko,10,77,24,RW,1978
9453,7,22,Dave Semenko,6,67,13,LW,1979
9454,8,23,Dave Semenko,11,58,19,LW,1980
9455,12,24,Dave Semenko,12,59,24,LW,1981
9456,15,25,Dave Semenko,12,75,27,LW,1982
9457,11,26,Dave Semenko,6,52,17,LW,1983
9458,12,27,Dave Semenko,6,69,18,LW,1984
9459,12,28,Dave Semenko,6,69,18,LW,1985
9460,8,29,Dave Semenko,4,56,12,LW,1986
9461,3,30,Dave Semenko,2,70,5,LW,1987
9462,11,20,Dave Shand,5,55,16,D,1976
9463,23,21,Dave Shand,2,80,25,D,1977
9464,22,22,Dave Shand,4,79,26,D,1978
9465,7,23,Dave Shand,3,74,10,D,1979
9466,4,24,Dave Shand,0,47,4,D,1980
9467,1,26,Dave Shand,0,1,1,D,1982
9468,15,27,Dave Shand,4,72,19,D,1983
9469,1,28,Dave Shand,1,13,2,D,1984
9470,0,22,Dave Silk,0,2,0,RW,1979
9471,12,23,Dave Silk,14,59,26,RW,1980
9472,20,24,Dave Silk,15,64,35,RW,1981
9473,1,25,Dave Silk,1,16,2,C,1982
9474,17,26,Dave Silk,13,35,30,RW,1983
9475,5,27,Dave Silk,9,41,14,RW,1984
9476,4,28,Dave Silk,2,32,6,RW,1985
9477,16,23,Dave Snuggerud,14,80,30,RW,1989
9478,15,24,Dave Snuggerud,9,80,24,C,1990
9479,16,25,Dave Snuggerud,3,66,19,LW,1991
9480,7,26,Dave Snuggerud,4,39,11,RW,1992
9481,11,21,Dave Syvret,1,50,12,D,1975
9482,11,21,Dave Syvret,1,50,12,D,1975
9483,0,22,Dave Syvret,0,8,0,D,1976
9484,0,22,Dave Syvret,0,8,0,D,1976
9485,21,22,Dave Taylor,22,64,43,RW,1977
9486,48,23,Dave Taylor,43,78,91,RW,1978
9487,53,24,Dave Taylor,37,61,90,RW,1979
9488,65,25,Dave Taylor,47,72,112,RW,1980
9489,67,26,Dave Taylor,39,78,106,RW,1981
9490,37,27,Dave Taylor,21,46,58,RW,1982
9491,49,28,Dave Taylor,20,63,69,RW,1983
9492,51,29,Dave Taylor,41,79,92,RW,1984
9493,38,30,Dave Taylor,33,76,71,RW,1985
9494,44,31,Dave Taylor,18,67,62,RW,1986
9495,41,32,Dave Taylor,26,68,67,RW,1987
9496,37,33,Dave Taylor,26,70,63,RW,1988
9497,26,34,Dave Taylor,15,58,41,RW,1989
9498,30,35,Dave Taylor,23,73,53,RW,1990
9499,19,36,Dave Taylor,10,77,29,RW,1991
9500,9,37,Dave Taylor,6,48,15,RW,1992
9501,3,38,Dave Taylor,4,33,7,RW,1993
9502,2,23,Dave Thomlinson,1,19,3,LW,1989
9503,0,24,Dave Thomlinson,0,3,0,LW,1990
9504,1,25,Dave Thomlinson,0,12,1,LW,1991
9505,0,27,Dave Thomlinson,0,7,0,RW,1993
9506,0,28,Dave Thomlinson,0,1,0,LW,1994
9507,2,22,Dave Tippett,4,17,6,C,1983
9508,12,23,Dave Tippett,7,80,19,LW,1984
9509,20,24,Dave Tippett,14,80,34,LW,1985
9510,22,25,Dave Tippett,9,80,31,LW,1986
9511,21,26,Dave Tippett,16,80,37,LW,1987
9512,24,27,Dave Tippett,17,80,41,LW,1988
9513,19,28,Dave Tippett,8,66,27,LW,1989
9514,9,29,Dave Tippett,6,61,15,LW,1990
9515,10,30,Dave Tippett,2,30,12,LW,1991
9516,19,31,Dave Tippett,6,74,25,C,1992
9517,11,32,Dave Tippett,4,73,15,C,1993
9518,0,22,Dave Tomlinson,0,3,0,C,1991
9519,0,23,Dave Tomlinson,0,3,0,C,1992
9520,3,24,Dave Tomlinson,1,31,4,C,1993
9521,0,25,Dave Tomlinson,0,5,0,C,1994
9522,1,21,Dave Walter,0,4,1,C,1973
9523,1,21,Dave Walter,0,4,1,C,1973
9524,0,22,Dave Walter,1,6,1,C,1974
9525,0,22,Dave Walter,1,6,1,C,1974
9526,2,23,Dave Walter,1,16,3,C,1975
9527,2,23,Dave Walter,1,16,3,C,1975
9528,0,21,Dave Watson,0,5,0,LW,1979
9529,1,22,Dave Watson,0,13,1,LW,1980
9530,4,19,David A Jensen,0,13,4,C,1984
9531,0,20,David A Jensen,1,5,1,C,1985
9532,8,21,David A Jensen,8,46,16,C,1986
9533,1,22,David A Jensen,0,5,1,C,1987
9534,13,22,David Backes,10,49,23,C,2006
9535,18,23,David Backes,13,72,31,RW,2007
9536,23,24,David Backes,31,82,54,RW,2008
9537,31,25,David Backes,17,79,48,RW,2009
9538,31,26,David Backes,31,82,62,RW,2010
9539,30,27,David Backes,24,82,54,RW,2011
9540,22,28,David Backes,6,48,28,RW,2012
9541,30,29,David Backes,27,74,57,C,2013
9542,32,30,David Backes,26,80,58,RW,2014
9543,24,31,David Backes,21,79,45,C,2015
9544,21,32,David Backes,17,74,38,RW,2016
9545,19,33,David Backes,14,57,33,RW,2017
9546,7,22,David Booth,3,48,10,LW,2006
9547,18,23,David Booth,22,73,40,LW,2007
9548,29,24,David Booth,31,72,60,LW,2008
9549,8,25,David Booth,8,28,16,LW,2009
9550,17,26,David Booth,23,82,40,LW,2010
9551,14,27,David Booth,16,62,30,LW,2011
9552,2,28,David Booth,1,12,3,LW,2012
9553,10,29,David Booth,9,66,19,LW,2013
9554,6,30,David Booth,7,59,13,LW,2014
9555,1,33,David Booth,4,28,5,LW,2017
9556,1,23,David Brine,0,9,1,C,2007
9557,1,21,David Broll,0,5,1,LW,2013
9558,1,21,David Bruce,0,12,1,RW,1985
9559,7,22,David Bruce,9,50,16,RW,1986
9560,3,23,David Bruce,7,28,10,RW,1987
9561,7,24,David Bruce,7,53,14,RW,1988
9562,2,26,David Bruce,1,12,3,RW,1990
9563,16,27,David Bruce,22,60,38,RW,1991
9564,3,28,David Bruce,2,17,5,RW,1992
9565,0,29,David Bruce,0,2,0,LW,1993
9566,1,22,David Clarkson,3,7,4,RW,2006
9567,13,23,David Clarkson,9,81,22,RW,2007
9568,15,24,David Clarkson,17,82,32,RW,2008
9569,13,25,David Clarkson,11,46,24,RW,2009
9570,6,26,David Clarkson,12,82,18,RW,2010
9571,16,27,David Clarkson,30,80,46,RW,2011
9572,9,28,David Clarkson,15,48,24,RW,2012
9573,6,29,David Clarkson,5,60,11,RW,2013
9574,5,30,David Clarkson,10,61,15,RW,2014
9575,2,31,David Clarkson,2,23,4,RW,2015
9576,3,23,David Cooper,3,19,6,D,1996
9577,4,24,David Cooper,0,9,4,D,1997
9578,0,27,David Cooper,0,2,0,D,2000
9579,0,24,David Cullen,0,2,0,D,2000
9580,0,25,David Cullen,0,17,0,D,2001
9581,1,23,David Desharnais,0,6,1,C,2009
9582,14,24,David Desharnais,8,43,22,C,2010
9583,44,25,David Desharnais,16,81,60,C,2011
9584,18,26,David Desharnais,10,48,28,C,2012
9585,36,27,David Desharnais,16,79,52,C,2013
9586,34,28,David Desharnais,14,82,48,C,2014
9587,18,29,David Desharnais,11,65,29,C,2015
9588,2,30,David Desharnais,2,18,4,C,2016
9589,22,31,David Desharnais,6,71,28,C,2017
9590,0,23,David Dziurzynski,2,12,2,C,2012
9591,3,26,David Dziurzynski,1,14,4,LW,2015
9592,0,24,David Emma,0,2,0,C,1992
9593,5,25,David Emma,5,15,10,C,1993
9594,1,26,David Emma,0,6,1,RW,1994
9595,0,28,David Emma,0,5,0,C,1996
9596,0,32,David Emma,0,6,0,RW,2000
9597,8,22,David Fenyves,0,24,8,D,1982
9598,4,23,David Fenyves,0,10,4,D,1983
9599,8,24,David Fenyves,1,60,9,D,1984
9600,7,25,David Fenyves,0,47,7,D,1985
9601,0,26,David Fenyves,1,7,1,D,1986
9602,0,27,David Fenyves,0,5,0,D,1987
9603,1,28,David Fenyves,0,1,1,D,1988
9604,0,29,David Fenyves,0,12,0,D,1989
9605,4,30,David Fenyves,1,40,5,D,1990
9606,1,22,David Gosselin,2,10,3,RW,1999
9607,0,24,David Gosselin,0,3,0,RW,2001
9608,1,27,David Gove,0,1,1,C,2005
9609,0,28,David Gove,0,1,0,LW,2006
9610,1,22,David H Jensen,0,8,1,D,1983
9611,1,23,David H Jensen,0,5,1,D,1984
9612,0,24,David H Jensen,0,5,0,D,1985
9613,0,22,David Haas,1,5,1,LW,1990
9614,1,25,David Haas,1,2,2,LW,1993
9615,4,22,David Hale,0,65,4,D,2003
9616,4,24,David Hale,0,38,4,D,2005
9617,1,25,David Hale,0,54,1,D,2006
9618,2,26,David Hale,0,58,2,D,2007
9619,6,27,David Hale,3,48,9,D,2008
9620,4,28,David Hale,0,39,4,D,2009
9621,4,29,David Hale,1,25,5,D,2010
9622,0,22,David Harlock,0,6,0,D,1993
9623,0,23,David Harlock,0,1,0,D,1994
9624,0,24,David Harlock,0,1,0,D,1995
9625,0,26,David Harlock,0,6,0,D,1997
9626,6,27,David Harlock,2,70,8,D,1998
9627,6,28,David Harlock,0,44,6,D,1999
9628,1,29,David Harlock,0,65,1,D,2000
9629,1,30,David Harlock,0,19,1,D,2001
9630,4,23,David Jones,2,27,6,RW,2007
9631,5,24,David Jones,8,40,13,RW,2008
9632,6,25,David Jones,10,23,16,RW,2009
9633,18,26,David Jones,27,77,45,RW,2010
9634,17,27,David Jones,20,72,37,RW,2011
9635,6,28,David Jones,3,33,9,RW,2012
9636,8,29,David Jones,9,48,17,RW,2013
9637,16,30,David Jones,14,67,30,RW,2014
9638,7,31,David Jones,11,75,18,RW,2015
9639,7,23,David Kampf,4,46,11,C,2017
9640,0,25,David Koci,0,9,0,LW,2006
9641,0,26,David Koci,0,18,0,LW,2007
9642,1,27,David Koci,1,37,2,LW,2008
9643,0,28,David Koci,1,43,1,D,2009
9644,0,29,David Koci,1,35,1,D,2010
9645,0,20,David Krejci,0,6,0,C,2006
9646,21,21,David Krejci,6,56,27,C,2007
9647,51,22,David Krejci,22,82,73,C,2008
9648,35,23,David Krejci,17,79,52,C,2009
9649,49,24,David Krejci,13,75,62,C,2010
9650,39,25,David Krejci,23,79,62,C,2011
9651,23,26,David Krejci,10,47,33,C,2012
9652,50,27,David Krejci,19,80,69,C,2013
9653,24,28,David Krejci,7,47,31,C,2014
9654,46,29,David Krejci,17,72,63,C,2015
9655,31,30,David Krejci,23,82,54,C,2016
9656,27,31,David Krejci,17,64,44,C,2017
9657,1,23,David Laliberte,2,11,3,RW,2009
9658,0,19,David Latta,0,1,0,LW,1985
9659,0,21,David Latta,0,10,0,LW,1987
9660,8,22,David Latta,4,24,12,LW,1988
9661,0,24,David Latta,0,1,0,LW,1990
9662,0,18,David Legwand,0,1,0,C,1998
9663,15,19,David Legwand,13,71,28,C,1999
9664,28,20,David Legwand,13,81,41,C,2000
9665,19,21,David Legwand,11,63,30,C,2001
9666,31,22,David Legwand,17,64,48,C,2002
9667,29,23,David Legwand,18,82,47,C,2003
9668,19,25,David Legwand,7,44,26,C,2005
9669,36,26,David Legwand,27,78,63,C,2006
9670,29,27,David Legwand,15,65,44,C,2007
9671,22,28,David Legwand,20,73,42,C,2008
9672,27,29,David Legwand,11,82,38,C,2009
9673,24,30,David Legwand,17,64,41,C,2010
9674,34,31,David Legwand,19,78,53,C,2011
9675,13,32,David Legwand,12,48,25,C,2012
9676,37,33,David Legwand,14,83,51,C,2013
9677,18,34,David Legwand,9,80,27,C,2014
9678,9,35,David Legwand,5,79,14,C,2015
9679,0,21,David Liffiton,0,1,0,D,2005
9680,0,22,David Liffiton,0,2,0,D,2006
9681,0,26,David Liffiton,1,4,1,D,2010
9682,0,22,David Ling,0,2,0,RW,1996
9683,0,23,David Ling,0,1,0,RW,1997
9684,0,27,David Ling,0,5,0,RW,2001
9685,2,28,David Ling,3,35,5,RW,2002
9686,2,29,David Ling,1,50,3,RW,2003
9687,3,21,David Mackey,1,23,4,LW,1987
9688,2,22,David Mackey,1,23,3,LW,1988
9689,0,23,David Mackey,2,16,2,LW,1989
9690,0,25,David Mackey,1,19,1,LW,1991
9691,4,26,David Mackey,1,15,5,LW,1992
9692,3,27,David Mackey,2,30,5,LW,1993
9693,0,22,David Maley,0,3,0,LW,1985
9694,12,23,David Maley,6,48,18,C,1986
9695,2,24,David Maley,4,44,6,C,1987
9696,6,25,David Maley,5,68,11,RW,1988
9697,17,26,David Maley,8,67,25,LW,1989
9698,14,27,David Maley,8,64,22,LW,1990
9699,17,28,David Maley,10,60,27,LW,1991
9700,7,29,David Maley,2,56,9,LW,1992
9701,6,30,David Maley,0,56,6,LW,1993
9702,1,24,David McIntyre,1,7,2,C,2011
9703,0,26,David Moravec,0,1,0,RW,1999
9704,8,33,David Moss,4,60,12,RW,2014
9705,2,21,David Musil,0,4,2,D,2014
9706,2,19,David Nemirovsky,0,9,2,RW,1995
9707,7,20,David Nemirovsky,7,39,14,RW,1996
9708,12,21,David Nemirovsky,9,41,21,RW,1997
9709,1,22,David Nemirovsky,0,2,1,RW,1998
9710,14,23,David Oliver,16,44,30,RW,1994
9711,19,24,David Oliver,20,80,39,RW,1995
9712,3,25,David Oliver,3,31,6,RW,1996
9713,5,27,David Oliver,2,17,7,RW,1998
9714,0,28,David Oliver,1,9,1,RW,1999
9715,0,29,David Oliver,0,7,0,RW,2000
9716,3,31,David Oliver,0,6,3,RW,2002
9717,5,32,David Oliver,7,36,12,RW,2003
9718,0,34,David Oliver,0,3,0,RW,2005
9719,17,18,David Pastrnak,10,46,27,RW,2014
9720,11,19,David Pastrnak,15,51,26,RW,2015
9721,36,20,David Pastrnak,34,75,70,RW,2016
9722,45,21,David Pastrnak,35,82,80,RW,2017
9723,14,19,David Perron,13,62,27,LW,2007
9724,35,20,David Perron,15,81,50,LW,2008
9725,27,21,David Perron,20,82,47,LW,2009
9726,2,22,David Perron,5,10,7,LW,2010
9727,21,23,David Perron,21,57,42,LW,2011
9728,15,24,David Perron,10,48,25,LW,2012
9729,29,25,David Perron,28,78,57,LW,2013
9730,24,26,David Perron,17,81,41,LW,2014
9731,24,27,David Perron,12,71,36,LW,2015
9732,28,28,David Perron,18,82,46,LW,2016
9733,50,29,David Perron,16,70,66,LW,2017
9734,0,25,David Printz,0,1,0,D,2005
9735,0,26,David Printz,0,12,0,D,2006
9736,0,23,David Roberts,0,1,0,LW,1993
9737,5,24,David Roberts,6,19,11,LW,1994
9738,10,25,David Roberts,3,34,13,LW,1995
9739,17,26,David Roberts,10,58,27,LW,1996
9740,1,27,David Roberts,1,13,2,LW,1997
9741,6,21,David Rundblad,1,30,7,D,2011
9742,1,22,David Rundblad,0,8,1,D,2012
9743,1,23,David Rundblad,0,17,1,D,2013
9744,11,24,David Rundblad,3,49,14,D,2014
9745,2,25,David Rundblad,0,9,2,D,2015
9746,1,23,David Sacco,1,4,2,RW,1993
9747,2,24,David Sacco,0,8,2,LW,1994
9748,10,25,David Sacco,4,23,14,LW,1995
9749,13,21,David Saunders,7,56,20,LW,1987
9750,8,21,David Savard,2,31,10,D,2011
9751,0,22,David Savard,0,4,0,D,2012
9752,10,23,David Savard,5,70,15,D,2013
9753,25,24,David Savard,11,82,36,D,2014
9754,21,25,David Savard,4,65,25,D,2015
9755,17,26,David Savard,6,74,23,D,2016
9756,12,27,David Savard,4,81,16,D,2017
9757,1,21,David Schlemko,0,3,1,D,2008
9758,4,22,David Schlemko,1,17,5,D,2009
9759,10,23,David Schlemko,4,43,14,D,2010
9760,10,24,David Schlemko,1,46,11,D,2011
9761,5,25,David Schlemko,1,30,6,D,2012
9762,8,26,David Schlemko,1,48,9,D,2013
9763,3,27,David Schlemko,1,44,4,D,2014
9764,13,28,David Schlemko,6,67,19,D,2015
9765,16,29,David Schlemko,2,62,18,D,2016
9766,4,30,David Schlemko,1,37,5,D,2017
9767,0,18,David Shaw,0,2,0,D,1982
9768,0,19,David Shaw,0,3,0,D,1983
9769,0,20,David Shaw,0,14,0,D,1984
9770,19,21,David Shaw,7,73,26,D,1985
9771,19,22,David Shaw,0,75,19,D,1986
9772,25,23,David Shaw,7,68,32,D,1987
9773,11,24,David Shaw,6,63,17,D,1988
9774,10,25,David Shaw,2,22,12,D,1989
9775,10,26,David Shaw,2,77,12,D,1990
9776,9,27,David Shaw,1,59,10,D,1991
9777,14,28,David Shaw,10,77,24,D,1992
9778,9,29,David Shaw,1,55,10,D,1993
9779,4,30,David Shaw,3,44,7,D,1994
9780,11,31,David Shaw,1,66,12,D,1995
9781,10,32,David Shaw,1,57,11,D,1996
9782,2,33,David Shaw,0,14,2,D,1997
9783,0,23,David Sloane,0,1,0,RW,2008
9784,0,23,David Steckel,0,7,0,LW,2005
9785,0,24,David Steckel,0,5,0,LW,2006
9786,7,25,David Steckel,5,67,12,C,2007
9787,11,26,David Steckel,8,76,19,C,2008
9788,11,27,David Steckel,5,79,16,C,2009
9789,6,28,David Steckel,6,75,12,C,2010
9790,5,29,David Steckel,8,76,13,C,2011
9791,6,30,David Steckel,1,34,7,C,2012
9792,0,31,David Steckel,0,6,0,C,2013
9793,0,22,David Struch,0,4,0,C,1993
9794,0,19,David Tanabe,4,31,4,D,1999
9795,22,20,David Tanabe,7,74,29,D,2000
9796,15,21,David Tanabe,1,78,16,D,2001
9797,10,22,David Tanabe,3,68,13,D,2002
9798,7,23,David Tanabe,5,45,12,D,2003
9799,16,25,David Tanabe,4,75,20,D,2005
9800,12,26,David Tanabe,5,60,17,D,2006
9801,2,27,David Tanabe,1,18,3,D,2007
9802,4,22,David Ullstrom,4,29,8,LW,2011
9803,3,23,David Ullstrom,2,20,5,LW,2012
9804,2,25,David Van Der Gulik,0,6,2,LW,2008
9805,2,27,David Van Der Gulik,1,6,3,RW,2010
9806,5,28,David Van Der Gulik,1,25,6,RW,2011
9807,2,29,David Van Der Gulik,0,9,2,RW,2012
9808,0,30,David Van Der Gulik,0,2,0,LW,2013
9809,0,31,David Van Der Gulik,0,1,0,LW,2014
9810,0,24,David Van Drunen,0,1,0,D,1999
9811,34,22,David Volek,25,77,59,LW,1988
9812,22,23,David Volek,17,80,39,RW,1989
9813,34,24,David Volek,22,77,56,LW,1990
9814,42,25,David Volek,18,74,60,RW,1991
9815,13,26,David Volek,8,56,21,LW,1992
9816,9,27,David Volek,5,32,14,LW,1993
9817,19,26,David Vyborny,13,79,32,RW,2000
9818,18,27,David Vyborny,13,75,31,LW,2001
9819,26,28,David Vyborny,20,79,46,LW,2002
9820,31,29,David Vyborny,22,82,53,RW,2003
9821,43,31,David Vyborny,22,80,65,LW,2005
9822,48,32,David Vyborny,16,82,64,RW,2006
9823,19,33,David Vyborny,7,66,26,RW,2007
9824,1,23,David Warsofsky,1,6,2,D,2013
9825,1,24,David Warsofsky,0,4,1,D,2014
9826,1,25,David Warsofsky,1,22,2,D,2015
9827,1,26,David Warsofsky,0,7,1,D,2016
9828,5,27,David Warsofsky,0,16,5,D,2017
9829,0,20,David Wilkie,0,1,0,D,1994
9830,5,21,David Wilkie,1,24,6,D,1995
9831,9,22,David Wilkie,6,61,15,D,1996
9832,5,23,David Wilkie,2,34,7,D,1997
9833,7,24,David Wilkie,1,46,8,D,1998
9834,0,26,David Wilkie,0,1,0,D,2000
9835,25,24,David Williams,3,56,28,D,1991
9836,11,25,David Williams,1,40,12,D,1992
9837,15,26,David Williams,5,56,20,D,1993
9838,2,27,David Williams,2,21,4,D,1994
9839,0,25,David Wolf,0,3,0,LW,2014
9840,3,24,Davis Drewiske,0,17,3,D,2008
9841,7,25,Davis Drewiske,1,42,8,D,2009
9842,5,26,Davis Drewiske,0,38,5,D,2010
9843,0,27,Davis Drewiske,2,9,2,D,2011
9844,5,28,Davis Drewiske,2,29,7,D,2012
9845,0,25,Davis Payne,0,7,0,LW,1995
9846,1,26,Davis Payne,0,15,1,LW,1996
9847,1,19,Daymond Langkow,0,4,1,C,1995
9848,13,20,Daymond Langkow,15,79,28,C,1996
9849,14,21,Daymond Langkow,8,68,22,C,1997
9850,19,22,Daymond Langkow,14,78,33,C,1998
9851,32,23,Daymond Langkow,18,82,50,C,1999
9852,41,24,Daymond Langkow,13,71,54,C,2000
9853,35,25,Daymond Langkow,27,80,62,C,2001
9854,32,26,Daymond Langkow,20,82,52,C,2002
9855,31,27,Daymond Langkow,21,81,52,C,2003
9856,34,29,Daymond Langkow,25,82,59,C,2005
9857,44,30,Daymond Langkow,33,81,77,C,2006
9858,35,31,Daymond Langkow,30,80,65,C,2007
9859,28,32,Daymond Langkow,21,73,49,C,2008
9860,23,33,Daymond Langkow,14,72,37,C,2009
9861,1,34,Daymond Langkow,0,4,1,C,2010
9862,19,35,Daymond Langkow,11,73,30,C,2011
9863,0,29,Dean Arsene,0,13,0,D,2009
9864,5,23,Dean Boylan,1,61,6,D,1973
9865,5,23,Dean Boylan,1,61,6,D,1973
9866,0,24,Dean Boylan,0,3,0,D,1974
9867,0,24,Dean Boylan,0,3,0,D,1974
9868,0,20,Dean Chynoweth,0,6,0,D,1988
9869,2,21,Dean Chynoweth,0,20,2,D,1989
9870,1,22,Dean Chynoweth,1,25,2,D,1990
9871,0,23,Dean Chynoweth,1,11,1,D,1991
9872,4,25,Dean Chynoweth,0,39,4,D,1993
9873,2,26,Dean Chynoweth,0,32,2,D,1994
9874,6,27,Dean Chynoweth,2,49,8,D,1995
9875,3,28,Dean Chynoweth,0,57,3,D,1996
9876,0,29,Dean Chynoweth,0,2,0,D,1997
9877,0,20,Dean Clark,0,1,0,D,1983
9878,2,20,Dean Defazio,0,22,2,LW,1983
9879,0,19,Dean Evason,0,2,0,C,1983
9880,4,20,Dean Evason,3,17,7,C,1984
9881,28,21,Dean Evason,20,55,48,C,1985
9882,37,22,Dean Evason,22,80,59,C,1986
9883,18,23,Dean Evason,10,77,28,C,1987
9884,17,24,Dean Evason,11,67,28,C,1988
9885,25,25,Dean Evason,18,78,43,C,1989
9886,23,26,Dean Evason,6,75,29,C,1990
9887,15,27,Dean Evason,11,74,26,C,1991
9888,19,28,Dean Evason,12,84,31,C,1992
9889,33,29,Dean Evason,11,80,44,C,1993
9890,7,30,Dean Evason,8,47,15,C,1994
9891,7,31,Dean Evason,7,67,14,C,1995
9892,6,20,Dean Hopkins,8,60,14,RW,1979
9893,18,21,Dean Hopkins,8,67,26,RW,1980
9894,13,22,Dean Hopkins,2,41,15,RW,1981
9895,12,23,Dean Hopkins,5,49,17,RW,1982
9896,0,26,Dean Hopkins,0,1,0,RW,1985
9897,2,29,Dean Hopkins,0,5,2,RW,1988
9898,0,24,Dean Jenkins,0,5,0,RW,1983
9899,12,20,Dean Kennedy,0,55,12,D,1982
9900,5,21,Dean Kennedy,1,37,6,D,1983
9901,10,23,Dean Kennedy,2,78,12,D,1985
9902,14,24,Dean Kennedy,6,66,20,D,1986
9903,11,25,Dean Kennedy,1,58,12,D,1987
9904,11,26,Dean Kennedy,3,67,14,D,1988
9905,12,27,Dean Kennedy,2,80,14,D,1989
9906,8,28,Dean Kennedy,4,64,12,D,1990
9907,4,29,Dean Kennedy,2,18,6,D,1991
9908,7,30,Dean Kennedy,1,78,8,D,1992
9909,8,31,Dean Kennedy,2,76,10,D,1993
9910,8,32,Dean Kennedy,2,40,10,D,1994
9911,5,20,Dean Kolstad,1,25,6,D,1988
9912,0,22,Dean Kolstad,0,5,0,D,1990
9913,2,24,Dean Kolstad,0,10,2,D,1992
9914,0,22,Dean Kukan,0,8,0,D,2015
9915,4,24,Dean Kukan,0,11,4,D,2017
9916,0,22,Dean Magee,0,7,0,LW,1977
9917,1,23,Dean Magee,0,5,1,LW,1978
9918,1,23,Dean Magee,0,5,1,LW,1978
9919,2,26,Dean Malkoc,0,41,2,D,1995
9920,0,27,Dean Malkoc,0,33,0,D,1996
9921,0,28,Dean Malkoc,1,40,1,D,1997
9922,1,29,Dean Malkoc,0,2,1,D,1998
9923,2,18,Dean McAmmond,0,5,2,C,1991
9924,21,20,Dean McAmmond,6,45,27,LW,1993
9925,0,21,Dean McAmmond,0,6,0,LW,1994
9926,15,22,Dean McAmmond,15,53,30,LW,1995
9927,17,23,Dean McAmmond,12,57,29,LW,1996
9928,31,24,Dean McAmmond,19,77,50,LW,1997
9929,20,25,Dean McAmmond,10,77,30,C,1998
9930,18,26,Dean McAmmond,14,76,32,LW,1999
9931,17,27,Dean McAmmond,11,71,28,LW,2000
9932,30,28,Dean McAmmond,21,73,51,LW,2001
9933,8,29,Dean McAmmond,10,41,18,LW,2002
9934,13,30,Dean McAmmond,17,64,30,LW,2003
9935,22,32,Dean McAmmond,15,78,37,LW,2005
9936,15,33,Dean McAmmond,14,81,29,LW,2006
9937,13,34,Dean McAmmond,9,68,22,LW,2007
9938,11,35,Dean McAmmond,5,62,16,LW,2008
9939,9,36,Dean McAmmond,8,62,17,LW,2009
9940,0,21,Dean Melanson,0,5,0,D,1994
9941,0,28,Dean Melanson,0,4,0,D,2001
9942,0,21,Dean Morton,1,1,1,D,1989
9943,38,35,Dean Prentice,17,69,55,LW,1967
9944,20,36,Dean Prentice,14,74,34,LW,1968
9945,25,37,Dean Prentice,26,75,51,LW,1969
9946,17,38,Dean Prentice,21,69,38,LW,1970
9947,27,39,Dean Prentice,20,71,47,LW,1971
9948,16,40,Dean Prentice,26,73,42,LW,1972
9949,3,41,Dean Prentice,2,24,5,LW,1973
9950,0,26,Dean Sylvester,0,1,0,RW,1998
9951,10,27,Dean Sylvester,16,52,26,RW,1999
9952,6,28,Dean Sylvester,5,43,11,RW,2000
9953,21,21,Dean Talafous,9,61,30,RW,1974
9954,30,22,Dean Talafous,18,79,48,RW,1975
9955,27,23,Dean Talafous,22,80,49,RW,1976
9956,16,24,Dean Talafous,13,75,29,RW,1977
9957,16,25,Dean Talafous,13,68,29,RW,1978
9958,20,26,Dean Talafous,10,55,30,RW,1979
9959,17,27,Dean Talafous,13,50,30,RW,1980
9960,7,28,Dean Talafous,6,29,13,RW,1981
9961,0,20,Dean Turner,0,1,0,D,1978
9962,0,21,Dean Turner,1,27,1,D,1979
9963,0,22,Dean Turner,0,4,0,D,1980
9964,0,24,Dean Turner,0,3,0,D,1982
9965,0,22,Del Hall,0,1,0,C,1971
9966,0,23,Del Hall,0,6,0,C,1972
9967,0,24,Del Hall,2,2,2,C,1973
9968,44,26,Del Hall,47,80,91,LW,1975
9969,44,26,Del Hall,47,80,91,LW,1975
9970,41,27,Del Hall,38,80,79,LW,1976
9971,41,27,Del Hall,38,80,79,LW,1976
9972,3,28,Del Hall,4,26,7,C,1977
9973,3,28,Del Hall,4,25,7,C,1977
9974,0,28,Del Hall,0,1,0,C,1977
9975,3,28,Del Hall,4,26,7,C,1977
9976,3,28,Del Hall,4,25,7,C,1977
9977,0,28,Del Hall,0,1,0,C,1977
9978,7,21,Denis Arkhipov,6,40,13,C,2000
9979,22,22,Denis Arkhipov,20,82,42,C,2001
9980,24,23,Denis Arkhipov,11,79,35,C,2002
9981,12,24,Denis Arkhipov,9,72,21,C,2003
9982,17,27,Denis Arkhipov,10,79,27,C,2006
9983,1,23,Denis Chasse,0,3,1,RW,1993
9984,9,24,Denis Chasse,7,47,16,RW,1994
9985,0,25,Denis Chasse,3,60,3,RW,1995
9986,4,26,Denis Chasse,1,22,5,RW,1996
9987,0,22,Denis Chervyakov,0,2,0,D,1992
9988,4,19,Denis Cyr,1,10,5,RW,1980
9989,10,20,Denis Cyr,12,45,22,RW,1981
9990,9,21,Denis Cyr,8,52,17,RW,1982
9991,13,22,Denis Cyr,12,46,25,RW,1983
9992,3,23,Denis Cyr,5,9,8,RW,1984
9993,4,24,Denis Cyr,3,31,7,RW,1985
9994,2,22,Denis Dupere,1,20,3,LW,1970
9995,10,23,Denis Dupere,7,77,17,LW,1971
9996,23,24,Denis Dupere,13,61,36,LW,1972
9997,9,25,Denis Dupere,8,34,17,LW,1973
9998,21,26,Denis Dupere,23,75,44,LW,1974
9999,8,27,Denis Dupere,6,43,14,LW,1975
10000,11,28,Denis Dupere,7,57,18,LW,1976
10001,15,29,Denis Dupere,15,54,30,LW,1977
10002,0,21,Denis Gauthier,0,10,0,D,1997
10003,4,22,Denis Gauthier,3,55,7,D,1998
10004,1,23,Denis Gauthier,1,39,2,D,1999
10005,6,24,Denis Gauthier,2,62,8,D,2000
10006,8,25,Denis Gauthier,5,66,13,D,2001
10007,11,26,Denis Gauthier,1,72,12,D,2002
10008,15,27,Denis Gauthier,1,80,16,D,2003
10009,9,29,Denis Gauthier,2,62,11,D,2005
10010,4,30,Denis Gauthier,0,43,4,D,2006
10011,2,32,Denis Gauthier,2,65,4,D,2008
10012,1,20,Denis Grebeshkov,0,4,1,D,2003
10013,5,22,Denis Grebeshkov,0,29,5,D,2005
10014,15,24,Denis Grebeshkov,3,71,18,D,2007
10015,32,25,Denis Grebeshkov,7,72,39,D,2008
10016,14,26,Denis Grebeshkov,7,51,21,D,2009
10017,1,30,Denis Grebeshkov,0,7,1,D,2013
10018,0,19,Denis Gurianov,0,1,0,RW,2016
10019,0,22,Denis Hamel,1,3,1,LW,1999
10020,3,23,Denis Hamel,8,41,11,C,2000
10021,6,24,Denis Hamel,2,61,8,LW,2001
10022,0,25,Denis Hamel,2,25,2,LW,2002
10023,0,26,Denis Hamel,0,5,0,LW,2003
10024,0,28,Denis Hamel,1,4,1,LW,2005
10025,3,29,Denis Hamel,5,53,8,LW,2006
10026,1,20,Denis Larocque,0,8,1,D,1987
10027,4,20,Denis Malgin,6,47,10,C,2016
10028,11,21,Denis Malgin,11,51,22,C,2017
10029,1,20,Denis Meloche,1,4,2,C,1972
10030,1,20,Denis Meloche,1,4,2,C,1972
10031,13,21,Denis Meloche,6,41,19,C,1973
10032,13,21,Denis Meloche,6,41,19,C,1973
10033,2,21,Denis Patry,1,3,3,RW,1974
10034,2,21,Denis Patry,1,3,3,RW,1974
10035,1,20,Denis Pederson,3,10,4,C,1995
10036,20,21,Denis Pederson,12,70,32,C,1996
10037,13,22,Denis Pederson,15,80,28,C,1997
10038,12,23,Denis Pederson,11,76,23,C,1998
10039,5,24,Denis Pederson,6,47,11,C,1999
10040,8,25,Denis Pederson,4,61,12,RW,2000
10041,6,26,Denis Pederson,2,48,8,RW,2001
10042,6,27,Denis Pederson,4,43,10,RW,2002
10043,37,20,Denis Potvin,17,77,54,D,1973
10044,55,21,Denis Potvin,21,79,76,D,1974
10045,67,22,Denis Potvin,31,78,98,D,1975
10046,55,23,Denis Potvin,25,80,80,D,1976
10047,64,24,Denis Potvin,30,80,94,D,1977
10048,70,25,Denis Potvin,31,73,101,D,1978
10049,33,26,Denis Potvin,8,31,41,D,1979
10050,56,27,Denis Potvin,20,74,76,D,1980
10051,37,28,Denis Potvin,24,60,61,D,1981
10052,54,29,Denis Potvin,12,69,66,D,1982
10053,63,30,Denis Potvin,22,78,85,D,1983
10054,51,31,Denis Potvin,17,77,68,D,1984
10055,38,32,Denis Potvin,21,74,59,D,1985
10056,30,33,Denis Potvin,12,58,42,D,1986
10057,32,34,Denis Potvin,19,72,51,D,1987
10058,47,19,Denis Savard,28,76,75,C,1980
10059,87,20,Denis Savard,32,80,119,C,1981
10060,86,21,Denis Savard,35,78,121,C,1982
10061,57,22,Denis Savard,37,75,94,C,1983
10062,67,23,Denis Savard,38,79,105,C,1984
10063,69,24,Denis Savard,47,80,116,C,1985
10064,50,25,Denis Savard,40,70,90,C,1986
10065,87,26,Denis Savard,44,80,131,C,1987
10066,59,27,Denis Savard,23,58,82,C,1988
10067,53,28,Denis Savard,27,60,80,C,1989
10068,31,29,Denis Savard,28,70,59,C,1990
10069,42,30,Denis Savard,28,77,70,C,1991
10070,34,31,Denis Savard,16,63,50,C,1992
10071,28,32,Denis Savard,18,74,46,C,1993
10072,15,33,Denis Savard,10,43,25,C,1994
10073,35,34,Denis Savard,13,69,48,C,1995
10074,18,35,Denis Savard,9,64,27,C,1996
10075,10,20,Denis Shvidki,6,43,16,RW,2000
10076,2,21,Denis Shvidki,1,8,3,LW,2001
10077,2,22,Denis Shvidki,4,23,6,LW,2002
10078,0,23,Denis Shvidki,0,2,0,RW,2003
10079,5,23,Denis Tolpeko,1,26,6,C,2007
10080,0,22,Denis Tsygurov,0,8,0,D,1993
10081,0,23,Denis Tsygurov,0,25,0,D,1994
10082,5,24,Denis Tsygurov,1,18,6,D,1995
10083,2,22,Dennis Abgrall,0,13,2,RW,1975
10084,39,23,Dennis Abgrall,23,80,62,RW,1976
10085,39,23,Dennis Abgrall,23,80,62,RW,1976
10086,11,24,Dennis Abgrall,13,65,24,RW,1977
10087,11,24,Dennis Abgrall,13,65,24,RW,1977
10088,0,21,Dennis Bonvie,0,2,0,D,1994
10089,0,22,Dennis Bonvie,0,8,0,RW,1995
10090,0,24,Dennis Bonvie,0,4,0,RW,1997
10091,0,25,Dennis Bonvie,0,11,0,RW,1998
10092,0,26,Dennis Bonvie,0,28,0,RW,1999
10093,0,27,Dennis Bonvie,0,3,0,RW,2000
10094,2,28,Dennis Bonvie,1,23,3,RW,2001
10095,0,29,Dennis Bonvie,0,12,0,RW,2002
10096,0,30,Dennis Bonvie,0,1,0,RW,2003
10097,9,23,Dennis Everberg,3,55,12,RW,2014
10098,0,24,Dennis Everberg,0,15,0,RW,2015
10099,4,25,Dennis Hextall,1,13,5,C,1968
10100,7,26,Dennis Hextall,5,28,12,C,1969
10101,31,27,Dennis Hextall,21,78,52,C,1970
10102,10,28,Dennis Hextall,6,33,16,C,1971
10103,52,29,Dennis Hextall,30,78,82,C,1972
10104,62,30,Dennis Hextall,20,78,82,C,1973
10105,57,31,Dennis Hextall,17,80,74,C,1974
10106,44,32,Dennis Hextall,16,76,60,C,1975
10107,32,33,Dennis Hextall,14,78,46,C,1976
10108,33,34,Dennis Hextall,16,78,49,C,1977
10109,17,35,Dennis Hextall,6,46,23,C,1978
10110,1,36,Dennis Hextall,1,15,2,C,1979
10111,15,23,Dennis Hull,18,74,33,LW,1967
10112,34,24,Dennis Hull,30,72,64,LW,1968
10113,35,25,Dennis Hull,17,76,52,LW,1969
10114,26,26,Dennis Hull,40,78,66,LW,1970
10115,39,27,Dennis Hull,30,78,69,LW,1971
10116,51,28,Dennis Hull,39,78,90,LW,1972
10117,39,29,Dennis Hull,29,74,68,LW,1973
10118,21,30,Dennis Hull,16,69,37,LW,1974
10119,39,31,Dennis Hull,27,80,66,LW,1975
10120,17,32,Dennis Hull,16,75,33,LW,1976
10121,9,33,Dennis Hull,5,55,14,LW,1977
10122,7,31,Dennis Kassian,6,50,13,LW,1972
10123,7,31,Dennis Kassian,6,50,13,LW,1972
10124,26,26,Dennis Kearns,3,73,29,D,1971
10125,33,27,Dennis Kearns,4,72,37,D,1972
10126,13,28,Dennis Kearns,4,52,17,D,1973
10127,11,29,Dennis Kearns,1,49,12,D,1974
10128,46,30,Dennis Kearns,5,80,51,D,1975
10129,55,31,Dennis Kearns,5,80,60,D,1976
10130,43,32,Dennis Kearns,4,80,47,D,1977
10131,31,33,Dennis Kearns,3,78,34,D,1978
10132,18,34,Dennis Kearns,1,67,19,D,1979
10133,14,35,Dennis Kearns,1,46,15,D,1980
10134,32,20,Dennis Maruk,30,80,62,C,1975
10135,50,21,Dennis Maruk,28,80,78,C,1976
10136,35,22,Dennis Maruk,36,76,71,C,1977
10137,59,23,Dennis Maruk,31,78,90,C,1978
10138,17,24,Dennis Maruk,10,27,27,C,1979
10139,47,25,Dennis Maruk,50,80,97,C,1980
10140,76,26,Dennis Maruk,60,80,136,C,1981
10141,50,27,Dennis Maruk,31,80,81,C,1982
10142,43,28,Dennis Maruk,17,71,60,C,1983
10143,41,29,Dennis Maruk,19,71,60,C,1984
10144,37,30,Dennis Maruk,21,70,58,C,1985
10145,30,31,Dennis Maruk,16,67,46,C,1986
10146,4,32,Dennis Maruk,7,22,11,C,1987
10147,1,33,Dennis Maruk,0,6,1,C,1988
10148,0,21,Dennis McCord,0,3,0,D,1973
10149,2,21,Dennis O'Brien,3,27,5,D,1970
10150,6,22,Dennis O'Brien,3,70,9,D,1971
10151,11,23,Dennis O'Brien,3,74,14,D,1972
10152,12,24,Dennis O'Brien,5,77,17,D,1973
10153,10,25,Dennis O'Brien,6,56,16,D,1974
10154,14,26,Dennis O'Brien,1,78,15,D,1975
10155,18,27,Dennis O'Brien,6,75,24,D,1976
10156,10,28,Dennis O'Brien,2,68,12,D,1977
10157,8,29,Dennis O'Brien,2,64,10,D,1978
10158,0,30,Dennis O'Brien,0,3,0,D,1979
10159,11,21,Dennis Owchar,6,46,17,D,1974
10160,12,22,Dennis Owchar,5,54,17,D,1975
10161,18,23,Dennis Owchar,5,46,23,D,1976
10162,31,24,Dennis Owchar,10,82,41,D,1977
10163,13,25,Dennis Owchar,3,50,16,D,1978
10164,0,26,Dennis Owchar,1,10,1,D,1979
10165,5,25,Dennis Patterson,1,66,6,D,1974
10166,16,26,Dennis Patterson,5,69,21,D,1975
10167,2,27,Dennis Patterson,0,23,2,D,1976
10168,2,27,Dennis Patterson,0,23,2,D,1976
10169,1,30,Dennis Patterson,0,3,1,D,1979
10170,0,21,Dennis Polonich,0,4,0,RW,1974
10171,12,22,Dennis Polonich,11,57,23,C,1975
10172,28,23,Dennis Polonich,18,79,46,RW,1976
10173,19,24,Dennis Polonich,16,79,35,RW,1977
10174,12,25,Dennis Polonich,10,62,22,RW,1978
10175,8,26,Dennis Polonich,2,66,10,RW,1979
10176,2,27,Dennis Polonich,2,32,4,RW,1980
10177,1,29,Dennis Polonich,0,11,1,C,1982
10178,5,25,Dennis Rasmussen,4,44,9,C,2015
10179,4,26,Dennis Rasmussen,4,68,8,C,2016
10180,3,27,Dennis Rasmussen,1,27,4,C,2017
10181,9,21,Dennis Seidenberg,4,58,13,D,2002
10182,0,22,Dennis Seidenberg,0,5,0,D,2003
10183,15,24,Dennis Seidenberg,3,63,18,D,2005
10184,6,25,Dennis Seidenberg,2,52,8,D,2006
10185,15,26,Dennis Seidenberg,0,47,15,D,2007
10186,25,27,Dennis Seidenberg,5,70,30,D,2008
10187,28,28,Dennis Seidenberg,4,79,32,D,2009
10188,25,29,Dennis Seidenberg,7,81,32,D,2010
10189,18,30,Dennis Seidenberg,5,80,23,D,2011
10190,13,31,Dennis Seidenberg,4,46,17,D,2012
10191,9,32,Dennis Seidenberg,1,34,10,D,2013
10192,11,33,Dennis Seidenberg,3,82,14,D,2014
10193,11,34,Dennis Seidenberg,1,61,12,D,2015
10194,17,35,Dennis Seidenberg,5,73,22,D,2016
10195,5,36,Dennis Seidenberg,0,28,5,D,2017
10196,0,25,Dennis Smith,0,4,0,D,1989
10197,0,26,Dennis Smith,0,4,0,D,1990
10198,45,21,Dennis Sobchuk,32,78,77,C,1974
10199,45,21,Dennis Sobchuk,32,78,77,C,1974
10200,40,22,Dennis Sobchuk,32,79,72,C,1975
10201,40,22,Dennis Sobchuk,32,79,72,C,1975
10202,52,23,Dennis Sobchuk,44,81,96,C,1976
10203,52,23,Dennis Sobchuk,44,81,96,C,1976
10204,12,24,Dennis Sobchuk,11,36,23,C,1977
10205,9,24,Dennis Sobchuk,5,23,14,C,1977
10206,3,24,Dennis Sobchuk,6,13,9,C,1977
10207,12,24,Dennis Sobchuk,11,36,23,C,1977
10208,9,24,Dennis Sobchuk,5,23,14,C,1977
10209,3,24,Dennis Sobchuk,6,13,9,C,1977
10210,37,25,Dennis Sobchuk,26,74,63,C,1978
10211,37,25,Dennis Sobchuk,26,74,63,C,1978
10212,6,26,Dennis Sobchuk,4,33,10,C,1979
10213,0,29,Dennis Sobchuk,1,2,1,C,1982
10214,0,23,Dennis Vaske,0,5,0,D,1990
10215,1,24,Dennis Vaske,0,39,1,D,1991
10216,5,25,Dennis Vaske,1,27,6,D,1992
10217,11,26,Dennis Vaske,2,65,13,D,1993
10218,11,27,Dennis Vaske,1,41,12,D,1994
10219,6,28,Dennis Vaske,1,19,7,D,1995
10220,4,29,Dennis Vaske,0,17,4,D,1996
10221,3,30,Dennis Vaske,0,19,3,D,1997
10222,0,31,Dennis Vaske,0,3,0,D,1998
10223,31,20,Dennis Ververgaert,26,78,57,RW,1973
10224,32,21,Dennis Ververgaert,19,57,51,RW,1974
10225,34,22,Dennis Ververgaert,37,80,71,RW,1975
10226,18,23,Dennis Ververgaert,27,79,45,RW,1976
10227,33,24,Dennis Ververgaert,21,80,54,RW,1977
10228,24,25,Dennis Ververgaert,18,72,42,RW,1978
10229,17,26,Dennis Ververgaert,14,58,31,RW,1979
10230,27,27,Dennis Ververgaert,14,79,41,RW,1980
10231,0,21,Dennis Vial,0,30,0,D,1990
10232,0,22,Dennis Vial,1,27,1,D,1991
10233,1,23,Dennis Vial,0,9,1,D,1992
10234,5,24,Dennis Vial,2,55,7,D,1993
10235,4,25,Dennis Vial,0,27,4,D,1994
10236,4,26,Dennis Vial,1,64,5,D,1995
10237,1,27,Dennis Vial,0,11,1,LW,1996
10238,0,28,Dennis Vial,0,19,0,LW,1997
10239,16,22,Dennis Wideman,8,67,24,D,2005
10240,19,23,Dennis Wideman,6,75,25,D,2006
10241,23,24,Dennis Wideman,13,81,36,D,2007
10242,37,25,Dennis Wideman,13,79,50,D,2008
10243,24,26,Dennis Wideman,6,76,30,D,2009
10244,30,27,Dennis Wideman,10,75,40,D,2010
10245,35,28,Dennis Wideman,11,82,46,D,2011
10246,16,29,Dennis Wideman,6,46,22,D,2012
10247,17,30,Dennis Wideman,4,46,21,D,2013
10248,41,31,Dennis Wideman,15,80,56,D,2014
10249,17,32,Dennis Wideman,2,51,19,D,2015
10250,13,33,Dennis Wideman,5,57,18,D,2016
10251,1,21,Denny Felsner,0,3,1,LW,1991
10252,3,22,Denny Felsner,0,6,3,LW,1992
10253,0,23,Denny Felsner,1,6,1,LW,1993
10254,0,24,Denny Felsner,0,3,0,LW,1994
10255,3,25,Denny Lambert,1,13,4,LW,1994
10256,8,26,Denny Lambert,0,33,8,LW,1995
10257,16,27,Denny Lambert,4,80,20,LW,1996
10258,10,28,Denny Lambert,9,72,19,LW,1997
10259,11,29,Denny Lambert,5,76,16,LW,1998
10260,6,30,Denny Lambert,5,73,11,LW,1999
10261,7,31,Denny Lambert,1,67,8,LW,2000
10262,5,32,Denny Lambert,2,73,7,LW,2001
10263,0,25,Derek A Smith,0,2,0,D,2009
10264,1,26,Derek A Smith,0,9,1,D,2010
10265,9,27,Derek A Smith,2,47,11,D,2011
10266,1,28,Derek A Smith,0,22,1,D,2012
10267,1,29,Derek A Smith,0,14,1,D,2013
10268,0,20,Derek Armstrong,0,1,0,C,1993
10269,3,22,Derek Armstrong,1,19,4,C,1995
10270,7,23,Derek Armstrong,6,50,13,C,1996
10271,0,24,Derek Armstrong,2,9,2,C,1997
10272,0,25,Derek Armstrong,0,3,0,C,1998
10273,0,26,Derek Armstrong,0,1,0,C,1999
10274,0,27,Derek Armstrong,0,3,0,C,2000
10275,26,29,Derek Armstrong,12,66,38,C,2002
10276,21,30,Derek Armstrong,14,57,35,C,2003
10277,28,32,Derek Armstrong,13,62,41,C,2005
10278,33,33,Derek Armstrong,11,67,44,C,2006
10279,27,34,Derek Armstrong,8,77,35,C,2007
10280,4,35,Derek Armstrong,5,56,9,C,2008
10281,0,36,Derek Armstrong,0,6,0,C,2009
10282,0,24,Derek Bekar,0,1,0,C,1999
10283,0,27,Derek Bekar,0,6,0,LW,2002
10284,0,28,Derek Bekar,0,4,0,LW,2003
10285,4,23,Derek Boogaard,2,65,6,LW,2005
10286,1,24,Derek Boogaard,0,48,1,LW,2006
10287,0,25,Derek Boogaard,0,34,0,LW,2007
10288,3,26,Derek Boogaard,0,51,3,LW,2008
10289,4,27,Derek Boogaard,0,57,4,LW,2009
10290,1,28,Derek Boogaard,1,22,2,LW,2010
10291,1,22,Derek Dorsett,4,52,5,RW,2008
10292,10,23,Derek Dorsett,4,51,14,RW,2009
10293,13,24,Derek Dorsett,4,76,17,RW,2010
10294,8,25,Derek Dorsett,12,77,20,RW,2011
10295,6,26,Derek Dorsett,3,24,9,RW,2012
10296,4,27,Derek Dorsett,4,51,8,RW,2013
10297,18,28,Derek Dorsett,7,79,25,RW,2014
10298,11,29,Derek Dorsett,5,71,16,RW,2015
10299,3,30,Derek Dorsett,1,14,4,RW,2016
10300,2,31,Derek Dorsett,7,20,9,RW,2017
10301,1,23,Derek Forbort,1,14,2,D,2015
10302,16,24,Derek Forbort,2,82,18,D,2016
10303,17,25,Derek Forbort,1,78,18,D,2017
10304,0,22,Derek Grant,0,5,0,C,2012
10305,2,23,Derek Grant,0,20,2,C,2013
10306,1,25,Derek Grant,0,15,1,C,2015
10307,1,26,Derek Grant,0,6,1,C,2016
10308,12,27,Derek Grant,12,66,24,C,2017
10309,9,20,Derek Haas,5,30,14,C,1975
10310,9,20,Derek Haas,5,30,14,C,1975
10311,5,22,Derek Harker,0,28,5,D,1972
10312,5,22,Derek Harker,0,27,5,D,1972
10313,0,22,Derek Harker,0,1,0,D,1972
10314,5,22,Derek Harker,0,28,5,D,1972
10315,5,22,Derek Harker,0,27,5,D,1972
10316,0,22,Derek Harker,0,1,0,D,1972
10317,0,21,Derek Joslin,0,12,0,D,2008
10318,3,22,Derek Joslin,0,24,3,D,2009
10319,7,23,Derek Joslin,2,34,9,D,2010
10320,2,24,Derek Joslin,2,44,4,D,2011
10321,0,25,Derek Joslin,0,2,0,D,2012
10322,0,19,Derek King,0,2,0,LW,1986
10323,24,20,Derek King,12,55,36,LW,1987
10324,29,21,Derek King,14,60,43,LW,1988
10325,27,22,Derek King,13,46,40,LW,1989
10326,26,23,Derek King,19,66,45,LW,1990
10327,38,24,Derek King,40,80,78,LW,1991
10328,38,25,Derek King,38,77,76,LW,1992
10329,40,26,Derek King,30,78,70,LW,1993
10330,16,27,Derek King,10,43,26,LW,1994
10331,20,28,Derek King,12,61,32,LW,1995
10332,33,29,Derek King,26,82,59,LW,1996
10333,25,30,Derek King,21,77,46,LW,1997
10334,28,31,Derek King,24,81,52,LW,1998
10335,7,32,Derek King,2,22,9,LW,1999
10336,0,18,Derek Laxdal,0,3,0,RW,1984
10337,0,20,Derek Laxdal,0,2,0,RW,1986
10338,0,21,Derek Laxdal,0,5,0,RW,1987
10339,6,22,Derek Laxdal,9,41,15,RW,1988
10340,1,23,Derek Laxdal,3,12,4,RW,1989
10341,0,24,Derek Laxdal,0,4,0,RW,1990
10342,0,20,Derek MacKenzie,0,1,0,C,2001
10343,1,22,Derek MacKenzie,0,12,1,C,2003
10344,1,24,Derek MacKenzie,0,11,1,C,2005
10345,0,25,Derek MacKenzie,0,4,0,C,2006
10346,0,26,Derek MacKenzie,2,17,2,C,2007
10347,0,27,Derek MacKenzie,0,1,0,C,2008
10348,3,28,Derek MacKenzie,1,18,4,C,2009
10349,14,29,Derek MacKenzie,9,63,23,C,2010
10350,7,30,Derek MacKenzie,7,66,14,C,2011
10351,5,31,Derek MacKenzie,3,43,8,C,2012
10352,9,32,Derek MacKenzie,9,71,18,C,2013
10353,6,33,Derek MacKenzie,5,82,11,C,2014
10354,7,34,Derek MacKenzie,6,64,13,C,2015
10355,10,35,Derek MacKenzie,6,82,16,C,2016
10356,11,36,Derek MacKenzie,3,75,14,C,2017
10357,2,26,Derek Mayer,2,17,4,D,1993
10358,0,22,Derek Meech,0,4,0,D,2006
10359,3,23,Derek Meech,0,32,3,D,2007
10360,5,24,Derek Meech,2,41,7,D,2008
10361,4,25,Derek Meech,2,49,6,D,2009
10362,0,27,Derek Meech,0,2,0,D,2011
10363,1,28,Derek Meech,0,16,1,D,2012
10364,20,19,Derek Morris,9,82,29,D,1997
10365,27,20,Derek Morris,7,71,34,D,1998
10366,29,21,Derek Morris,9,78,38,D,1999
10367,23,22,Derek Morris,5,51,28,D,2000
10368,30,23,Derek Morris,4,61,34,D,2001
10369,37,24,Derek Morris,11,75,48,D,2002
10370,26,25,Derek Morris,6,83,32,D,2003
10371,21,27,Derek Morris,6,53,27,D,2005
10372,19,28,Derek Morris,6,82,25,D,2006
10373,17,29,Derek Morris,8,82,25,D,2007
10374,15,30,Derek Morris,5,75,20,D,2008
10375,25,31,Derek Morris,4,76,29,D,2009
10376,11,32,Derek Morris,5,77,16,D,2010
10377,9,33,Derek Morris,2,59,11,D,2011
10378,11,34,Derek Morris,0,39,11,D,2012
10379,12,35,Derek Morris,5,63,17,D,2013
10380,0,23,Derek Peltier,0,11,0,D,2008
10381,0,24,Derek Peltier,0,3,0,D,2009
10382,35,23,Derek Plante,21,77,56,C,1993
10383,19,24,Derek Plante,3,47,22,C,1994
10384,33,25,Derek Plante,23,76,56,C,1995
10385,26,26,Derek Plante,27,82,53,C,1996
10386,21,27,Derek Plante,13,72,34,C,1997
10387,14,28,Derek Plante,6,51,20,C,1998
10388,2,29,Derek Plante,2,33,4,C,1999
10389,2,30,Derek Plante,1,12,3,C,2000
10390,0,22,Derek R Smith,0,5,0,C,1976
10391,3,23,Derek R Smith,3,36,6,C,1977
10392,12,24,Derek R Smith,14,43,26,C,1978
10393,39,25,Derek R Smith,24,79,63,C,1979
10394,43,26,Derek R Smith,21,69,64,LW,1980
10395,15,27,Derek R Smith,9,61,24,LW,1981
10396,4,28,Derek R Smith,7,42,11,C,1982
10397,10,20,Derek Roy,9,49,19,C,2003
10398,28,22,Derek Roy,18,70,46,C,2005
10399,42,23,Derek Roy,21,75,63,C,2006
10400,49,24,Derek Roy,32,78,81,C,2007
10401,42,25,Derek Roy,28,82,70,C,2008
10402,43,26,Derek Roy,26,80,69,C,2009
10403,25,27,Derek Roy,10,35,35,C,2010
10404,27,28,Derek Roy,17,80,44,C,2011
10405,21,29,Derek Roy,7,42,28,C,2012
10406,28,30,Derek Roy,9,75,37,C,2013
10407,20,31,Derek Roy,12,72,32,C,2014
10408,0,29,Derek Ryan,2,6,2,C,2015
10409,18,30,Derek Ryan,11,67,29,C,2016
10410,23,31,Derek Ryan,15,80,38,C,2017
10411,25,21,Derek Sanderson,24,71,49,C,1967
10412,22,22,Derek Sanderson,26,61,48,C,1968
10413,23,23,Derek Sanderson,18,50,41,C,1969
10414,34,24,Derek Sanderson,29,71,63,C,1970
10415,33,25,Derek Sanderson,25,78,58,C,1971
10416,10,26,Derek Sanderson,5,25,15,C,1972
10417,3,26,Derek Sanderson,3,8,6,C,1972
10418,3,26,Derek Sanderson,3,8,6,C,1972
10419,12,27,Derek Sanderson,8,29,20,C,1973
10420,25,28,Derek Sanderson,25,75,50,C,1974
10421,43,29,Derek Sanderson,24,73,67,C,1975
10422,22,30,Derek Sanderson,15,48,37,C,1976
10423,1,31,Derek Sanderson,3,13,4,C,1977
10424,24,20,Derek Stepan,21,82,45,C,2010
10425,34,21,Derek Stepan,17,82,51,C,2011
10426,26,22,Derek Stepan,18,48,44,C,2012
10427,40,23,Derek Stepan,17,82,57,C,2013
10428,39,24,Derek Stepan,16,68,55,C,2014
10429,31,25,Derek Stepan,22,72,53,C,2015
10430,38,26,Derek Stepan,17,81,55,C,2016
10431,42,27,Derek Stepan,14,82,56,C,2017
10432,0,27,Derek Whitmore,0,2,0,LW,2011
10433,4,19,Derian Hatcher,8,43,12,D,1991
10434,15,20,Derian Hatcher,4,67,19,D,1992
10435,19,21,Derian Hatcher,12,83,31,D,1993
10436,11,22,Derian Hatcher,5,43,16,D,1994
10437,23,23,Derian Hatcher,8,79,31,D,1995
10438,19,24,Derian Hatcher,3,63,22,D,1996
10439,25,25,Derian Hatcher,6,70,31,D,1997
10440,21,26,Derian Hatcher,9,80,30,D,1998
10441,22,27,Derian Hatcher,2,57,24,D,1999
10442,21,28,Derian Hatcher,2,80,23,D,2000
10443,21,29,Derian Hatcher,4,80,25,D,2001
10444,22,30,Derian Hatcher,8,82,30,D,2002
10445,4,31,Derian Hatcher,0,15,4,D,2003
10446,13,33,Derian Hatcher,4,77,17,D,2005
10447,6,34,Derian Hatcher,3,82,9,D,2006
10448,5,35,Derian Hatcher,2,44,7,D,2007
10449,1,20,Derick Brassard,1,17,2,C,2007
10450,15,21,Derick Brassard,10,31,25,C,2008
10451,27,22,Derick Brassard,9,79,36,C,2009
10452,30,23,Derick Brassard,17,74,47,C,2010
10453,27,24,Derick Brassard,14,74,41,C,2011
10454,17,25,Derick Brassard,12,47,29,C,2012
10455,27,26,Derick Brassard,18,81,45,C,2013
10456,41,27,Derick Brassard,19,80,60,C,2014
10457,31,28,Derick Brassard,27,80,58,C,2015
10458,25,29,Derick Brassard,14,81,39,C,2016
10459,5,30,Derick Brassard,3,14,8,C,2017
10460,13,19,Deron Quint,5,51,18,D,1995
10461,11,20,Deron Quint,3,27,14,D,1996
10462,7,21,Deron Quint,4,32,11,D,1997
10463,8,22,Deron Quint,5,60,13,D,1998
10464,7,23,Deron Quint,4,54,11,D,1999
10465,16,24,Deron Quint,7,57,23,D,2000
10466,18,25,Deron Quint,7,75,25,D,2001
10467,10,26,Deron Quint,7,51,17,D,2002
10468,7,27,Deron Quint,4,51,11,D,2003
10469,0,30,Deron Quint,0,5,0,D,2006
10470,5,21,Derrick Pouliot,2,34,7,D,2014
10471,7,22,Derrick Pouliot,0,22,7,D,2015
10472,0,23,Derrick Pouliot,0,11,0,D,2016
10473,19,24,Derrick Pouliot,3,71,22,D,2017
10474,22,20,Derrick Smith,17,77,39,LW,1984
10475,6,21,Derrick Smith,6,69,12,LW,1985
10476,21,22,Derrick Smith,11,71,32,LW,1986
10477,8,23,Derrick Smith,16,76,24,LW,1987
10478,14,24,Derrick Smith,16,74,30,LW,1988
10479,6,25,Derrick Smith,3,55,9,LW,1989
10480,10,26,Derrick Smith,11,72,21,LW,1990
10481,4,27,Derrick Smith,2,33,6,LW,1991
10482,1,28,Derrick Smith,0,9,1,LW,1992
10483,0,29,Derrick Smith,0,1,0,LW,1993
10484,0,23,Derrick Walser,1,2,1,D,2001
10485,13,24,Derrick Walser,4,53,17,D,2002
10486,8,25,Derrick Walser,1,27,9,D,2003
10487,0,28,Derrick Walser,2,9,2,D,2006
10488,2,27,Deryk Engelland,0,9,2,D,2009
10489,7,28,Deryk Engelland,3,63,10,D,2010
10490,13,29,Deryk Engelland,4,73,17,D,2011
10491,6,30,Deryk Engelland,0,42,6,D,2012
10492,6,31,Deryk Engelland,6,56,12,D,2013
10493,9,32,Deryk Engelland,2,76,11,D,2014
10494,9,33,Deryk Engelland,3,69,12,D,2015
10495,12,34,Deryk Engelland,4,81,16,D,2016
10496,18,35,Deryk Engelland,5,79,23,D,2017
10497,6,19,Devante Smith-Pelly,7,49,13,RW,2011
10498,0,20,Devante Smith-Pelly,0,7,0,RW,2012
10499,8,21,Devante Smith-Pelly,2,19,10,RW,2013
10500,14,22,Devante Smith-Pelly,6,74,20,RW,2014
10501,11,23,Devante Smith-Pelly,14,64,25,RW,2015
10502,5,24,Devante Smith-Pelly,4,53,9,RW,2016
10503,9,25,Devante Smith-Pelly,7,75,16,RW,2017
10504,6,21,Devin Setoguchi,11,44,17,RW,2007
10505,34,22,Devin Setoguchi,31,81,65,RW,2008
10506,16,23,Devin Setoguchi,20,70,36,RW,2009
10507,19,24,Devin Setoguchi,22,72,41,RW,2010
10508,17,25,Devin Setoguchi,19,69,36,RW,2011
10509,14,26,Devin Setoguchi,13,48,27,RW,2012
10510,16,27,Devin Setoguchi,11,75,27,RW,2013
10511,0,28,Devin Setoguchi,0,12,0,RW,2014
10512,8,30,Devin Setoguchi,4,45,12,RW,2016
10513,0,21,Devin Shore,0,3,0,C,2015
10514,20,22,Devin Shore,13,82,33,C,2016
10515,21,23,Devin Shore,11,82,32,C,2017
10516,6,31,Dick Cherry,9,71,15,D,1968
10517,4,32,Dick Cherry,3,68,7,D,1969
10518,21,31,Dick Duff,25,66,46,LW,1967
10519,21,32,Dick Duff,19,68,40,LW,1968
10520,9,33,Dick Duff,6,49,15,LW,1969
10521,13,34,Dick Duff,8,60,21,LW,1970
10522,2,35,Dick Duff,2,8,4,LW,1971
10523,4,23,Dick Lamby,0,9,4,D,1978
10524,1,24,Dick Lamby,0,12,1,D,1979
10525,0,25,Dick Lamby,0,1,0,D,1980
10526,2,29,Dick Mattiussi,0,32,2,D,1967
10527,11,30,Dick Mattiussi,1,36,12,D,1968
10528,10,31,Dick Mattiussi,4,65,14,D,1969
10529,8,32,Dick Mattiussi,3,67,11,D,1970
10530,0,24,Dick McGlynn,0,30,0,D,1972
10531,0,24,Dick McGlynn,0,30,0,D,1972
10532,15,27,Dick Paradise,3,77,18,D,1972
10533,7,28,Dick Paradise,2,67,9,D,1973
10534,7,28,Dick Paradise,2,67,9,D,1973
10535,14,26,Dick Proceviat,4,53,18,D,1972
10536,20,27,Dick Proceviat,2,77,22,D,1973
10537,20,27,Dick Proceviat,2,77,22,D,1973
10538,31,28,Dick Proceviat,1,63,32,D,1974
10539,28,28,Dick Proceviat,1,52,29,D,1974
10540,3,28,Dick Proceviat,0,11,3,D,1974
10541,31,28,Dick Proceviat,1,63,32,D,1974
10542,28,28,Dick Proceviat,1,52,29,D,1974
10543,3,28,Dick Proceviat,0,11,3,D,1974
10544,14,29,Dick Proceviat,7,73,21,D,1975
10545,14,29,Dick Proceviat,7,73,21,D,1975
10546,12,30,Dick Proceviat,2,55,14,D,1976
10547,1,20,Dick Redmond,0,7,1,D,1969
10548,6,21,Dick Redmond,2,20,8,D,1970
10549,35,22,Dick Redmond,10,74,45,D,1971
10550,32,23,Dick Redmond,12,76,44,LW,1972
10551,42,24,Dick Redmond,17,76,59,D,1973
10552,43,25,Dick Redmond,14,80,57,D,1974
10553,27,26,Dick Redmond,9,53,36,D,1975
10554,25,27,Dick Redmond,22,80,47,LW,1976
10555,22,28,Dick Redmond,11,70,33,D,1977
10556,26,29,Dick Redmond,7,64,33,D,1978
10557,33,30,Dick Redmond,14,76,47,D,1979
10558,20,31,Dick Redmond,15,78,35,D,1980
10559,0,32,Dick Redmond,0,17,0,D,1981
10560,30,23,Dick Sarrazin,16,54,46,RW,1968
10561,1,24,Dick Sarrazin,1,18,2,RW,1969
10562,4,26,Dick Sarrazin,3,28,7,RW,1971
10563,15,27,Dick Sarrazin,7,68,22,RW,1972
10564,7,27,Dick Sarrazin,4,35,11,RW,1972
10565,8,27,Dick Sarrazin,3,33,11,RW,1972
10566,7,27,Dick Sarrazin,4,35,11,RW,1972
10567,8,27,Dick Sarrazin,3,33,11,RW,1972
10568,19,26,Dick Sentes,22,74,41,LW,1972
10569,19,26,Dick Sentes,22,74,41,LW,1972
10570,34,27,Dick Sentes,26,64,60,RW,1973
10571,34,27,Dick Sentes,26,64,60,RW,1973
10572,41,28,Dick Sentes,44,74,85,RW,1974
10573,41,28,Dick Sentes,44,74,85,RW,1974
10574,24,29,Dick Sentes,25,72,49,LW,1975
10575,24,29,Dick Sentes,25,72,49,LW,1975
10576,25,30,Dick Sentes,20,53,45,LW,1976
10577,14,30,Dick Sentes,10,29,24,LW,1976
10578,11,30,Dick Sentes,10,24,21,LW,1976
10579,25,30,Dick Sentes,20,53,45,LW,1976
10580,14,30,Dick Sentes,10,29,24,LW,1976
10581,11,30,Dick Sentes,10,24,21,LW,1976
10582,16,27,Dick Tarnstrom,3,62,19,D,2001
10583,34,28,Dick Tarnstrom,7,61,41,D,2002
10584,36,29,Dick Tarnstrom,16,80,52,D,2003
10585,8,31,Dick Tarnstrom,6,55,14,D,2005
10586,11,33,Dick Tarnstrom,3,48,14,D,2007
10587,3,37,Dickie Moore,5,27,8,LW,1967
10588,1,22,Dillon Heatherington,0,6,1,D,2017
10589,0,,Dillon Simpson,0,3,0,D,2016
10590,12,20,Dino Ciccarelli,18,32,30,RW,1980
10591,51,21,Dino Ciccarelli,55,76,106,RW,1981
10592,38,22,Dino Ciccarelli,37,77,75,RW,1982
10593,33,23,Dino Ciccarelli,38,79,71,RW,1983
10594,17,24,Dino Ciccarelli,15,51,32,RW,1984
10595,45,25,Dino Ciccarelli,44,75,89,RW,1985
10596,51,26,Dino Ciccarelli,52,80,103,RW,1986
10597,45,27,Dino Ciccarelli,41,67,86,RW,1987
10598,30,28,Dino Ciccarelli,44,76,74,RW,1988
10599,38,29,Dino Ciccarelli,41,80,79,RW,1989
10600,18,30,Dino Ciccarelli,21,54,39,RW,1990
10601,38,31,Dino Ciccarelli,38,78,76,RW,1991
10602,56,32,Dino Ciccarelli,41,82,97,RW,1992
10603,29,33,Dino Ciccarelli,28,66,57,RW,1993
10604,27,34,Dino Ciccarelli,16,42,43,RW,1994
10605,21,35,Dino Ciccarelli,22,64,43,RW,1995
10606,25,36,Dino Ciccarelli,35,77,60,RW,1996
10607,17,37,Dino Ciccarelli,16,62,33,RW,1997
10608,1,38,Dino Ciccarelli,6,14,7,RW,1998
10609,29,20,Dion Phaneuf,20,82,49,D,2005
10610,33,21,Dion Phaneuf,17,79,50,D,2006
10611,43,22,Dion Phaneuf,17,82,60,D,2007
10612,36,23,Dion Phaneuf,11,80,47,D,2008
10613,20,24,Dion Phaneuf,12,81,32,D,2009
10614,22,25,Dion Phaneuf,8,66,30,D,2010
10615,32,26,Dion Phaneuf,12,82,44,D,2011
10616,19,27,Dion Phaneuf,9,48,28,D,2012
10617,23,28,Dion Phaneuf,8,80,31,D,2013
10618,26,29,Dion Phaneuf,3,70,29,D,2014
10619,28,30,Dion Phaneuf,4,71,32,D,2015
10620,21,31,Dion Phaneuf,9,81,30,D,2016
10621,7,32,Dion Phaneuf,3,26,10,D,2017
10622,1,24,Dirk Graham,1,6,2,RW,1983
10623,11,25,Dirk Graham,12,36,23,RW,1984
10624,33,26,Dirk Graham,22,80,55,RW,1985
10625,29,27,Dirk Graham,25,76,54,RW,1986
10626,24,28,Dirk Graham,24,70,48,RW,1987
10627,45,29,Dirk Graham,33,80,78,RW,1988
10628,32,30,Dirk Graham,22,73,54,RW,1989
10629,21,31,Dirk Graham,24,80,45,RW,1990
10630,30,32,Dirk Graham,17,80,47,RW,1991
10631,17,33,Dirk Graham,20,84,37,RW,1992
10632,18,34,Dirk Graham,15,67,33,RW,1993
10633,9,35,Dirk Graham,4,40,13,RW,1994
10634,30,24,Dixon Ward,22,70,52,LW,1992
10635,3,25,Dixon Ward,12,67,15,LW,1993
10636,3,26,Dixon Ward,0,22,3,RW,1994
10637,2,27,Dixon Ward,2,8,4,RW,1995
10638,32,28,Dixon Ward,13,79,45,RW,1996
10639,13,29,Dixon Ward,10,71,23,RW,1997
10640,24,30,Dixon Ward,20,78,44,RW,1998
10641,9,31,Dixon Ward,11,71,20,LW,1999
10642,13,32,Dixon Ward,5,63,18,C,2000
10643,0,34,Dixon Ward,0,8,0,LW,2002
10644,10,25,Dmitri Bykov,2,71,12,D,2002
10645,4,22,Dmitri Filimonov,1,30,5,D,1993
10646,0,19,Dmitri Kalinin,0,4,0,D,1999
10647,18,20,Dmitri Kalinin,4,79,22,D,2000
10648,11,21,Dmitri Kalinin,2,58,13,D,2001
10649,13,22,Dmitri Kalinin,8,65,21,D,2002
10650,24,23,Dmitri Kalinin,10,77,34,D,2003
10651,16,25,Dmitri Kalinin,2,55,18,D,2005
10652,22,26,Dmitri Kalinin,7,82,29,D,2006
10653,7,27,Dmitri Kalinin,1,46,8,D,2007
10654,15,28,Dmitri Kalinin,2,73,17,D,2008
10655,14,21,Dmitri Khristich,13,40,27,LW,1990
10656,37,22,Dmitri Khristich,36,80,73,LW,1991
10657,35,23,Dmitri Khristich,31,64,66,LW,1992
10658,29,24,Dmitri Khristich,29,83,58,RW,1993
10659,14,25,Dmitri Khristich,12,48,26,LW,1994
10660,37,26,Dmitri Khristich,27,76,64,LW,1995
10661,37,27,Dmitri Khristich,19,75,56,C,1996
10662,37,28,Dmitri Khristich,29,82,66,RW,1997
10663,42,29,Dmitri Khristich,29,79,71,LW,1998
10664,18,30,Dmitri Khristich,12,53,30,LW,1999
10665,25,31,Dmitri Khristich,13,70,38,RW,2000
10666,12,32,Dmitri Khristich,9,61,21,C,2001
10667,42,26,Dmitri Kvartalnov,30,73,72,RW,1992
10668,7,27,Dmitri Kvartalnov,12,39,19,RW,1993
10669,0,26,Dmitri Mironov,1,7,1,D,1991
10670,24,27,Dmitri Mironov,7,59,31,D,1992
10671,27,28,Dmitri Mironov,9,76,36,D,1993
10672,12,29,Dmitri Mironov,5,33,17,D,1994
10673,31,30,Dmitri Mironov,3,72,34,D,1995
10674,39,31,Dmitri Mironov,13,77,52,D,1996
10675,35,32,Dmitri Mironov,8,77,43,D,1997
10676,14,33,Dmitri Mironov,2,46,16,D,1998
10677,19,34,Dmitri Mironov,3,73,22,D,1999
10678,5,35,Dmitri Mironov,3,36,8,D,2000
10679,4,21,Dmitri Nabokov,7,25,11,C,1997
10680,2,22,Dmitri Nabokov,0,4,2,C,1998
10681,7,23,Dmitri Nabokov,4,26,11,LW,1999
10682,8,22,Dmitri Tertyshny,2,62,10,D,1998
10683,0,22,Dmitri Yakushin,0,2,0,D,1999
10684,0,19,Dmitrij Jaskin,0,2,0,RW,2012
10685,1,20,Dmitrij Jaskin,1,18,2,RW,2013
10686,5,21,Dmitrij Jaskin,13,54,18,RW,2014
10687,9,22,Dmitrij Jaskin,4,65,13,RW,2015
10688,10,23,Dmitrij Jaskin,1,51,11,RW,2016
10689,11,24,Dmitrij Jaskin,6,76,17,RW,2017
10690,1,20,Dmitry Afanasenkov,1,9,2,LW,2000
10691,0,21,Dmitry Afanasenkov,0,5,0,LW,2001
10692,10,23,Dmitry Afanasenkov,6,71,16,RW,2003
10693,6,25,Dmitry Afanasenkov,9,68,15,LW,2005
10694,10,26,Dmitry Afanasenkov,11,74,21,LW,2006
10695,1,24,Dmitry Korobov,0,3,1,D,2013
10696,13,19,Dmitry Kulikov,3,68,16,D,2009
10697,20,20,Dmitry Kulikov,6,72,26,D,2010
10698,24,21,Dmitry Kulikov,4,58,28,D,2011
10699,7,22,Dmitry Kulikov,3,34,10,D,2012
10700,11,23,Dmitry Kulikov,8,81,19,D,2013
10701,19,24,Dmitry Kulikov,3,73,22,D,2014
10702,16,25,Dmitry Kulikov,1,74,17,D,2015
10703,3,26,Dmitry Kulikov,2,47,5,D,2016
10704,8,27,Dmitry Kulikov,3,62,11,D,2017
10705,16,20,Dmitry Orlov,3,60,19,D,2011
10706,1,21,Dmitry Orlov,0,5,1,D,2012
10707,8,22,Dmitry Orlov,3,54,11,D,2013
10708,21,24,Dmitry Orlov,8,82,29,D,2015
10709,27,25,Dmitry Orlov,6,82,33,D,2016
10710,21,26,Dmitry Orlov,10,82,31,D,2017
10711,27,21,Dmitry Yushkevich,5,82,32,D,1992
10712,25,22,Dmitry Yushkevich,5,75,30,D,1993
10713,9,23,Dmitry Yushkevich,5,40,14,D,1994
10714,10,24,Dmitry Yushkevich,1,69,11,D,1995
10715,10,25,Dmitry Yushkevich,4,74,14,D,1996
10716,12,26,Dmitry Yushkevich,0,72,12,D,1997
10717,22,27,Dmitry Yushkevich,6,78,28,D,1998
10718,24,28,Dmitry Yushkevich,3,77,27,D,1999
10719,19,29,Dmitry Yushkevich,5,81,24,D,2000
10720,13,30,Dmitry Yushkevich,6,55,19,D,2001
10721,11,31,Dmitry Yushkevich,3,83,14,D,2002
10722,1,20,Dody Wood,1,13,2,C,1992
10723,1,22,Dody Wood,1,9,2,C,1994
10724,6,23,Dody Wood,3,32,9,C,1995
10725,2,24,Dody Wood,3,44,5,C,1996
10726,0,25,Dody Wood,0,8,0,C,1997
10727,0,21,Dom Campedelli,0,2,0,D,1985
10728,0,22,Domenic Pittis,0,1,0,C,1996
10729,0,24,Domenic Pittis,0,3,0,C,1998
10730,0,25,Domenic Pittis,1,7,1,C,1999
10731,5,26,Domenic Pittis,4,47,9,C,2000
10732,6,27,Domenic Pittis,0,22,6,LW,2001
10733,0,28,Domenic Pittis,0,2,0,C,2002
10734,0,29,Domenic Pittis,0,4,0,C,2003
10735,0,21,Dominic Lavoie,0,1,0,D,1988
10736,1,22,Dominic Lavoie,1,13,2,D,1989
10737,2,23,Dominic Lavoie,1,6,3,D,1990
10738,1,24,Dominic Lavoie,0,6,1,D,1991
10739,1,25,Dominic Lavoie,0,4,1,D,1992
10740,3,26,Dominic Lavoie,3,8,6,D,1993
10741,3,23,Dominic Moore,0,5,3,C,2003
10742,9,25,Dominic Moore,9,82,18,C,2005
10743,9,26,Dominic Moore,8,69,17,C,2006
10744,12,27,Dominic Moore,5,68,17,C,2007
10745,32,28,Dominic Moore,13,81,45,C,2008
10746,18,29,Dominic Moore,10,69,28,C,2009
10747,14,30,Dominic Moore,18,77,32,C,2010
10748,21,31,Dominic Moore,4,79,25,C,2011
10749,12,33,Dominic Moore,6,73,18,C,2013
10750,17,34,Dominic Moore,10,82,27,C,2014
10751,9,35,Dominic Moore,6,80,15,C,2015
10752,14,36,Dominic Moore,11,82,25,C,2016
10753,6,37,Dominic Moore,6,50,12,C,2017
10754,2,23,Dominic Toninato,0,37,2,C,2017
10755,0,21,Dominic Turgeon,0,5,0,C,2017
10756,1,21,Dominik Simon,0,3,1,C,2015
10757,1,22,Dominik Simon,0,2,1,C,2016
10758,8,23,Dominik Simon,4,33,12,C,2017
10759,0,22,Dominik Uher,0,2,0,C,2014
10760,15,20,Don Ashby,6,50,21,C,1975
10761,23,21,Don Ashby,19,76,42,C,1976
10762,2,22,Don Ashby,1,12,3,C,1977
10763,3,23,Don Ashby,2,15,5,C,1978
10764,10,24,Don Ashby,10,29,20,C,1979
10765,3,25,Don Ashby,2,6,5,C,1980
10766,12,24,Don Awrey,3,74,15,D,1967
10767,13,25,Don Awrey,0,73,13,D,1968
10768,10,26,Don Awrey,3,73,13,D,1969
10769,21,27,Don Awrey,4,74,25,D,1970
10770,8,28,Don Awrey,1,34,9,D,1971
10771,17,29,Don Awrey,2,78,19,D,1972
10772,16,30,Don Awrey,5,75,21,D,1973
10773,19,31,Don Awrey,1,76,20,D,1974
10774,12,32,Don Awrey,0,72,12,D,1975
10775,12,33,Don Awrey,1,79,13,D,1976
10776,8,34,Don Awrey,2,78,10,D,1977
10777,4,35,Don Awrey,1,56,5,D,1978
10778,5,24,Don Barber,8,23,13,LW,1988
10779,19,25,Don Barber,15,44,34,RW,1989
10780,2,26,Don Barber,1,23,3,LW,1990
10781,6,27,Don Barber,1,25,7,LW,1991
10782,0,19,Don Biggs,0,1,0,C,1984
10783,0,24,Don Biggs,2,11,2,C,1989
10784,20,29,Don Blackburn,9,67,29,LW,1967
10785,9,30,Don Blackburn,7,48,16,LW,1968
10786,0,31,Don Blackburn,0,3,0,LW,1969
10787,0,32,Don Blackburn,0,1,0,LW,1970
10788,10,34,Don Blackburn,7,60,17,LW,1972
10789,39,35,Don Blackburn,20,75,59,LW,1973
10790,39,35,Don Blackburn,20,75,59,LW,1973
10791,32,36,Don Blackburn,18,50,50,LW,1974
10792,32,36,Don Blackburn,18,50,50,LW,1974
10793,3,37,Don Blackburn,2,21,5,LW,1975
10794,3,37,Don Blackburn,2,21,5,LW,1975
10795,28,29,Don Borgeson,29,74,57,RW,1974
10796,28,29,Don Borgeson,29,74,57,RW,1974
10797,24,30,Don Borgeson,30,71,54,LW,1975
10798,24,30,Don Borgeson,30,71,54,LW,1975
10799,22,26,Don Burgess,20,74,42,LW,1972
10800,22,26,Don Burgess,20,74,42,LW,1972
10801,36,27,Don Burgess,30,78,66,LW,1973
10802,36,27,Don Burgess,30,78,66,LW,1973
10803,18,28,Don Burgess,11,62,29,LW,1974
10804,18,28,Don Burgess,11,62,29,LW,1974
10805,11,29,Don Burgess,14,73,25,LW,1975
10806,11,29,Don Burgess,14,73,25,LW,1975
10807,22,30,Don Burgess,20,77,42,LW,1976
10808,22,30,Don Burgess,20,77,42,LW,1976
10809,12,31,Don Burgess,11,79,23,LW,1977
10810,12,31,Don Burgess,11,79,23,LW,1977
10811,1,32,Don Burgess,1,3,2,LW,1978
10812,1,32,Don Burgess,1,3,2,LW,1978
10813,0,20,Don Cairns,0,7,0,LW,1975
10814,1,21,Don Cairns,0,2,1,LW,1976
10815,5,22,Don Dietrich,0,17,5,D,1983
10816,2,24,Don Dietrich,0,11,2,D,1985
10817,3,23,Don Gibson,0,14,3,D,1990
10818,0,19,Don Gillen,1,1,1,RW,1979
10819,4,21,Don Gillen,1,34,5,RW,1981
10820,10,25,Don Gordon,13,52,23,RW,1973
10821,6,25,Don Gordon,8,29,14,RW,1973
10822,4,25,Don Gordon,5,23,9,RW,1973
10823,10,25,Don Gordon,13,52,23,RW,1973
10824,6,25,Don Gordon,8,29,14,RW,1973
10825,4,25,Don Gordon,5,23,9,RW,1973
10826,5,26,Don Gordon,4,42,9,RW,1974
10827,5,26,Don Gordon,4,42,9,RW,1974
10828,22,25,Don Grierson,22,78,44,RW,1972
10829,22,25,Don Grierson,22,78,44,RW,1972
10830,18,26,Don Grierson,11,65,29,RW,1973
10831,18,26,Don Grierson,11,65,29,RW,1973
10832,48,27,Don Herriman,24,78,72,LW,1972
10833,48,27,Don Herriman,24,78,72,LW,1972
10834,21,28,Don Herriman,11,44,32,LW,1973
10835,21,28,Don Herriman,11,44,32,LW,1973
10836,2,29,Don Herriman,1,33,3,LW,1974
10837,2,29,Don Herriman,1,33,3,LW,1974
10838,5,27,Don Howse,2,33,7,LW,1979
10839,0,21,Don Jackson,0,2,0,D,1977
10840,0,22,Don Jackson,0,5,0,D,1978
10841,4,23,Don Jackson,0,10,4,D,1979
10842,3,24,Don Jackson,0,10,3,D,1980
10843,0,25,Don Jackson,0,8,0,D,1981
10844,8,26,Don Jackson,2,71,10,D,1982
10845,12,27,Don Jackson,8,60,20,D,1983
10846,17,28,Don Jackson,3,78,20,D,1984
10847,8,29,Don Jackson,2,45,10,D,1985
10848,0,30,Don Jackson,1,22,1,D,1986
10849,0,30,Don Johns,0,4,0,D,1967
10850,6,20,Don Kozak,14,72,20,RW,1972
10851,14,21,Don Kozak,21,76,35,RW,1973
10852,15,22,Don Kozak,16,77,31,RW,1974
10853,24,23,Don Kozak,20,62,44,RW,1975
10854,17,24,Don Kozak,15,79,32,RW,1976
10855,5,25,Don Kozak,8,43,13,RW,1977
10856,5,26,Don Kozak,2,28,7,RW,1978
10857,14,20,Don Larway,22,76,36,RW,1974
10858,20,21,Don Larway,30,79,50,RW,1975
10859,20,21,Don Larway,30,79,50,RW,1975
10860,13,22,Don Larway,11,75,24,RW,1976
10861,13,22,Don Larway,11,75,24,RW,1976
10862,35,23,Don Larway,24,69,59,RW,1977
10863,35,23,Don Larway,24,69,59,RW,1977
10864,10,24,Don Larway,8,25,18,RW,1978
10865,10,24,Don Larway,8,25,18,RW,1978
10866,20,21,Don Laurence,14,59,34,C,1978
10867,2,22,Don Laurence,1,20,3,C,1979
10868,26,20,Don Lever,12,78,38,C,1972
10869,25,21,Don Lever,23,78,48,C,1973
10870,30,22,Don Lever,38,80,68,C,1974
10871,40,23,Don Lever,25,80,65,C,1975
10872,30,24,Don Lever,27,80,57,C,1976
10873,32,25,Don Lever,17,75,49,LW,1977
10874,21,26,Don Lever,23,71,44,LW,1978
10875,33,27,Don Lever,35,79,68,LW,1979
10876,31,28,Don Lever,26,62,57,LW,1980
10877,39,29,Don Lever,30,82,69,LW,1981
10878,30,30,Don Lever,23,79,53,LW,1982
10879,19,31,Don Lever,14,70,33,LW,1983
10880,8,32,Don Lever,10,67,18,C,1984
10881,1,33,Don Lever,7,29,8,LW,1985
10882,2,34,Don Lever,3,10,5,LW,1986
10883,2,21,Don Luce,1,12,3,C,1969
10884,12,22,Don Luce,3,67,15,C,1970
10885,8,23,Don Luce,11,78,19,C,1971
10886,25,24,Don Luce,18,78,43,C,1972
10887,31,25,Don Luce,26,75,57,C,1973
10888,43,26,Don Luce,33,80,76,C,1974
10889,49,27,Don Luce,21,77,70,C,1975
10890,43,28,Don Luce,26,80,69,C,1976
10891,35,29,Don Luce,26,78,61,C,1977
10892,35,30,Don Luce,26,79,61,C,1978
10893,29,31,Don Luce,14,80,43,C,1979
10894,13,32,Don Luce,16,71,29,C,1980
10895,4,33,Don Luce,4,39,8,C,1981
10896,0,24,Don MacIver,0,6,0,D,1979
10897,2,21,Don MacLean,5,22,7,C,1997
10898,1,24,Don MacLean,0,3,1,C,2000
10899,0,27,Don MacLean,1,4,1,C,2003
10900,1,29,Don MacLean,1,3,2,C,2005
10901,1,30,Don MacLean,1,9,2,C,2006
10902,17,20,Don Maloney,9,28,26,LW,1978
10903,48,21,Don Maloney,25,79,73,LW,1979
10904,23,22,Don Maloney,29,61,52,LW,1980
10905,36,23,Don Maloney,22,54,58,LW,1981
10906,40,24,Don Maloney,29,78,69,LW,1982
10907,42,25,Don Maloney,24,79,66,LW,1983
10908,16,26,Don Maloney,11,37,27,LW,1984
10909,17,27,Don Maloney,11,68,28,LW,1985
10910,38,28,Don Maloney,19,72,57,LW,1986
10911,21,29,Don Maloney,12,66,33,LW,1987
10912,20,30,Don Maloney,7,52,27,LW,1988
10913,27,31,Don Maloney,16,79,43,LW,1989
10914,5,32,Don Maloney,0,12,5,LW,1990
10915,0,21,Don Marcotte,1,7,1,LW,1968
10916,3,22,Don Marcotte,9,35,12,LW,1969
10917,13,23,Don Marcotte,15,75,28,LW,1970
10918,4,24,Don Marcotte,6,47,10,LW,1971
10919,31,25,Don Marcotte,24,78,55,LW,1972
10920,26,26,Don Marcotte,24,78,50,LW,1973
10921,33,27,Don Marcotte,31,80,64,LW,1974
10922,20,28,Don Marcotte,16,58,36,LW,1975
10923,18,29,Don Marcotte,27,80,45,LW,1976
10924,34,30,Don Marcotte,20,77,54,LW,1977
10925,27,31,Don Marcotte,20,79,47,LW,1978
10926,11,32,Don Marcotte,4,32,15,LW,1979
10927,13,33,Don Marcotte,20,72,33,LW,1980
10928,21,34,Don Marcotte,13,69,34,LW,1981
10929,30,35,Don Marshall,19,70,49,LW,1967
10930,19,36,Don Marshall,20,74,39,C,1968
10931,15,37,Don Marshall,9,57,24,LW,1969
10932,29,38,Don Marshall,20,62,49,LW,1970
10933,14,39,Don Marshall,2,50,16,LW,1971
10934,0,21,Don Martineau,0,4,0,RW,1973
10935,9,22,Don Martineau,6,76,15,RW,1974
10936,1,23,Don Martineau,0,9,1,RW,1975
10937,0,24,Don Martineau,0,1,0,RW,1976
10938,9,23,Don McCulloch,1,51,10,D,1974
10939,20,33,Don McKenney,9,39,29,C,1967
10940,0,22,Don McLean,0,9,0,D,1975
10941,1,23,Don McSween,0,5,1,D,1987
10942,0,25,Don McSween,0,4,0,D,1989
10943,9,29,Don McSween,3,32,12,D,1993
10944,0,30,Don McSween,0,2,0,D,1994
10945,0,31,Don McSween,0,4,0,D,1995
10946,24,20,Don Murdoch,32,59,56,RW,1976
10947,28,21,Don Murdoch,27,66,55,RW,1977
10948,22,22,Don Murdoch,15,40,37,RW,1978
10949,21,23,Don Murdoch,28,66,49,RW,1979
10950,9,24,Don Murdoch,10,40,19,RW,1980
10951,13,25,Don Murdoch,9,49,22,RW,1981
10952,17,22,Don Nachbaur,16,77,33,C,1980
10953,21,23,Don Nachbaur,5,77,26,LW,1981
10954,0,24,Don Nachbaur,0,4,0,C,1982
10955,1,27,Don Nachbaur,1,5,2,C,1985
10956,2,28,Don Nachbaur,0,23,2,C,1986
10957,4,29,Don Nachbaur,0,20,4,C,1987
10958,0,30,Don Nachbaur,1,15,1,C,1988
10959,1,31,Don Nachbaur,0,2,1,C,1989
10960,6,20,Don O'Donoghue,5,68,11,RW,1969
10961,9,21,Don O'Donoghue,11,43,20,RW,1970
10962,2,22,Don O'Donoghue,2,14,4,RW,1971
10963,23,23,Don O'Donoghue,16,74,39,RW,1972
10964,23,23,Don O'Donoghue,16,74,39,RW,1972
10965,6,24,Don O'Donoghue,8,49,14,RW,1973
10966,6,24,Don O'Donoghue,8,49,14,RW,1973
10967,0,25,Don O'Donoghue,0,4,0,RW,1974
10968,0,25,Don O'Donoghue,0,4,0,RW,1974
10969,8,26,Don O'Donoghue,1,20,9,RW,1975
10970,8,26,Don O'Donoghue,1,20,9,RW,1975
10971,0,22,Don Saleski,0,1,0,RW,1971
10972,9,23,Don Saleski,12,78,21,RW,1972
10973,25,24,Don Saleski,15,77,40,RW,1973
10974,18,25,Don Saleski,10,63,28,RW,1974
10975,26,26,Don Saleski,21,78,47,RW,1975
10976,16,27,Don Saleski,22,74,38,RW,1976
10977,18,28,Don Saleski,27,70,45,RW,1977
10978,5,29,Don Saleski,13,51,18,RW,1978
10979,8,30,Don Saleski,8,51,16,RW,1979
10980,18,21,Don Spring,1,80,19,D,1980
10981,16,22,Don Spring,0,78,16,D,1981
10982,16,23,Don Spring,0,80,16,D,1982
10983,4,24,Don Spring,0,21,4,D,1983
10984,5,22,Don Sweeney,3,36,8,D,1988
10985,5,23,Don Sweeney,3,58,8,D,1989
10986,13,24,Don Sweeney,8,77,21,D,1990
10987,11,25,Don Sweeney,3,75,14,D,1991
10988,27,26,Don Sweeney,7,84,34,D,1992
10989,15,27,Don Sweeney,6,75,21,D,1993
10990,19,28,Don Sweeney,3,47,22,D,1994
10991,24,29,Don Sweeney,4,77,28,D,1995
10992,23,30,Don Sweeney,3,82,26,D,1996
10993,15,31,Don Sweeney,1,59,16,D,1997
10994,10,32,Don Sweeney,2,81,12,D,1998
10995,13,33,Don Sweeney,1,81,14,D,1999
10996,10,34,Don Sweeney,2,72,12,D,2000
10997,15,35,Don Sweeney,3,81,18,D,2001
10998,5,36,Don Sweeney,3,67,8,D,2002
10999,11,37,Don Sweeney,0,63,11,D,2003
11000,21,23,Don Tannahill,22,78,43,LW,1972
11001,12,24,Don Tannahill,8,33,20,LW,1973
11002,30,25,Don Tannahill,23,72,53,D,1974
11003,30,25,Don Tannahill,23,72,53,D,1974
11004,24,26,Don Tannahill,25,78,49,D,1975
11005,24,26,Don Tannahill,25,78,49,D,1975
11006,22,27,Don Tannahill,10,72,32,D,1976
11007,22,27,Don Tannahill,10,72,32,D,1976
11008,0,22,Don Waddell,0,1,0,D,1980
11009,0,20,Don Wheldon,0,2,0,D,1974
11010,3,21,Donald Audette,4,8,7,RW,1990
11011,17,22,Donald Audette,31,63,48,RW,1991
11012,7,23,Donald Audette,12,44,19,RW,1992
11013,30,24,Donald Audette,29,77,59,RW,1993
11014,13,25,Donald Audette,24,46,37,RW,1994
11015,13,26,Donald Audette,12,23,25,RW,1995
11016,22,27,Donald Audette,28,73,50,RW,1996
11017,20,28,Donald Audette,24,75,44,RW,1997
11018,18,29,Donald Audette,18,49,36,RW,1998
11019,24,30,Donald Audette,19,63,43,RW,1999
11020,45,31,Donald Audette,34,76,79,RW,2000
11021,13,32,Donald Audette,5,33,18,RW,2001
11022,12,33,Donald Audette,11,54,23,RW,2002
11023,12,34,Donald Audette,9,51,21,RW,2003
11024,2,22,Donald Brashear,2,14,4,LW,1993
11025,1,23,Donald Brashear,1,20,2,LW,1994
11026,4,24,Donald Brashear,0,67,4,LW,1995
11027,5,25,Donald Brashear,8,69,13,LW,1996
11028,9,26,Donald Brashear,9,77,18,LW,1997
11029,10,27,Donald Brashear,8,82,18,LW,1998
11030,2,28,Donald Brashear,11,60,13,LW,1999
11031,19,29,Donald Brashear,9,79,28,LW,2000
11032,23,30,Donald Brashear,9,81,32,LW,2001
11033,17,31,Donald Brashear,8,80,25,LW,2002
11034,7,32,Donald Brashear,6,64,13,LW,2003
11035,5,34,Donald Brashear,4,76,9,LW,2005
11036,9,35,Donald Brashear,4,77,13,LW,2006
11037,3,36,Donald Brashear,5,80,8,LW,2007
11038,3,37,Donald Brashear,1,63,4,LW,2008
11039,1,38,Donald Brashear,0,36,1,LW,2009
11040,1,21,Donald Dufresne,0,13,1,D,1988
11041,4,22,Donald Dufresne,0,18,4,D,1989
11042,13,23,Donald Dufresne,2,53,15,D,1990
11043,0,24,Donald Dufresne,0,3,0,D,1991
11044,2,25,Donald Dufresne,1,32,3,D,1992
11045,6,26,Donald Dufresne,2,60,8,D,1993
11046,3,27,Donald Dufresne,0,22,3,D,1994
11047,6,28,Donald Dufresne,1,45,7,D,1995
11048,1,29,Donald Dufresne,0,22,1,D,1996
11049,1,20,Doug Acomb,0,2,1,C,1969
11050,0,22,Doug Barrault,0,2,0,RW,1992
11051,0,23,Doug Barrault,0,2,0,RW,1993
11052,1,22,Doug Barrie,1,8,2,D,1968
11053,23,24,Doug Barrie,4,75,27,D,1970
11054,18,25,Doug Barrie,5,75,23,D,1971
11055,22,26,Doug Barrie,9,54,31,D,1972
11056,22,26,Doug Barrie,9,54,31,D,1972
11057,27,27,Doug Barrie,4,69,31,D,1973
11058,27,27,Doug Barrie,4,69,31,D,1973
11059,33,28,Doug Barrie,12,78,45,D,1974
11060,33,28,Doug Barrie,12,78,45,D,1974
11061,21,29,Doug Barrie,4,79,25,RW,1975
11062,21,29,Doug Barrie,4,79,25,RW,1975
11063,19,30,Doug Barrie,8,70,27,D,1976
11064,19,30,Doug Barrie,8,70,27,D,1976
11065,3,21,Doug Berry,6,29,9,C,1978
11066,3,21,Doug Berry,6,29,9,C,1978
11067,23,22,Doug Berry,7,75,30,C,1979
11068,10,23,Doug Berry,3,46,13,C,1980
11069,26,18,Doug Bodger,5,65,31,D,1984
11070,33,19,Doug Bodger,4,79,37,D,1985
11071,38,20,Doug Bodger,11,76,49,D,1986
11072,31,21,Doug Bodger,14,69,45,D,1987
11073,44,22,Doug Bodger,8,71,52,D,1988
11074,36,23,Doug Bodger,12,71,48,D,1989
11075,23,24,Doug Bodger,5,58,28,D,1990
11076,35,25,Doug Bodger,11,73,46,D,1991
11077,45,26,Doug Bodger,9,81,54,D,1992
11078,32,27,Doug Bodger,7,75,39,D,1993
11079,17,28,Doug Bodger,3,44,20,D,1994
11080,24,29,Doug Bodger,4,73,28,D,1995
11081,15,30,Doug Bodger,1,81,16,D,1996
11082,11,31,Doug Bodger,9,77,20,D,1997
11083,11,32,Doug Bodger,3,65,14,D,1998
11084,1,33,Doug Bodger,0,13,1,D,1999
11085,0,21,Doug Brindley,0,3,0,C,1970
11086,11,23,Doug Brindley,15,73,26,C,1972
11087,11,23,Doug Brindley,15,73,26,C,1972
11088,9,24,Doug Brindley,13,30,22,C,1973
11089,9,24,Doug Brindley,13,30,22,C,1973
11090,1,22,Doug Brown,0,4,1,RW,1986
11091,11,23,Doug Brown,14,70,25,RW,1987
11092,10,24,Doug Brown,15,63,25,RW,1988
11093,20,25,Doug Brown,14,69,34,RW,1989
11094,16,26,Doug Brown,14,58,30,RW,1990
11095,17,27,Doug Brown,11,71,28,RW,1991
11096,5,28,Doug Brown,0,15,5,RW,1992
11097,37,29,Doug Brown,18,77,55,RW,1993
11098,12,30,Doug Brown,9,45,21,RW,1994
11099,15,31,Doug Brown,12,62,27,LW,1995
11100,7,32,Doug Brown,6,49,13,LW,1996
11101,23,33,Doug Brown,19,80,42,C,1997
11102,19,34,Doug Brown,9,80,28,RW,1998
11103,8,35,Doug Brown,10,51,18,RW,1999
11104,13,36,Doug Brown,9,60,22,C,2000
11105,2,25,Doug Buhr,0,6,2,LW,1974
11106,2,20,Doug Crossman,0,9,2,D,1980
11107,28,21,Doug Crossman,12,70,40,D,1981
11108,40,22,Doug Crossman,13,80,53,D,1982
11109,28,23,Doug Crossman,7,78,35,D,1983
11110,33,24,Doug Crossman,4,80,37,D,1984
11111,37,25,Doug Crossman,6,80,43,D,1985
11112,31,26,Doug Crossman,9,78,40,D,1986
11113,29,27,Doug Crossman,9,76,38,D,1987
11114,15,28,Doug Crossman,10,74,25,D,1988
11115,44,29,Doug Crossman,15,80,59,D,1989
11116,29,30,Doug Crossman,8,74,37,D,1990
11117,8,31,Doug Crossman,0,26,8,D,1991
11118,28,32,Doug Crossman,10,59,38,D,1992
11119,7,33,Doug Crossman,2,50,9,D,1993
11120,1,29,Doug Doull,0,35,1,LW,2003
11121,0,31,Doug Doull,0,2,0,C,2005
11122,0,22,Doug Evans,1,13,1,C,1985
11123,13,23,Doug Evans,3,53,16,LW,1986
11124,7,24,Doug Evans,5,41,12,LW,1987
11125,12,25,Doug Evans,7,53,19,LW,1988
11126,8,26,Doug Evans,10,30,18,LW,1989
11127,27,27,Doug Evans,7,70,34,LW,1990
11128,7,28,Doug Evans,7,30,14,LW,1991
11129,13,29,Doug Evans,8,65,21,LW,1992
11130,0,26,Doug Friedman,0,16,0,LW,1997
11131,1,27,Doug Friedman,0,2,1,LW,1998
11132,0,20,Doug Gibson,0,2,0,C,1973
11133,18,22,Doug Gibson,7,50,25,C,1975
11134,1,24,Doug Gibson,2,11,3,C,1977
11135,28,20,Doug Gilmour,25,80,53,C,1983
11136,36,21,Doug Gilmour,21,78,57,C,1984
11137,28,22,Doug Gilmour,25,74,53,C,1985
11138,63,23,Doug Gilmour,42,80,105,C,1986
11139,50,24,Doug Gilmour,36,72,86,C,1987
11140,59,25,Doug Gilmour,26,72,85,C,1988
11141,67,26,Doug Gilmour,24,78,91,C,1989
11142,61,27,Doug Gilmour,20,78,81,C,1990
11143,61,28,Doug Gilmour,26,78,87,C,1991
11144,95,29,Doug Gilmour,32,83,127,C,1992
11145,84,30,Doug Gilmour,27,83,111,C,1993
11146,23,31,Doug Gilmour,10,44,33,C,1994
11147,40,32,Doug Gilmour,32,81,72,C,1995
11148,60,33,Doug Gilmour,22,81,82,C,1996
11149,40,34,Doug Gilmour,13,63,53,C,1997
11150,40,35,Doug Gilmour,16,72,56,C,1998
11151,48,36,Doug Gilmour,25,74,73,C,1999
11152,31,37,Doug Gilmour,7,71,38,LW,2000
11153,31,38,Doug Gilmour,10,70,41,C,2001
11154,19,39,Doug Gilmour,11,62,30,C,2002
11155,5,20,Doug Halward,1,22,6,D,1975
11156,2,21,Doug Halward,2,18,4,D,1976
11157,2,22,Doug Halward,0,25,2,D,1977
11158,5,23,Doug Halward,1,27,6,D,1978
11159,45,24,Doug Halward,11,63,56,D,1979
11160,16,25,Doug Halward,4,58,20,D,1980
11161,13,26,Doug Halward,4,37,17,D,1981
11162,33,27,Doug Halward,19,75,52,D,1982
11163,16,28,Doug Halward,7,54,23,D,1983
11164,27,29,Doug Halward,7,71,34,D,1984
11165,25,30,Doug Halward,8,70,33,D,1985
11166,6,31,Doug Halward,0,21,6,D,1986
11167,21,32,Doug Halward,5,70,26,D,1987
11168,8,33,Doug Halward,0,42,8,D,1988
11169,20,44,Doug Harvey,2,70,22,D,1968
11170,12,19,Doug Hicks,6,80,18,D,1974
11171,13,20,Doug Hicks,5,80,18,D,1975
11172,14,21,Doug Hicks,5,79,19,D,1976
11173,16,22,Doug Hicks,3,74,19,D,1977
11174,8,23,Doug Hicks,1,44,9,D,1978
11175,31,24,Doug Hicks,9,78,40,D,1979
11176,16,25,Doug Hicks,5,59,21,D,1980
11177,21,26,Doug Hicks,3,61,24,D,1981
11178,0,27,Doug Hicks,0,6,0,D,1982
11179,0,22,Doug Horbul,1,4,1,LW,1974
11180,0,19,Doug Houda,0,6,0,D,1985
11181,1,21,Doug Houda,1,11,2,D,1987
11182,11,22,Doug Houda,2,57,13,D,1988
11183,9,23,Doug Houda,2,73,11,D,1989
11184,6,24,Doug Houda,1,41,7,D,1990
11185,6,25,Doug Houda,3,56,9,D,1991
11186,6,26,Doug Houda,2,60,8,D,1992
11187,6,27,Doug Houda,2,61,8,D,1993
11188,2,28,Doug Houda,1,28,3,D,1994
11189,3,29,Doug Houda,1,38,4,D,1995
11190,8,30,Doug Houda,2,70,10,D,1996
11191,4,31,Doug Houda,2,55,6,D,1997
11192,1,32,Doug Houda,0,3,1,D,1998
11193,0,33,Doug Houda,0,1,0,D,1999
11194,0,36,Doug Houda,0,1,0,D,2002
11195,0,22,Doug Janik,0,6,0,D,2002
11196,0,23,Doug Janik,0,4,0,D,2003
11197,9,26,Doug Janik,2,75,11,D,2006
11198,3,27,Doug Janik,1,61,4,D,2007
11199,1,28,Doug Janik,0,15,1,D,2008
11200,2,29,Doug Janik,0,13,2,D,2009
11201,0,30,Doug Janik,0,7,0,D,2010
11202,1,31,Doug Janik,0,9,1,D,2011
11203,19,23,Doug Jarrett,4,74,23,D,1967
11204,13,24,Doug Jarrett,0,69,13,D,1968
11205,20,25,Doug Jarrett,4,72,24,D,1969
11206,12,26,Doug Jarrett,1,51,13,D,1970
11207,23,27,Doug Jarrett,6,78,29,D,1971
11208,11,28,Doug Jarrett,2,49,13,D,1972
11209,11,29,Doug Jarrett,5,67,16,D,1973
11210,21,30,Doug Jarrett,5,79,26,D,1974
11211,4,31,Doug Jarrett,0,45,4,D,1975
11212,0,32,Doug Jarrett,0,9,0,D,1976
11213,30,20,Doug Jarvis,5,80,35,C,1975
11214,22,21,Doug Jarvis,16,80,38,C,1976
11215,28,22,Doug Jarvis,11,80,39,C,1977
11216,13,23,Doug Jarvis,10,80,23,C,1978
11217,11,24,Doug Jarvis,13,80,24,C,1979
11218,22,25,Doug Jarvis,16,80,38,C,1980
11219,28,26,Doug Jarvis,20,80,48,C,1981
11220,22,27,Doug Jarvis,8,80,30,C,1982
11221,29,28,Doug Jarvis,13,80,42,C,1983
11222,28,29,Doug Jarvis,9,80,37,C,1984
11223,18,30,Doug Jarvis,9,82,27,C,1985
11224,13,31,Doug Jarvis,9,80,22,C,1986
11225,0,32,Doug Jarvis,0,2,0,C,1987
11226,0,24,Doug Kerslake,4,10,4,RW,1974
11227,0,24,Doug Kerslake,4,10,4,RW,1974
11228,1,25,Doug Kerslake,1,13,2,RW,1975
11229,1,25,Doug Kerslake,1,13,2,RW,1975
11230,1,20,Doug Kostynski,3,9,4,C,1983
11231,0,21,Doug Kostynski,0,6,0,C,1984
11232,0,20,Doug Lecuyer,1,2,1,LW,1978
11233,10,21,Doug Lecuyer,3,53,13,LW,1979
11234,17,22,Doug Lecuyer,6,59,23,LW,1980
11235,4,24,Doug Lecuyer,1,12,5,LW,1982
11236,0,23,Doug Lidster,0,8,0,D,1983
11237,24,24,Doug Lidster,6,78,30,D,1984
11238,16,25,Doug Lidster,12,78,28,D,1985
11239,51,26,Doug Lidster,12,80,63,D,1986
11240,32,27,Doug Lidster,4,64,36,D,1987
11241,17,28,Doug Lidster,5,63,22,D,1988
11242,28,29,Doug Lidster,8,80,36,D,1989
11243,32,30,Doug Lidster,6,78,38,D,1990
11244,23,31,Doug Lidster,6,66,29,D,1991
11245,19,32,Doug Lidster,6,71,25,D,1992
11246,2,33,Doug Lidster,0,34,2,D,1993
11247,7,34,Doug Lidster,2,37,9,D,1994
11248,9,35,Doug Lidster,5,59,14,D,1995
11249,4,36,Doug Lidster,3,48,7,D,1996
11250,4,37,Doug Lidster,0,36,4,D,1997
11251,0,38,Doug Lidster,0,17,0,D,1998
11252,0,21,Doug Lindskog,0,2,0,LW,1976
11253,0,21,Doug Lindskog,0,2,0,LW,1976
11254,0,20,Doug Lynch,0,2,0,D,2003
11255,0,23,Doug MacDonald,1,5,1,LW,1992
11256,0,24,Doug MacDonald,0,4,0,LW,1993
11257,0,25,Doug MacDonald,0,2,0,LW,1994
11258,29,34,Doug Mohns,24,65,53,LW,1967
11259,19,35,Doug Mohns,22,65,41,LW,1968
11260,27,36,Doug Mohns,6,66,33,D,1969
11261,11,37,Doug Mohns,6,56,17,D,1970
11262,30,38,Doug Mohns,6,78,36,D,1971
11263,13,39,Doug Mohns,4,67,17,D,1972
11264,3,40,Doug Mohns,0,28,3,D,1973
11265,19,41,Doug Mohns,2,75,21,D,1974
11266,0,19,Doug Morrison,0,1,0,RW,1979
11267,3,20,Doug Morrison,7,18,10,RW,1980
11268,0,21,Doug Morrison,0,3,0,RW,1981
11269,0,24,Doug Morrison,0,1,0,RW,1984
11270,0,21,Doug O'Brien,0,5,0,D,2005
11271,17,22,Doug Palazzari,14,73,31,LW,1974
11272,0,24,Doug Palazzari,1,12,1,C,1976
11273,0,25,Doug Palazzari,1,3,1,C,1977
11274,3,26,Doug Palazzari,2,20,5,C,1978
11275,1,20,Doug Patey,3,37,4,RW,1976
11276,1,21,Doug Patey,0,2,1,RW,1977
11277,0,22,Doug Patey,1,6,1,RW,1978
11278,32,21,Doug Risebrough,15,64,47,C,1974
11279,28,22,Doug Risebrough,16,80,44,C,1975
11280,38,23,Doug Risebrough,22,78,60,C,1976
11281,23,24,Doug Risebrough,18,72,41,C,1977
11282,15,25,Doug Risebrough,10,48,25,C,1978
11283,10,26,Doug Risebrough,8,44,18,C,1979
11284,21,27,Doug Risebrough,13,48,34,C,1980
11285,18,28,Doug Risebrough,15,59,33,C,1981
11286,37,29,Doug Risebrough,21,71,58,C,1982
11287,28,30,Doug Risebrough,23,77,51,C,1983
11288,5,31,Doug Risebrough,7,15,12,C,1984
11289,28,32,Doug Risebrough,15,62,43,C,1985
11290,3,33,Doug Risebrough,2,22,5,C,1986
11291,9,25,Doug Roberts,8,37,17,RW,1967
11292,19,26,Doug Roberts,1,76,20,D,1968
11293,25,27,Doug Roberts,6,76,31,RW,1969
11294,13,28,Doug Roberts,4,78,17,D,1970
11295,0,29,Doug Roberts,1,3,1,RW,1971
11296,7,30,Doug Roberts,4,45,11,RW,1972
11297,26,31,Doug Roberts,12,64,38,RW,1973
11298,4,32,Doug Roberts,4,26,8,RW,1974
11299,13,33,Doug Roberts,4,76,17,D,1975
11300,18,34,Doug Roberts,3,64,21,D,1976
11301,18,34,Doug Roberts,3,64,21,D,1976
11302,9,27,Doug Robinson,9,34,18,LW,1967
11303,10,28,Doug Robinson,2,31,12,LW,1968
11304,13,30,Doug Robinson,15,61,28,LW,1970
11305,0,22,Doug Rombough,2,5,2,C,1972
11306,10,23,Doug Rombough,9,58,19,C,1973
11307,15,24,Doug Rombough,11,68,26,C,1974
11308,2,25,Doug Rombough,2,19,4,C,1975
11309,15,20,Doug Shedden,10,38,25,C,1981
11310,43,21,Doug Shedden,24,80,67,C,1982
11311,35,22,Doug Shedden,22,67,57,C,1983
11312,32,23,Doug Shedden,35,80,67,RW,1984
11313,37,24,Doug Shedden,34,78,71,RW,1985
11314,14,25,Doug Shedden,6,49,20,RW,1986
11315,0,27,Doug Shedden,0,1,0,C,1988
11316,10,29,Doug Shedden,8,23,18,RW,1990
11317,1,22,Doug Shelton,0,5,1,RW,1967
11318,8,23,Doug Smail,10,30,18,LW,1980
11319,18,24,Doug Smail,17,72,35,LW,1981
11320,29,25,Doug Smail,15,80,44,LW,1982
11321,17,26,Doug Smail,20,66,37,LW,1983
11322,35,27,Doug Smail,31,80,66,LW,1984
11323,26,28,Doug Smail,16,73,42,LW,1985
11324,18,29,Doug Smail,25,78,43,LW,1986
11325,16,30,Doug Smail,15,71,31,LW,1987
11326,15,31,Doug Smail,14,47,29,LW,1988
11327,24,32,Doug Smail,25,79,49,LW,1989
11328,15,33,Doug Smail,8,72,23,RW,1990
11329,18,34,Doug Smail,10,46,28,LW,1991
11330,10,35,Doug Smail,4,51,14,RW,1992
11331,14,18,Doug Smith,16,80,30,C,1981
11332,11,19,Doug Smith,11,42,22,C,1982
11333,20,20,Doug Smith,16,72,36,C,1983
11334,20,21,Doug Smith,21,62,41,C,1984
11335,20,22,Doug Smith,18,78,38,C,1985
11336,24,23,Doug Smith,16,62,40,C,1986
11337,19,24,Doug Smith,9,70,28,C,1987
11338,5,25,Doug Smith,4,29,9,C,1988
11339,5,26,Doug Smith,4,40,9,C,1989
11340,7,20,Doug Sulliman,4,31,11,RW,1979
11341,1,21,Doug Sulliman,4,32,5,RW,1980
11342,40,22,Doug Sulliman,29,77,69,RW,1981
11343,19,23,Doug Sulliman,22,77,41,RW,1982
11344,13,24,Doug Sulliman,6,67,19,RW,1983
11345,16,25,Doug Sulliman,22,57,38,LW,1984
11346,22,26,Doug Sulliman,21,73,43,RW,1985
11347,26,27,Doug Sulliman,27,78,53,RW,1986
11348,14,28,Doug Sulliman,16,59,30,RW,1987
11349,6,29,Doug Sulliman,6,52,12,RW,1988
11350,4,30,Doug Sulliman,3,28,7,RW,1989
11351,0,21,Doug Trapp,0,2,0,LW,1986
11352,1,26,Doug Volmar,0,2,1,RW,1970
11353,5,27,Doug Volmar,9,39,14,RW,1971
11354,2,28,Doug Volmar,4,21,6,RW,1972
11355,1,30,Doug Volmar,0,10,1,RW,1974
11356,22,21,Doug Weight,8,53,30,LW,1991
11357,31,22,Doug Weight,17,78,48,C,1992
11358,50,23,Doug Weight,24,84,74,C,1993
11359,33,24,Doug Weight,7,48,40,C,1994
11360,79,25,Doug Weight,25,82,104,C,1995
11361,61,26,Doug Weight,21,80,82,C,1996
11362,44,27,Doug Weight,26,79,70,C,1997
11363,31,28,Doug Weight,6,43,37,C,1998
11364,51,29,Doug Weight,21,77,72,C,1999
11365,65,30,Doug Weight,25,82,90,C,2000
11366,34,31,Doug Weight,15,61,49,C,2001
11367,52,32,Doug Weight,15,70,67,C,2002
11368,51,33,Doug Weight,14,75,65,C,2003
11369,42,35,Doug Weight,15,70,57,C,2005
11370,43,36,Doug Weight,16,82,59,C,2006
11371,15,37,Doug Weight,10,67,25,C,2007
11372,28,38,Doug Weight,10,53,38,C,2008
11373,16,39,Doug Weight,1,36,17,C,2009
11374,7,40,Doug Weight,2,18,9,C,2010
11375,8,19,Doug Wickenheiser,7,41,15,C,1980
11376,23,20,Doug Wickenheiser,12,56,35,C,1981
11377,30,21,Doug Wickenheiser,25,78,55,C,1982
11378,26,22,Doug Wickenheiser,12,73,38,C,1983
11379,20,23,Doug Wickenheiser,23,68,43,C,1984
11380,11,24,Doug Wickenheiser,8,36,19,C,1985
11381,15,25,Doug Wickenheiser,13,80,28,LW,1986
11382,19,26,Doug Wickenheiser,7,80,26,C,1987
11383,5,27,Doug Wickenheiser,3,17,8,C,1988
11384,8,28,Doug Wickenheiser,1,27,9,C,1989
11385,20,20,Doug Wilson,14,77,34,D,1977
11386,21,21,Doug Wilson,5,56,26,D,1978
11387,49,22,Doug Wilson,12,73,61,D,1979
11388,39,23,Doug Wilson,12,76,51,D,1980
11389,46,24,Doug Wilson,39,76,85,D,1981
11390,51,25,Doug Wilson,18,74,69,D,1982
11391,45,26,Doug Wilson,13,66,58,D,1983
11392,54,27,Doug Wilson,22,78,76,D,1984
11393,47,28,Doug Wilson,17,79,64,D,1985
11394,32,29,Doug Wilson,16,69,48,D,1986
11395,24,30,Doug Wilson,8,27,32,D,1987
11396,47,31,Doug Wilson,15,66,62,D,1988
11397,50,32,Doug Wilson,23,70,73,D,1989
11398,29,33,Doug Wilson,11,51,40,D,1990
11399,19,34,Doug Wilson,9,44,28,D,1991
11400,17,35,Doug Wilson,3,42,20,D,1992
11401,10,22,Doug Zmolek,5,84,15,D,1992
11402,4,23,Doug Zmolek,1,75,5,D,1993
11403,5,24,Doug Zmolek,0,42,5,D,1994
11404,5,25,Doug Zmolek,2,58,7,D,1995
11405,0,26,Doug Zmolek,1,57,1,D,1996
11406,8,27,Doug Zmolek,0,46,8,D,1997
11407,14,28,Doug Zmolek,0,62,14,D,1998
11408,7,29,Doug Zmolek,2,43,9,D,1999
11409,11,19,Dougie Hamilton,5,42,16,D,2012
11410,18,20,Dougie Hamilton,7,64,25,D,2013
11411,32,21,Dougie Hamilton,10,72,42,D,2014
11412,31,22,Dougie Hamilton,12,82,43,D,2015
11413,37,23,Dougie Hamilton,13,81,50,D,2016
11414,27,24,Dougie Hamilton,17,82,44,D,2017
11415,1,25,Douglas Murray,0,34,1,D,2005
11416,3,26,Douglas Murray,0,35,3,D,2006
11417,9,27,Douglas Murray,1,66,10,D,2007
11418,7,28,Douglas Murray,0,75,7,D,2008
11419,13,29,Douglas Murray,4,79,17,D,2009
11420,13,30,Douglas Murray,1,73,14,D,2010
11421,4,31,Douglas Murray,0,60,4,D,2011
11422,5,32,Douglas Murray,1,43,6,D,2012
11423,2,33,Douglas Murray,0,53,2,D,2013
11424,1,19,Drake Berehowsky,0,8,1,D,1990
11425,0,20,Drake Berehowsky,0,1,0,D,1991
11426,15,21,Drake Berehowsky,4,41,19,D,1992
11427,8,22,Drake Berehowsky,2,49,10,D,1993
11428,2,23,Drake Berehowsky,0,29,2,D,1994
11429,0,24,Drake Berehowsky,0,1,0,D,1995
11430,6,26,Drake Berehowsky,1,67,7,D,1997
11431,15,27,Drake Berehowsky,2,74,17,D,1998
11432,20,28,Drake Berehowsky,12,79,32,D,1999
11433,19,29,Drake Berehowsky,7,80,26,D,2000
11434,6,30,Drake Berehowsky,2,57,8,D,2001
11435,2,31,Drake Berehowsky,1,7,3,D,2002
11436,18,32,Drake Berehowsky,6,56,24,D,2003
11437,11,22,Drake Caggiula,7,60,18,LW,2016
11438,7,23,Drake Caggiula,13,67,20,LW,2017
11439,0,20,Drayson Bowman,2,9,2,C,2009
11440,1,21,Drayson Bowman,0,23,1,C,2010
11441,7,22,Drayson Bowman,6,37,13,C,2011
11442,2,23,Drayson Bowman,3,37,5,C,2012
11443,8,24,Drayson Bowman,4,70,12,LW,2013
11444,0,25,Drayson Bowman,0,3,0,LW,2014
11445,0,27,Drew Bagnall,0,2,0,D,2010
11446,1,21,Drew Bannister,0,13,1,D,1995
11447,14,22,Drew Bannister,4,65,18,D,1996
11448,8,23,Drew Bannister,0,61,8,D,1997
11449,2,24,Drew Bannister,1,21,3,D,1998
11450,0,26,Drew Bannister,0,3,0,D,2000
11451,0,27,Drew Bannister,0,1,0,D,2001
11452,0,20,Drew Callander,1,2,1,C,1976
11453,0,21,Drew Callander,0,1,0,C,1977
11454,1,22,Drew Callander,4,32,5,C,1978
11455,1,23,Drew Callander,1,4,2,C,1979
11456,21,19,Drew Doughty,6,81,27,D,2008
11457,43,20,Drew Doughty,16,82,59,D,2009
11458,29,21,Drew Doughty,11,76,40,D,2010
11459,26,22,Drew Doughty,10,77,36,D,2011
11460,16,23,Drew Doughty,6,48,22,D,2012
11461,27,24,Drew Doughty,10,78,37,D,2013
11462,39,25,Drew Doughty,7,82,46,D,2014
11463,37,26,Drew Doughty,14,82,51,D,2015
11464,32,27,Drew Doughty,12,82,44,D,2016
11465,50,28,Drew Doughty,10,82,60,D,2017
11466,0,23,Drew Fata,1,3,1,D,2006
11467,1,24,Drew Fata,0,5,1,D,2007
11468,0,21,Drew Larman,2,16,2,C,2006
11469,1,22,Drew Larman,0,6,1,C,2007
11470,0,24,Drew Larman,0,4,0,C,2009
11471,0,23,Drew LeBlanc,0,2,0,C,2012
11472,3,23,Drew Miller,2,26,5,LW,2007
11473,6,24,Drew Miller,4,27,10,LW,2008
11474,9,25,Drew Miller,10,80,19,LW,2009
11475,8,26,Drew Miller,10,67,18,LW,2010
11476,11,27,Drew Miller,14,80,25,LW,2011
11477,4,28,Drew Miller,4,44,8,LW,2012
11478,8,29,Drew Miller,7,82,15,LW,2013
11479,8,30,Drew Miller,5,82,13,LW,2014
11480,1,31,Drew Miller,1,28,2,LW,2015
11481,2,32,Drew Miller,5,55,7,LW,2016
11482,10,22,Drew Shore,3,43,13,C,2012
11483,2,23,Drew Shore,5,24,7,C,2013
11484,2,24,Drew Shore,1,11,3,C,2014
11485,1,25,Drew Shore,0,2,1,C,2015
11486,2,26,Drew Shore,0,14,2,C,2016
11487,14,21,Drew Stafford,13,41,27,RW,2006
11488,22,22,Drew Stafford,16,64,38,RW,2007
11489,25,23,Drew Stafford,20,79,45,RW,2008
11490,20,24,Drew Stafford,14,71,34,RW,2009
11491,21,25,Drew Stafford,31,62,52,RW,2010
11492,30,26,Drew Stafford,20,80,50,RW,2011
11493,12,27,Drew Stafford,6,46,18,RW,2012
11494,18,28,Drew Stafford,16,70,34,RW,2013
11495,25,29,Drew Stafford,18,76,43,RW,2014
11496,17,30,Drew Stafford,21,78,38,RW,2015
11497,4,31,Drew Stafford,4,18,8,RW,2016
11498,7,32,Drew Stafford,8,59,15,RW,2017
11499,1,22,Dryden Hunt,0,11,1,LW,2017
11500,6,22,Duane Bray,2,46,8,D,1976
11501,6,22,Duane Bray,2,46,8,D,1976
11502,0,28,Duane Joyce,0,3,0,D,1993
11503,8,29,Duane Rupp,1,71,9,D,1967
11504,11,30,Duane Rupp,5,59,16,D,1968
11505,14,31,Duane Rupp,2,64,16,D,1969
11506,28,32,Duane Rupp,5,59,33,D,1970
11507,18,33,Duane Rupp,4,34,22,D,1971
11508,13,34,Duane Rupp,7,78,20,D,1972
11509,26,36,Duane Rupp,3,73,29,D,1974
11510,26,36,Duane Rupp,3,73,29,D,1974
11511,16,37,Duane Rupp,0,42,16,D,1975
11512,16,37,Duane Rupp,0,42,16,D,1975
11513,9,19,Duane Sutter,15,56,24,RW,1979
11514,11,20,Duane Sutter,7,23,18,RW,1980
11515,35,21,Duane Sutter,18,77,53,RW,1981
11516,19,22,Duane Sutter,13,75,32,RW,1982
11517,23,23,Duane Sutter,17,78,40,RW,1983
11518,24,24,Duane Sutter,17,78,41,RW,1984
11519,33,25,Duane Sutter,20,80,53,RW,1985
11520,17,26,Duane Sutter,14,80,31,RW,1986
11521,9,27,Duane Sutter,7,37,16,RW,1987
11522,9,28,Duane Sutter,7,75,16,RW,1988
11523,14,29,Duane Sutter,4,72,18,C,1989
11524,3,24,Duane Wylie,1,6,4,C,1974
11525,0,26,Duane Wylie,2,8,2,C,1976
11526,4,25,Duke Harris,1,26,5,RW,1967
11527,12,30,Duke Harris,30,75,42,RW,1972
11528,12,30,Duke Harris,30,75,42,RW,1972
11529,16,31,Duke Harris,14,64,30,RW,1973
11530,16,31,Duke Harris,14,64,30,RW,1973
11531,19,32,Duke Harris,9,54,28,RW,1974
11532,19,32,Duke Harris,9,54,28,RW,1974
11533,2,27,Dunc McCallum,0,32,2,D,1967
11534,13,28,Dunc McCallum,5,62,18,D,1968
11535,0,29,Dunc McCallum,0,14,0,D,1969
11536,20,30,Dunc McCallum,9,77,29,D,1970
11537,20,32,Dunc McCallum,9,69,29,D,1972
11538,10,34,Dunc McCallum,0,31,10,D,1974
11539,17,27,Dunc Rousseau,16,75,33,LW,1972
11540,17,27,Dunc Rousseau,16,75,33,LW,1972
11541,8,28,Dunc Rousseau,10,60,18,LW,1973
11542,8,28,Dunc Rousseau,10,60,18,LW,1973
11543,12,22,Duncan Keith,9,81,21,D,2005
11544,29,23,Duncan Keith,2,82,31,D,2006
11545,20,24,Duncan Keith,12,82,32,D,2007
11546,36,25,Duncan Keith,8,77,44,D,2008
11547,55,26,Duncan Keith,14,82,69,D,2009
11548,38,27,Duncan Keith,7,82,45,D,2010
11549,36,28,Duncan Keith,4,74,40,D,2011
11550,24,29,Duncan Keith,3,47,27,D,2012
11551,55,30,Duncan Keith,6,79,61,D,2013
11552,35,31,Duncan Keith,10,80,45,D,2014
11553,34,32,Duncan Keith,9,67,43,D,2015
11554,47,33,Duncan Keith,6,80,53,D,2016
11555,30,34,Duncan Keith,2,82,32,D,2017
11556,1,23,Duncan Milroy,0,5,1,RW,2006
11557,0,21,Duncan Siemens,0,1,0,D,2014
11558,0,23,Duncan Siemens,0,3,0,D,2016
11559,1,24,Duncan Siemens,1,16,2,D,2017
11560,10,28,Dusan Pasek,4,48,14,RW,1988
11561,2,20,Dustin Boyd,2,13,4,C,2006
11562,5,21,Dustin Boyd,7,48,12,C,2007
11563,11,22,Dustin Boyd,11,71,22,C,2008
11564,13,23,Dustin Boyd,11,78,24,C,2009
11565,0,24,Dustin Boyd,1,10,1,C,2010
11566,4,19,Dustin Brown,1,31,5,RW,2003
11567,14,21,Dustin Brown,14,79,28,RW,2005
11568,29,22,Dustin Brown,17,81,46,LW,2006
11569,27,23,Dustin Brown,33,78,60,RW,2007
11570,29,24,Dustin Brown,24,80,53,RW,2008
11571,32,25,Dustin Brown,24,82,56,RW,2009
11572,29,26,Dustin Brown,28,82,57,RW,2010
11573,32,27,Dustin Brown,22,82,54,RW,2011
11574,11,28,Dustin Brown,18,46,29,RW,2012
11575,12,29,Dustin Brown,15,79,27,RW,2013
11576,16,30,Dustin Brown,11,82,27,LW,2014
11577,17,31,Dustin Brown,11,82,28,RW,2015
11578,22,32,Dustin Brown,14,80,36,RW,2016
11579,33,33,Dustin Brown,28,81,61,RW,2017
11580,2,20,Dustin Byfuglien,3,25,5,D,2005
11581,2,21,Dustin Byfuglien,1,9,3,D,2006
11582,17,22,Dustin Byfuglien,19,67,36,D,2007
11583,16,23,Dustin Byfuglien,15,77,31,RW,2008
11584,17,24,Dustin Byfuglien,17,82,34,D,2009
11585,33,25,Dustin Byfuglien,20,81,53,D,2010
11586,41,26,Dustin Byfuglien,12,66,53,D,2011
11587,20,27,Dustin Byfuglien,8,43,28,D,2012
11588,36,28,Dustin Byfuglien,20,78,56,D,2013
11589,27,29,Dustin Byfuglien,18,69,45,D,2014
11590,34,30,Dustin Byfuglien,19,81,53,D,2015
11591,39,31,Dustin Byfuglien,13,80,52,D,2016
11592,37,32,Dustin Byfuglien,8,69,45,D,2017
11593,2,20,Dustin Jeffrey,1,14,3,C,2008
11594,0,21,Dustin Jeffrey,0,1,0,C,2009
11595,5,22,Dustin Jeffrey,7,25,12,C,2010
11596,2,23,Dustin Jeffrey,4,26,6,C,2011
11597,3,24,Dustin Jeffrey,3,24,6,C,2012
11598,2,25,Dustin Jeffrey,2,34,4,C,2013
11599,1,27,Dustin Jeffrey,1,7,2,C,2015
11600,4,22,Dustin Kohn,0,22,4,D,2009
11601,3,23,Dustin Penner,4,19,7,RW,2005
11602,16,24,Dustin Penner,29,82,45,RW,2006
11603,24,25,Dustin Penner,23,82,47,LW,2007
11604,20,26,Dustin Penner,17,78,37,LW,2008
11605,31,27,Dustin Penner,32,82,63,RW,2009
11606,22,28,Dustin Penner,23,81,45,RW,2010
11607,10,29,Dustin Penner,7,65,17,RW,2011
11608,12,30,Dustin Penner,2,33,14,RW,2012
11609,21,31,Dustin Penner,14,67,35,LW,2013
11610,0,24,Duvie Westcott,0,4,0,D,2001
11611,7,25,Duvie Westcott,0,39,7,D,2002
11612,7,26,Duvie Westcott,0,34,7,D,2003
11613,22,28,Duvie Westcott,6,78,28,D,2005
11614,6,29,Duvie Westcott,4,23,10,D,2006
11615,3,30,Duvie Westcott,1,23,4,D,2007
11616,0,20,Dwayne Hay,0,2,0,LW,1997
11617,0,21,Dwayne Hay,0,9,0,LW,1998
11618,1,22,Dwayne Hay,1,19,2,RW,1999
11619,3,23,Dwayne Hay,1,49,4,RW,2000
11620,1,23,Dwayne Lowdermilk,0,2,1,D,1980
11621,1,24,Dwayne Norris,1,4,2,RW,1993
11622,2,25,Dwayne Norris,1,13,3,RW,1994
11623,1,26,Dwayne Norris,0,3,1,RW,1995
11624,2,23,Dwayne Pentland,1,29,3,D,1976
11625,2,23,Dwayne Pentland,1,29,3,D,1976
11626,1,27,Dwayne Zinger,0,7,1,D,2003
11627,0,21,Dwight Bialowas,0,11,0,D,1973
11628,19,22,Dwight Bialowas,5,77,24,D,1974
11629,18,23,Dwight Bialowas,5,58,23,D,1975
11630,9,24,Dwight Bialowas,1,18,10,D,1976
11631,0,23,Dwight Carruthers,0,1,0,D,1967
11632,1,20,Dwight Foster,2,14,3,C,1977
11633,13,21,Dwight Foster,11,44,24,C,1978
11634,28,22,Dwight Foster,10,57,38,C,1979
11635,28,23,Dwight Foster,24,77,52,RW,1980
11636,19,24,Dwight Foster,12,70,31,RW,1981
11637,22,25,Dwight Foster,17,62,39,C,1982
11638,12,26,Dwight Foster,9,52,21,RW,1983
11639,16,27,Dwight Foster,16,50,32,C,1984
11640,12,28,Dwight Foster,6,68,18,C,1985
11641,12,29,Dwight Foster,4,47,16,C,1986
11642,1,25,Dwight Helminen,1,23,2,C,2008
11643,0,26,Dwight Helminen,1,4,1,C,2009
11644,0,21,Dwight King,0,6,0,LW,2010
11645,9,22,Dwight King,5,27,14,LW,2011
11646,6,23,Dwight King,4,47,10,LW,2012
11647,15,24,Dwight King,15,77,30,LW,2013
11648,13,25,Dwight King,13,81,26,LW,2014
11649,6,26,Dwight King,7,47,13,LW,2015
11650,0,27,Dwight King,1,17,1,LW,2016
11651,0,22,Dwight Mathiasen,1,4,1,RW,1985
11652,1,23,Dwight Mathiasen,0,6,1,RW,1986
11653,6,24,Dwight Mathiasen,0,23,6,RW,1987
11654,0,20,Dwight Schofield,1,3,1,D,1976
11655,0,26,Dwight Schofield,0,2,0,D,1982
11656,10,27,Dwight Schofield,4,70,14,D,1983
11657,4,28,Dwight Schofield,1,43,5,D,1984
11658,2,29,Dwight Schofield,1,50,3,D,1985
11659,6,30,Dwight Schofield,1,25,7,D,1986
11660,0,31,Dwight Schofield,0,18,0,LW,1987
11661,2,22,Dylan DeMelo,2,45,4,D,2015
11662,7,23,Dylan DeMelo,1,25,8,D,2016
11663,20,24,Dylan DeMelo,0,63,20,D,2017
11664,0,21,Dylan Gambrell,0,3,0,C,2017
11665,22,19,Dylan Larkin,23,80,45,C,2015
11666,15,20,Dylan Larkin,17,80,32,C,2016
11667,47,21,Dylan Larkin,16,82,63,C,2017
11668,0,21,Dylan McIlrath,0,2,0,D,2013
11669,0,22,Dylan McIlrath,0,1,0,D,2014
11670,2,23,Dylan McIlrath,2,34,4,D,2015
11671,0,24,Dylan McIlrath,0,1,0,D,2016
11672,1,21,Dylan Olsen,0,28,1,D,2011
11673,9,23,Dylan Olsen,3,44,12,D,2013
11674,6,24,Dylan Olsen,2,44,8,D,2014
11675,1,25,Dylan Olsen,0,8,1,D,2015
11676,2,25,Dylan Reese,2,19,4,D,2009
11677,6,26,Dylan Reese,0,27,6,D,2010
11678,6,27,Dylan Reese,1,28,7,D,2011
11679,0,28,Dylan Reese,0,3,0,D,2012
11680,0,30,Dylan Reese,0,1,0,D,2014
11681,3,22,Dylan Sikura,0,5,3,RW,2017
11682,1,19,Dylan Strome,0,7,1,C,2016
11683,5,20,Dylan Strome,4,21,9,C,2017
11684,7,23,Earl Anderson,9,64,16,RW,1974
11685,1,24,Earl Anderson,0,5,1,RW,1975
11686,11,25,Earl Anderson,10,40,21,RW,1976
11687,3,26,Earl Heiskala,3,21,6,LW,1968
11688,7,27,Earl Heiskala,8,65,15,LW,1969
11689,1,28,Earl Heiskala,2,41,3,LW,1970
11690,17,30,Earl Heiskala,12,70,29,RW,1972
11691,17,30,Earl Heiskala,12,70,29,RW,1972
11692,6,31,Earl Heiskala,2,24,8,LW,1973
11693,6,31,Earl Heiskala,2,24,8,LW,1973
11694,22,33,Earl Ingarfield,15,50,37,C,1967
11695,30,34,Earl Ingarfield,16,66,46,LW,1968
11696,24,35,Earl Ingarfield,21,54,45,C,1969
11697,8,36,Earl Ingarfield,5,49,13,C,1970
11698,0,21,Earl Ingarfield,0,1,0,C,1979
11699,4,22,Earl Ingarfield,4,38,8,C,1980
11700,7,20,Ed Cooper,7,47,14,LW,1980
11701,0,21,Ed Cooper,1,2,1,LW,1981
11702,0,23,Ed Courtenay,0,5,0,RW,1991
11703,13,24,Ed Courtenay,7,39,20,C,1992
11704,1,22,Ed Cristofoli,0,9,1,C,1989
11705,22,22,Ed Gilbert,16,80,38,C,1974
11706,9,23,Ed Gilbert,5,79,14,C,1975
11707,0,24,Ed Gilbert,0,7,0,C,1976
11708,3,26,Ed Gilbert,3,29,6,C,1978
11709,3,26,Ed Gilbert,3,29,6,C,1978
11710,1,21,Ed Hatoum,2,16,3,RW,1968
11711,2,22,Ed Hatoum,0,5,2,RW,1969
11712,3,23,Ed Hatoum,1,26,4,RW,1970
11713,1,25,Ed Hatoum,1,15,2,RW,1972
11714,1,25,Ed Hatoum,1,15,2,RW,1972
11715,12,26,Ed Hatoum,3,37,15,RW,1973
11716,12,26,Ed Hatoum,3,37,15,RW,1973
11717,21,30,Ed Hoekstra,15,70,36,C,1967
11718,28,35,Ed Hoekstra,11,78,39,RW,1972
11719,28,35,Ed Hoekstra,11,78,39,RW,1972
11720,0,36,Ed Hoekstra,2,19,2,C,1973
11721,0,36,Ed Hoekstra,2,19,2,C,1973
11722,1,20,Ed Hospodar,0,20,1,D,1979
11723,14,21,Ed Hospodar,5,61,19,D,1980
11724,8,22,Ed Hospodar,3,41,11,D,1981
11725,9,23,Ed Hospodar,1,72,10,D,1982
11726,9,24,Ed Hospodar,0,59,9,D,1983
11727,4,25,Ed Hospodar,3,50,7,D,1984
11728,3,26,Ed Hospodar,3,60,6,D,1985
11729,2,27,Ed Hospodar,2,45,4,D,1986
11730,1,28,Ed Hospodar,0,42,1,D,1987
11731,11,19,Ed Jovanovski,10,70,21,D,1995
11732,16,20,Ed Jovanovski,7,61,23,D,1996
11733,14,21,Ed Jovanovski,9,81,23,D,1997
11734,22,22,Ed Jovanovski,5,72,27,D,1998
11735,21,23,Ed Jovanovski,5,75,26,D,1999
11736,35,24,Ed Jovanovski,12,79,47,D,2000
11737,31,25,Ed Jovanovski,17,82,48,D,2001
11738,40,26,Ed Jovanovski,6,67,46,D,2002
11739,16,27,Ed Jovanovski,7,56,23,D,2003
11740,25,29,Ed Jovanovski,8,44,33,D,2005
11741,18,30,Ed Jovanovski,11,54,29,D,2006
11742,39,31,Ed Jovanovski,12,80,51,D,2007
11743,27,32,Ed Jovanovski,9,82,36,D,2008
11744,24,33,Ed Jovanovski,10,66,34,D,2009
11745,9,34,Ed Jovanovski,5,50,14,D,2010
11746,10,35,Ed Jovanovski,3,66,13,D,2011
11747,1,36,Ed Jovanovski,0,6,1,D,2012
11748,4,37,Ed Jovanovski,1,37,5,D,2013
11749,0,22,Ed Kastelic,0,15,0,RW,1985
11750,1,23,Ed Kastelic,1,23,2,RW,1986
11751,0,24,Ed Kastelic,1,35,1,RW,1987
11752,2,25,Ed Kastelic,0,10,2,RW,1988
11753,2,26,Ed Kastelic,6,67,8,RW,1989
11754,2,27,Ed Kastelic,2,45,4,RW,1990
11755,3,28,Ed Kastelic,1,25,4,RW,1991
11756,2,26,Ed Kea,0,3,2,D,1973
11757,9,27,Ed Kea,1,50,10,D,1974
11758,19,28,Ed Kea,8,78,27,D,1975
11759,21,29,Ed Kea,4,72,25,D,1976
11760,23,30,Ed Kea,3,60,26,D,1977
11761,18,31,Ed Kea,6,53,24,D,1978
11762,16,32,Ed Kea,3,69,19,D,1979
11763,18,33,Ed Kea,3,74,21,D,1980
11764,14,34,Ed Kea,2,78,16,D,1981
11765,5,35,Ed Kea,0,46,5,D,1982
11766,30,18,Ed Olczyk,20,70,50,RW,1984
11767,50,19,Ed Olczyk,29,79,79,RW,1985
11768,35,20,Ed Olczyk,16,79,51,C,1986
11769,33,21,Ed Olczyk,42,80,75,RW,1987
11770,52,22,Ed Olczyk,38,80,90,C,1988
11771,56,23,Ed Olczyk,32,79,88,C,1989
11772,41,24,Ed Olczyk,30,79,71,C,1990
11773,33,25,Ed Olczyk,32,64,65,C,1991
11774,28,26,Ed Olczyk,21,71,49,LW,1992
11775,5,27,Ed Olczyk,3,37,8,C,1993
11776,9,28,Ed Olczyk,4,33,13,LW,1994
11777,22,29,Ed Olczyk,27,51,49,RW,1995
11778,30,30,Ed Olczyk,25,79,55,RW,1996
11779,11,31,Ed Olczyk,11,56,22,LW,1997
11780,15,32,Ed Olczyk,10,61,25,C,1998
11781,2,33,Ed Olczyk,2,33,4,RW,1999
11782,1,21,Ed Patterson,3,27,4,RW,1993
11783,2,23,Ed Patterson,0,35,2,RW,1995
11784,0,24,Ed Patterson,0,6,0,RW,1996
11785,0,21,Ed Pizunski,0,1,0,RW,1975
11786,0,21,Ed Pizunski,0,1,0,RW,1975
11787,0,23,Ed Ronan,0,3,0,RW,1991
11788,7,24,Ed Ronan,5,53,12,RW,1992
11789,8,25,Ed Ronan,6,61,14,RW,1993
11790,4,26,Ed Ronan,1,30,5,RW,1994
11791,0,27,Ed Ronan,0,17,0,RW,1995
11792,4,28,Ed Ronan,1,18,5,RW,1996
11793,13,27,Ed Van Impe,4,67,17,D,1967
11794,12,28,Ed Van Impe,7,68,19,D,1968
11795,10,29,Ed Van Impe,0,65,10,D,1969
11796,11,30,Ed Van Impe,0,77,11,D,1970
11797,9,31,Ed Van Impe,4,73,13,D,1971
11798,11,32,Ed Van Impe,1,72,12,D,1972
11799,16,33,Ed Van Impe,2,77,18,D,1973
11800,17,34,Ed Van Impe,1,78,18,D,1974
11801,13,35,Ed Van Impe,0,52,13,D,1975
11802,3,36,Ed Van Impe,0,10,3,D,1976
11803,0,24,Ed Ward,1,7,1,RW,1993
11804,1,25,Ed Ward,1,2,2,RW,1994
11805,5,26,Ed Ward,3,41,8,RW,1995
11806,8,27,Ed Ward,5,40,13,LW,1996
11807,5,28,Ed Ward,4,64,9,LW,1997
11808,5,29,Ed Ward,3,68,8,RW,1998
11809,1,30,Ed Ward,6,52,7,RW,1999
11810,1,31,Ed Ward,0,4,1,RW,2000
11811,22,27,Ed Westfall,14,73,36,RW,1967
11812,24,28,Ed Westfall,18,70,42,RW,1968
11813,22,29,Ed Westfall,14,72,36,RW,1969
11814,34,30,Ed Westfall,25,78,59,RW,1970
11815,26,31,Ed Westfall,18,77,44,RW,1971
11816,31,32,Ed Westfall,15,67,46,RW,1972
11817,23,33,Ed Westfall,19,68,42,RW,1973
11818,33,34,Ed Westfall,22,73,55,RW,1974
11819,31,35,Ed Westfall,25,80,56,RW,1975
11820,33,36,Ed Westfall,14,79,47,RW,1976
11821,19,37,Ed Westfall,5,71,24,RW,1977
11822,11,38,Ed Westfall,5,55,16,RW,1978
11823,4,20,Eddie Johnstone,4,23,8,RW,1974
11824,4,20,Eddie Johnstone,4,23,8,RW,1974
11825,1,21,Eddie Johnstone,2,10,3,RW,1975
11826,13,23,Eddie Johnstone,13,53,26,RW,1977
11827,3,24,Eddie Johnstone,5,30,8,RW,1978
11828,21,25,Eddie Johnstone,14,78,35,RW,1979
11829,38,26,Eddie Johnstone,30,80,68,RW,1980
11830,28,27,Eddie Johnstone,30,68,58,RW,1981
11831,21,28,Eddie Johnstone,15,52,36,RW,1982
11832,11,29,Eddie Johnstone,12,46,23,RW,1983
11833,0,31,Eddie Johnstone,1,3,1,RW,1985
11834,0,32,Eddie Johnstone,0,6,0,RW,1986
11835,34,27,Eddie Joyal,23,74,57,C,1967
11836,19,28,Eddie Joyal,33,73,52,C,1968
11837,22,29,Eddie Joyal,18,59,40,C,1969
11838,21,30,Eddie Joyal,20,69,41,C,1970
11839,7,31,Eddie Joyal,14,70,21,C,1971
11840,16,32,Eddie Joyal,22,71,38,C,1972
11841,10,33,Eddie Joyal,8,45,18,C,1973
11842,25,34,Eddie Joyal,22,78,47,C,1974
11843,25,34,Eddie Joyal,22,78,47,C,1974
11844,4,35,Eddie Joyal,5,45,9,C,1975
11845,4,35,Eddie Joyal,5,45,9,C,1975
11846,19,30,Eddie Shack,23,70,42,LW,1967
11847,11,31,Eddie Shack,11,50,22,RW,1968
11848,12,32,Eddie Shack,22,73,34,LW,1969
11849,19,33,Eddie Shack,27,67,46,LW,1970
11850,23,34,Eddie Shack,16,68,39,LW,1971
11851,20,35,Eddie Shack,25,74,45,LW,1972
11852,8,36,Eddie Shack,7,59,15,RW,1973
11853,1,37,Eddie Shack,2,26,3,LW,1974
11854,1,22,Eddy Beers,1,5,2,LW,1981
11855,15,23,Eddy Beers,11,41,26,LW,1982
11856,39,24,Eddy Beers,36,73,75,LW,1983
11857,40,25,Eddy Beers,28,74,68,LW,1984
11858,21,26,Eddy Beers,18,57,39,LW,1985
11859,3,20,Eddy Godin,3,18,6,RW,1977
11860,3,21,Eddy Godin,0,9,3,RW,1978
11861,0,23,Edward Lee,0,2,0,RW,1984
11862,0,18,Eeli Tolvanen,0,3,0,RW,2017
11863,12,19,Elias Lindholm,9,58,21,C,2013
11864,22,20,Elias Lindholm,17,81,39,C,2014
11865,28,21,Elias Lindholm,11,82,39,C,2015
11866,34,22,Elias Lindholm,11,72,45,C,2016
11867,28,23,Elias Lindholm,16,81,44,C,2017
11868,1,20,Emanuel Viveiros,0,4,1,D,1985
11869,1,21,Emanuel Viveiros,0,1,1,D,1986
11870,9,22,Emanuel Viveiros,1,24,10,D,1987
11871,7,20,Emerson Etem,3,38,10,RW,2012
11872,4,21,Emerson Etem,7,29,11,LW,2013
11873,5,22,Emerson Etem,5,45,10,LW,2014
11874,8,23,Emerson Etem,7,58,15,RW,2015
11875,0,24,Emerson Etem,0,3,0,LW,2016
11876,1,20,Emile Poirier,0,6,1,LW,2014
11877,0,21,Emile Poirier,0,2,0,LW,2015
11878,0,21,Enrico Ciccone,0,11,0,D,1991
11879,1,22,Enrico Ciccone,0,31,1,D,1992
11880,2,23,Enrico Ciccone,1,57,3,D,1993
11881,4,24,Enrico Ciccone,2,41,6,D,1994
11882,4,25,Enrico Ciccone,2,66,6,D,1995
11883,2,26,Enrico Ciccone,2,67,4,D,1996
11884,4,27,Enrico Ciccone,0,39,4,D,1997
11885,1,28,Enrico Ciccone,3,59,4,D,1998
11886,0,30,Enrico Ciccone,0,3,0,D,2000
11887,1,20,Enver Lisin,1,17,2,RW,2006
11888,1,21,Enver Lisin,4,13,5,RW,2007
11889,8,22,Enver Lisin,13,48,21,RW,2008
11890,8,23,Enver Lisin,6,57,14,RW,2009
11891,0,25,Eriah Hayes,1,15,1,RW,2013
11892,0,26,Eriah Hayes,0,4,0,RW,2014
11893,3,21,Eric Beaudoin,1,8,4,LW,2001
11894,1,22,Eric Beaudoin,0,15,1,LW,2002
11895,4,23,Eric Beaudoin,2,30,6,LW,2003
11896,12,23,Eric Belanger,9,62,21,C,2000
11897,16,24,Eric Belanger,8,53,24,C,2001
11898,19,25,Eric Belanger,16,62,35,C,2002
11899,20,26,Eric Belanger,13,81,33,C,2003
11900,20,28,Eric Belanger,17,65,37,C,2005
11901,18,29,Eric Belanger,17,80,35,C,2006
11902,24,30,Eric Belanger,13,75,37,C,2007
11903,23,31,Eric Belanger,13,79,36,C,2008
11904,26,32,Eric Belanger,15,77,41,C,2009
11905,27,33,Eric Belanger,13,82,40,C,2010
11906,12,34,Eric Belanger,4,78,16,C,2011
11907,3,35,Eric Belanger,0,26,3,C,2012
11908,0,24,Eric Bertrand,0,12,0,LW,1999
11909,0,25,Eric Bertrand,0,3,0,LW,2000
11910,0,24,Eric Boguniecki,0,4,0,C,1999
11911,0,25,Eric Boguniecki,0,1,0,C,2000
11912,1,26,Eric Boguniecki,0,8,1,C,2001
11913,27,27,Eric Boguniecki,22,80,49,RW,2002
11914,4,28,Eric Boguniecki,6,27,10,RW,2003
11915,10,30,Eric Boguniecki,6,47,16,RW,2005
11916,0,31,Eric Boguniecki,0,11,0,C,2006
11917,2,24,Eric Boulton,1,35,3,LW,2000
11918,3,25,Eric Boulton,2,35,5,LW,2001
11919,5,26,Eric Boulton,1,58,6,LW,2002
11920,2,27,Eric Boulton,1,44,3,LW,2003
11921,5,29,Eric Boulton,4,51,9,LW,2005
11922,4,30,Eric Boulton,3,45,7,LW,2006
11923,5,31,Eric Boulton,4,74,9,LW,2007
11924,10,32,Eric Boulton,3,76,13,LW,2008
11925,6,33,Eric Boulton,2,62,8,LW,2009
11926,4,34,Eric Boulton,6,69,10,LW,2010
11927,0,35,Eric Boulton,0,51,0,LW,2011
11928,0,36,Eric Boulton,0,15,0,LW,2012
11929,2,37,Eric Boulton,2,23,4,LW,2013
11930,0,38,Eric Boulton,2,10,2,LW,2014
11931,0,39,Eric Boulton,0,6,0,LW,2015
11932,6,19,Eric Brewer,5,63,11,D,1998
11933,2,20,Eric Brewer,0,26,2,D,1999
11934,14,21,Eric Brewer,7,77,21,D,2000
11935,18,22,Eric Brewer,7,81,25,D,2001
11936,21,23,Eric Brewer,8,80,29,D,2002
11937,18,24,Eric Brewer,7,77,25,D,2003
11938,3,26,Eric Brewer,6,32,9,D,2005
11939,23,27,Eric Brewer,6,82,29,D,2006
11940,21,28,Eric Brewer,1,77,22,D,2007
11941,5,29,Eric Brewer,1,28,6,D,2008
11942,7,30,Eric Brewer,8,59,15,D,2009
11943,7,31,Eric Brewer,9,76,16,D,2010
11944,20,32,Eric Brewer,1,82,21,D,2011
11945,8,33,Eric Brewer,4,48,12,D,2012
11946,13,34,Eric Brewer,4,77,17,D,2013
11947,8,35,Eric Brewer,3,44,11,D,2014
11948,1,22,Eric Cairns,0,40,1,D,1996
11949,3,23,Eric Cairns,0,39,3,D,1997
11950,3,24,Eric Cairns,0,9,3,D,1998
11951,7,25,Eric Cairns,2,67,9,D,1999
11952,2,26,Eric Cairns,2,45,4,D,2000
11953,5,27,Eric Cairns,2,74,7,D,2001
11954,4,28,Eric Cairns,1,60,5,D,2002
11955,6,29,Eric Cairns,2,72,8,D,2003
11956,1,31,Eric Cairns,1,50,2,D,2005
11957,0,32,Eric Cairns,0,1,0,D,2006
11958,0,18,Eric Calder,0,1,0,D,1981
11959,0,19,Eric Calder,0,1,0,D,1982
11960,0,23,Eric Charron,0,3,0,D,1992
11961,0,24,Eric Charron,0,4,0,D,1993
11962,4,25,Eric Charron,1,45,5,D,1994
11963,1,26,Eric Charron,0,18,1,D,1995
11964,1,27,Eric Charron,1,25,2,D,1996
11965,0,28,Eric Charron,0,2,0,D,1997
11966,1,29,Eric Charron,0,12,1,D,1998
11967,0,30,Eric Charron,0,21,0,D,1999
11968,3,20,Eric Chouinard,1,13,4,C,2000
11969,4,22,Eric Chouinard,4,28,8,C,2002
11970,4,23,Eric Chouinard,6,48,10,RW,2003
11971,0,25,Eric Chouinard,0,1,0,C,2005
11972,1,19,Eric Daze,1,4,2,LW,1994
11973,23,20,Eric Daze,30,80,53,LW,1995
11974,19,21,Eric Daze,22,71,41,RW,1996
11975,11,22,Eric Daze,31,80,42,RW,1997
11976,20,23,Eric Daze,22,72,42,LW,1998
11977,13,24,Eric Daze,23,59,36,RW,1999
11978,24,25,Eric Daze,33,79,57,LW,2000
11979,32,26,Eric Daze,38,82,70,LW,2001
11980,22,27,Eric Daze,22,54,44,LW,2002
11981,7,28,Eric Daze,4,19,11,RW,2003
11982,0,30,Eric Daze,0,1,0,LW,2005
11983,12,19,Eric Desjardins,2,36,14,D,1988
11984,13,20,Eric Desjardins,3,55,16,D,1989
11985,18,21,Eric Desjardins,7,62,25,D,1990
11986,32,22,Eric Desjardins,6,77,38,D,1991
11987,32,23,Eric Desjardins,13,82,45,D,1992
11988,23,24,Eric Desjardins,12,84,35,D,1993
11989,24,25,Eric Desjardins,5,43,29,D,1994
11990,40,26,Eric Desjardins,7,80,47,D,1995
11991,34,27,Eric Desjardins,12,82,46,D,1996
11992,27,28,Eric Desjardins,6,77,33,D,1997
11993,36,29,Eric Desjardins,15,68,51,D,1998
11994,41,30,Eric Desjardins,14,81,55,D,1999
11995,33,31,Eric Desjardins,15,79,48,D,2000
11996,19,32,Eric Desjardins,6,65,25,D,2001
11997,24,33,Eric Desjardins,8,79,32,D,2002
11998,11,34,Eric Desjardins,1,48,12,D,2003
11999,20,36,Eric Desjardins,4,45,24,D,2005
12000,0,20,Eric Fehr,0,11,0,RW,2005
12001,1,21,Eric Fehr,2,14,3,RW,2006
12002,5,22,Eric Fehr,1,23,6,RW,2007
12003,13,23,Eric Fehr,12,61,25,RW,2008
12004,18,24,Eric Fehr,21,69,39,RW,2009
12005,10,25,Eric Fehr,10,52,20,RW,2010
12006,1,26,Eric Fehr,2,35,3,RW,2011
12007,8,27,Eric Fehr,9,41,17,RW,2012
12008,18,28,Eric Fehr,13,73,31,RW,2013
12009,14,29,Eric Fehr,19,75,33,RW,2014
12010,6,30,Eric Fehr,8,55,14,C,2015
12011,0,31,Eric Fehr,0,1,0,C,2016
12012,0,32,Eric Fehr,0,4,0,C,2017
12013,0,21,Eric Gelinas,0,1,0,D,2012
12014,22,22,Eric Gelinas,7,60,29,D,2013
12015,13,23,Eric Gelinas,6,61,19,D,2014
12016,5,24,Eric Gelinas,1,40,6,D,2015
12017,1,25,Eric Gelinas,0,27,1,D,2016
12018,1,21,Eric Germain,0,4,1,D,1987
12019,0,22,Eric Godard,0,19,0,RW,2002
12020,1,23,Eric Godard,0,31,1,RW,2003
12021,2,25,Eric Godard,2,57,4,RW,2005
12022,1,26,Eric Godard,0,19,1,RW,2006
12023,1,27,Eric Godard,1,74,2,RW,2007
12024,2,28,Eric Godard,2,71,4,RW,2008
12025,2,29,Eric Godard,1,45,3,RW,2009
12026,3,30,Eric Godard,0,19,3,RW,2010
12027,4,24,Eric Gryba,2,33,6,D,2012
12028,9,25,Eric Gryba,2,57,11,D,2013
12029,12,26,Eric Gryba,0,75,12,D,2014
12030,5,27,Eric Gryba,1,53,6,D,2015
12031,4,28,Eric Gryba,2,40,6,D,2016
12032,2,29,Eric Gryba,0,21,2,D,2017
12033,0,31,Eric Healey,0,2,0,LW,2005
12034,2,20,Eric Houde,0,13,2,C,1996
12035,0,21,Eric Houde,1,9,1,C,1997
12036,1,22,Eric Houde,1,8,2,C,1998
12037,0,22,Eric Lacroix,0,3,0,LW,1993
12038,7,23,Eric Lacroix,9,45,16,LW,1994
12039,16,24,Eric Lacroix,16,72,32,LW,1995
12040,18,25,Eric Lacroix,18,81,36,LW,1996
12041,15,26,Eric Lacroix,16,82,31,LW,1997
12042,2,27,Eric Lacroix,2,64,4,LW,1998
12043,8,28,Eric Lacroix,4,70,12,LW,1999
12044,4,29,Eric Lacroix,2,55,6,LW,2000
12045,0,23,Eric Landry,1,12,1,C,1997
12046,1,24,Eric Landry,0,3,1,C,1998
12047,7,26,Eric Landry,4,51,11,C,2000
12048,1,27,Eric Landry,0,2,1,C,2001
12049,0,22,Eric Lavigne,0,1,0,D,1994
12050,34,19,Eric Lindros,41,61,75,C,1992
12051,53,20,Eric Lindros,44,65,97,C,1993
12052,41,21,Eric Lindros,29,46,70,C,1994
12053,68,22,Eric Lindros,47,73,115,C,1995
12054,47,23,Eric Lindros,32,52,79,C,1996
12055,41,24,Eric Lindros,30,63,71,C,1997
12056,53,25,Eric Lindros,40,71,93,C,1998
12057,32,26,Eric Lindros,27,55,59,C,1999
12058,36,28,Eric Lindros,37,72,73,C,2001
12059,34,29,Eric Lindros,19,81,53,C,2002
12060,22,30,Eric Lindros,10,39,32,C,2003
12061,11,32,Eric Lindros,11,33,22,C,2005
12062,21,33,Eric Lindros,5,49,26,RW,2006
12063,1,25,Eric Manlow,0,8,1,C,2000
12064,0,26,Eric Manlow,0,3,0,C,2001
12065,1,27,Eric Manlow,2,8,3,C,2002
12066,2,28,Eric Manlow,0,18,2,C,2003
12067,1,25,Eric Meloche,0,23,1,RW,2001
12068,1,26,Eric Meloche,5,13,6,RW,2002
12069,7,27,Eric Meloche,3,25,10,RW,2003
12070,2,30,Eric Meloche,1,13,3,RW,2006
12071,0,23,Eric Messier,0,21,0,D,1996
12072,12,24,Eric Messier,4,62,16,D,1997
12073,2,25,Eric Messier,4,31,6,D,1998
12074,6,26,Eric Messier,3,61,9,D,1999
12075,7,27,Eric Messier,5,64,12,LW,2000
12076,10,28,Eric Messier,5,74,15,LW,2001
12077,10,29,Eric Messier,4,72,14,LW,2002
12078,3,30,Eric Messier,0,21,3,LW,2003
12079,25,34,Eric Nesterenko,11,71,36,C,1967
12080,17,35,Eric Nesterenko,15,72,32,C,1968
12081,18,36,Eric Nesterenko,16,67,34,RW,1969
12082,15,37,Eric Nesterenko,8,76,23,RW,1970
12083,8,38,Eric Nesterenko,4,38,12,RW,1971
12084,5,40,Eric Nesterenko,2,29,7,RW,1973
12085,5,40,Eric Nesterenko,2,29,7,RW,1973
12086,0,23,Eric Nickulas,0,2,0,C,1998
12087,6,24,Eric Nickulas,5,20,11,RW,1999
12088,0,25,Eric Nickulas,0,7,0,C,2000
12089,1,27,Eric Nickulas,0,8,1,RW,2002
12090,12,28,Eric Nickulas,8,65,20,LW,2003
12091,4,30,Eric Nickulas,2,16,6,RW,2005
12092,0,22,Eric Nystrom,0,2,0,LW,2005
12093,7,24,Eric Nystrom,3,44,10,LW,2007
12094,5,25,Eric Nystrom,5,76,10,LW,2008
12095,8,26,Eric Nystrom,11,82,19,LW,2009
12096,8,27,Eric Nystrom,4,82,12,LW,2010
12097,5,28,Eric Nystrom,16,74,21,LW,2011
12098,4,29,Eric Nystrom,7,48,11,LW,2012
12099,6,30,Eric Nystrom,15,79,21,LW,2013
12100,5,31,Eric Nystrom,7,60,12,LW,2014
12101,0,32,Eric Nystrom,7,46,7,LW,2015
12102,4,23,Eric O'Dell,3,30,7,C,2013
12103,1,24,Eric O'Dell,0,11,1,C,2014
12104,0,28,Eric Perrin,0,4,0,C,2003
12105,23,31,Eric Perrin,13,82,36,C,2006
12106,33,32,Eric Perrin,12,81,45,C,2007
12107,16,33,Eric Perrin,7,78,23,C,2008
12108,0,22,Eric Robinson,0,1,0,LW,2017
12109,1,25,Eric Selleck,0,2,1,LW,2012
12110,0,28,Eric Selleck,0,1,0,RW,2015
12111,20,19,Eric Staal,11,81,31,C,2003
12112,55,21,Eric Staal,45,82,100,C,2005
12113,40,22,Eric Staal,30,82,70,C,2006
12114,44,23,Eric Staal,38,82,82,C,2007
12115,35,24,Eric Staal,40,82,75,C,2008
12116,41,25,Eric Staal,29,70,70,C,2009
12117,43,26,Eric Staal,33,81,76,C,2010
12118,46,27,Eric Staal,24,82,70,C,2011
12119,35,28,Eric Staal,18,48,53,C,2012
12120,40,29,Eric Staal,21,79,61,C,2013
12121,31,30,Eric Staal,23,77,54,C,2014
12122,26,31,Eric Staal,13,83,39,C,2015
12123,37,32,Eric Staal,28,82,65,C,2016
12124,34,33,Eric Staal,42,82,76,C,2017
12125,0,20,Eric Tangradi,0,1,0,LW,2009
12126,2,21,Eric Tangradi,1,15,3,LW,2010
12127,2,22,Eric Tangradi,0,24,2,LW,2011
12128,3,23,Eric Tangradi,1,41,4,LW,2012
12129,3,24,Eric Tangradi,3,55,6,LW,2013
12130,0,25,Eric Tangradi,0,7,0,LW,2014
12131,0,26,Eric Tangradi,0,1,0,LW,2015
12132,9,20,Eric Vail,2,23,11,LW,1973
12133,21,21,Eric Vail,39,72,60,LW,1974
12134,31,22,Eric Vail,16,60,47,LW,1975
12135,39,23,Eric Vail,32,78,71,LW,1976
12136,36,24,Eric Vail,22,79,58,LW,1977
12137,48,25,Eric Vail,35,80,83,LW,1978
12138,25,26,Eric Vail,28,77,53,LW,1979
12139,36,27,Eric Vail,28,64,64,LW,1980
12140,15,28,Eric Vail,14,58,29,LW,1981
12141,0,22,Eric Weinrich,0,2,0,D,1988
12142,7,23,Eric Weinrich,2,19,9,D,1989
12143,34,24,Eric Weinrich,4,76,38,D,1990
12144,25,25,Eric Weinrich,7,76,32,D,1991
12145,29,26,Eric Weinrich,7,79,36,D,1992
12146,24,27,Eric Weinrich,4,62,28,D,1993
12147,10,28,Eric Weinrich,3,48,13,D,1994
12148,10,29,Eric Weinrich,5,77,15,D,1995
12149,25,30,Eric Weinrich,7,81,32,D,1996
12150,21,31,Eric Weinrich,2,82,23,D,1997
12151,15,32,Eric Weinrich,7,80,22,D,1998
12152,25,33,Eric Weinrich,4,77,29,D,1999
12153,24,34,Eric Weinrich,7,82,31,D,2000
12154,20,35,Eric Weinrich,4,80,24,D,2001
12155,18,36,Eric Weinrich,2,81,20,D,2002
12156,15,37,Eric Weinrich,4,80,19,D,2003
12157,16,39,Eric Weinrich,1,75,17,D,2005
12158,1,20,Eric Wellwood,0,3,1,LW,2010
12159,4,21,Eric Wellwood,5,24,9,LW,2011
12160,0,22,Eric Wellwood,0,4,0,LW,2012
12161,0,23,Erich Goldmann,0,1,0,D,1999
12162,1,26,Erik Andersson,2,12,3,C,1997
12163,0,28,Erik Burgdoerfer,0,2,0,D,2016
12164,1,29,Erik Burgdoerfer,0,2,1,D,2017
12165,7,22,Erik Christensen,6,33,13,C,2005
12166,15,23,Erik Christensen,18,61,33,C,2006
12167,13,24,Erik Christensen,11,59,24,C,2007
12168,21,25,Erik Christensen,7,64,28,C,2008
12169,18,26,Erik Christensen,8,58,26,C,2009
12170,16,27,Erik Christensen,11,63,27,C,2010
12171,5,28,Erik Christensen,7,49,12,C,2011
12172,24,23,Erik Cole,16,81,40,RW,2001
12173,13,24,Erik Cole,14,53,27,RW,2002
12174,24,25,Erik Cole,18,80,42,RW,2003
12175,29,27,Erik Cole,30,60,59,RW,2005
12176,32,28,Erik Cole,29,71,61,LW,2006
12177,29,29,Erik Cole,22,73,51,RW,2007
12178,24,30,Erik Cole,18,80,42,LW,2008
12179,5,31,Erik Cole,11,40,16,LW,2009
12180,26,32,Erik Cole,26,82,52,LW,2010
12181,26,33,Erik Cole,35,82,61,LW,2011
12182,4,34,Erik Cole,9,47,13,LW,2012
12183,13,35,Erik Cole,16,75,29,LW,2013
12184,18,36,Erik Cole,21,68,39,LW,2014
12185,5,24,Erik Condra,6,26,11,RW,2010
12186,17,25,Erik Condra,8,81,25,RW,2011
12187,8,26,Erik Condra,4,48,12,RW,2012
12188,10,27,Erik Condra,6,76,16,RW,2013
12189,14,28,Erik Condra,9,68,23,RW,2014
12190,5,29,Erik Condra,6,54,11,RW,2015
12191,0,30,Erik Condra,0,13,0,RW,2016
12192,6,20,Erik Gudbranson,2,72,8,D,2011
12193,4,21,Erik Gudbranson,0,32,4,D,2012
12194,6,22,Erik Gudbranson,3,65,9,D,2013
12195,9,23,Erik Gudbranson,4,76,13,D,2014
12196,7,24,Erik Gudbranson,2,64,9,D,2015
12197,5,25,Erik Gudbranson,1,30,6,D,2016
12198,3,26,Erik Gudbranson,2,52,5,D,2017
12199,0,22,Erik Gustafsson,0,3,0,D,2010
12200,4,23,Erik Gustafsson,1,30,5,D,2011
12201,5,24,Erik Gustafsson,3,27,8,D,2012
12202,8,25,Erik Gustafsson,2,31,10,D,2013
12203,14,23,Erik Gustafsson,0,41,14,D,2015
12204,11,25,Erik Gustafsson,5,35,16,D,2017
12205,9,22,Erik Haula,6,46,15,C,2013
12206,7,23,Erik Haula,7,72,14,C,2014
12207,20,24,Erik Haula,14,76,34,C,2015
12208,11,25,Erik Haula,15,72,26,C,2016
12209,26,26,Erik Haula,29,76,55,LW,2017
12210,28,19,Erik Johnson,5,69,33,D,2007
12211,29,21,Erik Johnson,10,79,39,D,2009
12212,21,22,Erik Johnson,8,77,29,D,2010
12213,22,23,Erik Johnson,4,73,26,D,2011
12214,4,24,Erik Johnson,0,31,4,D,2012
12215,30,25,Erik Johnson,9,80,39,D,2013
12216,11,26,Erik Johnson,12,47,23,D,2014
12217,16,27,Erik Johnson,11,73,27,D,2015
12218,15,28,Erik Johnson,2,46,17,D,2016
12219,16,29,Erik Johnson,9,62,25,D,2017
12220,21,19,Erik Karlsson,5,60,26,D,2009
12221,32,20,Erik Karlsson,13,75,45,D,2010
12222,59,21,Erik Karlsson,19,81,78,D,2011
12223,8,22,Erik Karlsson,6,17,14,D,2012
12224,54,23,Erik Karlsson,20,82,74,D,2013
12225,45,24,Erik Karlsson,21,82,66,D,2014
12226,66,25,Erik Karlsson,16,82,82,D,2015
12227,54,26,Erik Karlsson,17,77,71,D,2016
12228,53,27,Erik Karlsson,9,71,62,D,2017
12229,3,20,Erik Rasmussen,2,21,5,C,1997
12230,7,21,Erik Rasmussen,3,42,10,C,1998
12231,6,22,Erik Rasmussen,8,67,14,C,1999
12232,19,23,Erik Rasmussen,12,82,31,LW,2000
12233,11,24,Erik Rasmussen,8,69,19,LW,2001
12234,12,25,Erik Rasmussen,4,57,16,C,2002
12235,6,26,Erik Rasmussen,7,69,13,LW,2003
12236,5,28,Erik Rasmussen,5,67,10,C,2005
12237,7,29,Erik Rasmussen,3,71,10,C,2006
12238,0,23,Erik Reitz,0,5,0,D,2005
12239,0,24,Erik Reitz,0,1,0,D,2006
12240,1,26,Erik Reitz,1,42,2,D,2008
12241,1,24,Erik Westrum,1,15,2,C,2003
12242,1,26,Erik Westrum,0,10,1,C,2005
12243,0,27,Erik Westrum,0,2,0,C,2006
12244,1,20,Ernie Godden,1,5,2,C,1981
12245,25,23,Ernie Hicke,22,78,47,LW,1970
12246,12,24,Ernie Hicke,11,68,23,RW,1971
12247,23,25,Ernie Hicke,14,59,37,LW,1972
12248,7,26,Ernie Hicke,6,55,13,LW,1973
12249,19,27,Ernie Hicke,17,62,36,LW,1974
12250,19,28,Ernie Hicke,23,80,42,LW,1975
12251,20,29,Ernie Hicke,30,77,50,LW,1976
12252,15,30,Ernie Hicke,9,41,24,LW,1977
12253,2,20,Errol Rausse,6,24,8,LW,1979
12254,1,21,Errol Rausse,1,5,2,LW,1980
12255,0,22,Errol Rausse,0,2,0,LW,1981
12256,0,20,Errol Thompson,0,1,0,LW,1970
12257,19,22,Errol Thompson,13,68,32,LW,1972
12258,8,23,Errol Thompson,7,56,15,LW,1973
12259,17,24,Errol Thompson,25,65,42,LW,1974
12260,37,25,Errol Thompson,43,75,80,LW,1975
12261,16,26,Errol Thompson,21,41,37,LW,1976
12262,23,27,Errol Thompson,22,73,45,LW,1977
12263,31,28,Errol Thompson,23,70,54,LW,1978
12264,14,29,Errol Thompson,34,77,48,LW,1979
12265,20,30,Errol Thompson,20,73,40,LW,1980
12266,0,21,Esa Lindell,0,4,0,D,2015
12267,12,22,Esa Lindell,6,73,18,D,2016
12268,20,23,Esa Lindell,7,80,27,D,2017
12269,8,26,Esa Pirnes,3,57,11,C,2003
12270,6,21,Esa Tikkanen,7,35,13,LW,1985
12271,44,22,Esa Tikkanen,34,76,78,LW,1986
12272,51,23,Esa Tikkanen,23,80,74,LW,1987
12273,47,24,Esa Tikkanen,31,67,78,LW,1988
12274,33,25,Esa Tikkanen,30,79,63,C,1989
12275,42,26,Esa Tikkanen,27,79,69,LW,1990
12276,16,27,Esa Tikkanen,12,40,28,LW,1991
12277,24,28,Esa Tikkanen,16,81,40,LW,1992
12278,32,29,Esa Tikkanen,22,83,54,LW,1993
12279,23,30,Esa Tikkanen,12,43,35,LW,1994
12280,30,31,Esa Tikkanen,14,58,44,LW,1995
12281,17,32,Esa Tikkanen,13,76,30,C,1996
12282,18,33,Esa Tikkanen,3,48,21,LW,1997
12283,3,34,Esa Tikkanen,0,32,3,LW,1998
12284,0,26,Espen Knutsen,3,19,3,C,1997
12285,42,29,Espen Knutsen,11,66,53,C,2000
12286,31,30,Espen Knutsen,11,77,42,RW,2001
12287,4,31,Espen Knutsen,5,31,9,C,2002
12288,4,32,Espen Knutsen,0,14,4,C,2003
12289,3,20,Ethan Bear,1,18,4,D,2017
12290,1,20,Ethan Moreau,0,8,1,LW,1995
12291,16,21,Ethan Moreau,15,82,31,LW,1996
12292,9,22,Ethan Moreau,9,54,18,LW,1997
12293,11,23,Ethan Moreau,10,80,21,LW,1998
12294,10,24,Ethan Moreau,17,73,27,LW,1999
12295,10,25,Ethan Moreau,9,68,19,LW,2000
12296,5,26,Ethan Moreau,11,80,16,LW,2001
12297,17,27,Ethan Moreau,14,78,31,LW,2002
12298,12,28,Ethan Moreau,20,81,32,LW,2003
12299,16,30,Ethan Moreau,11,74,27,LW,2005
12300,0,31,Ethan Moreau,1,7,1,LW,2006
12301,4,32,Ethan Moreau,5,25,9,LW,2007
12302,12,33,Ethan Moreau,14,77,26,LW,2008
12303,9,34,Ethan Moreau,9,76,18,LW,2009
12304,5,35,Ethan Moreau,1,37,6,LW,2010
12305,3,36,Ethan Moreau,1,28,4,LW,2011
12306,0,24,Evan Brophey,0,1,0,C,2010
12307,0,25,Evan Brophey,0,3,0,C,2011
12308,0,22,Evan McEneny,0,1,0,D,2016
12309,0,21,Evan Oberg,0,2,0,D,2009
12310,0,22,Evan Oberg,0,2,0,D,2010
12311,0,23,Evan Oberg,0,3,0,D,2011
12312,1,22,Evan Rodrigues,1,2,2,C,2015
12313,2,23,Evan Rodrigues,4,30,6,LW,2016
12314,18,24,Evan Rodrigues,7,48,25,LW,2017
12315,12,18,Evander Kane,14,66,26,C,2009
12316,24,19,Evander Kane,19,73,43,C,2010
12317,27,20,Evander Kane,30,74,57,C,2011
12318,16,21,Evander Kane,17,48,33,C,2012
12319,22,22,Evander Kane,19,63,41,LW,2013
12320,12,23,Evander Kane,10,37,22,LW,2014
12321,15,24,Evander Kane,20,65,35,LW,2015
12322,15,25,Evander Kane,28,70,43,LW,2016
12323,5,26,Evander Kane,9,17,14,LW,2017
12324,3,18,Everett Sanipass,1,7,4,LW,1986
12325,12,19,Everett Sanipass,8,57,20,LW,1987
12326,9,20,Everett Sanipass,6,50,15,LW,1988
12327,5,21,Everett Sanipass,5,21,10,LW,1989
12328,5,22,Everett Sanipass,5,29,10,LW,1990
12329,0,20,Evgeni Dadonov,0,4,0,RW,2009
12330,9,21,Evgeni Dadonov,8,36,17,RW,2010
12331,1,22,Evgeni Dadonov,2,15,3,RW,2011
12332,37,28,Evgeni Dadonov,28,74,65,RW,2017
12333,52,20,Evgeni Malkin,33,78,85,LW,2006
12334,59,21,Evgeni Malkin,47,82,106,C,2007
12335,78,22,Evgeni Malkin,35,82,113,C,2008
12336,49,23,Evgeni Malkin,28,67,77,C,2009
12337,22,24,Evgeni Malkin,15,43,37,C,2010
12338,59,25,Evgeni Malkin,50,75,109,C,2011
12339,24,26,Evgeni Malkin,9,31,33,C,2012
12340,49,27,Evgeni Malkin,23,60,72,C,2013
12341,42,28,Evgeni Malkin,28,69,70,C,2014
12342,31,29,Evgeni Malkin,27,57,58,C,2015
12343,39,30,Evgeni Malkin,33,62,72,C,2016
12344,56,31,Evgeni Malkin,42,78,98,C,2017
12345,13,22,Evgeny Artyukhin,4,72,17,RW,2005
12346,10,25,Evgeny Artyukhin,6,73,16,RW,2008
12347,7,26,Evgeny Artyukhin,9,54,16,RW,2009
12348,3,24,Evgeny Davydov,4,12,7,LW,1991
12349,21,25,Evgeny Davydov,28,79,49,RW,1992
12350,13,26,Evgeny Davydov,7,61,20,RW,1993
12351,2,27,Evgeny Davydov,1,3,3,RW,1994
12352,0,20,Evgeny Grachev,0,8,0,C,2010
12353,3,21,Evgeny Grachev,1,26,4,C,2011
12354,2,21,Evgeny Korolev,1,17,3,D,1999
12355,0,22,Evgeny Korolev,0,8,0,D,2000
12356,2,23,Evgeny Korolev,0,17,2,D,2001
12357,6,21,Evgeny Kuznetsov,3,17,9,C,2013
12358,26,22,Evgeny Kuznetsov,11,80,37,C,2014
12359,57,23,Evgeny Kuznetsov,20,82,77,C,2015
12360,40,24,Evgeny Kuznetsov,19,82,59,C,2016
12361,56,25,Evgeny Kuznetsov,27,79,83,C,2017
12362,8,33,Evgeny Medvedev,4,45,12,D,2015
12363,0,20,Evgeny Svechnikov,0,2,0,RW,2016
12364,2,21,Evgeny Svechnikov,2,14,4,RW,2017
12365,12,23,Fabian Brunnstrom,17,55,29,LW,2008
12366,9,24,Fabian Brunnstrom,2,44,11,LW,2009
12367,1,26,Fabian Brunnstrom,0,5,1,LW,2011
12368,1,21,Fedor Fedorov,0,7,1,LW,2002
12369,1,22,Fedor Fedorov,0,8,1,C,2003
12370,0,24,Fedor Fedorov,0,3,0,RW,2005
12371,5,20,Fedor Tyutin,2,25,7,D,2003
12372,19,22,Fedor Tyutin,6,77,25,D,2005
12373,12,23,Fedor Tyutin,2,66,14,D,2006
12374,15,24,Fedor Tyutin,5,82,20,D,2007
12375,25,25,Fedor Tyutin,9,82,34,D,2008
12376,26,26,Fedor Tyutin,6,80,32,D,2009
12377,20,27,Fedor Tyutin,7,80,27,D,2010
12378,21,28,Fedor Tyutin,5,66,26,D,2011
12379,18,29,Fedor Tyutin,4,48,22,D,2012
12380,22,30,Fedor Tyutin,4,69,26,D,2013
12381,12,31,Fedor Tyutin,3,67,15,D,2014
12382,2,32,Fedor Tyutin,1,61,3,D,2015
12383,12,33,Fedor Tyutin,1,69,13,D,2016
12384,0,21,Fern LeBlanc,0,3,0,C,1976
12385,0,22,Fern LeBlanc,0,2,0,RW,1977
12386,6,23,Fern LeBlanc,5,29,11,RW,1978
12387,5,26,Fernando Pisani,8,35,13,RW,2002
12388,14,27,Fernando Pisani,16,76,30,RW,2003
12389,19,29,Fernando Pisani,18,80,37,C,2005
12390,14,30,Fernando Pisani,14,77,28,RW,2006
12391,9,31,Fernando Pisani,13,56,22,RW,2007
12392,8,32,Fernando Pisani,7,38,15,RW,2008
12393,4,33,Fernando Pisani,4,40,8,RW,2009
12394,9,34,Fernando Pisani,7,60,16,RW,2010
12395,3,20,Filip Chlapik,1,20,4,C,2017
12396,2,18,Filip Chytil,1,9,3,C,2017
12397,1,18,Filip Forsberg,0,5,1,C,2012
12398,4,19,Filip Forsberg,1,13,5,C,2013
12399,37,20,Filip Forsberg,26,82,63,LW,2014
12400,31,21,Filip Forsberg,33,82,64,LW,2015
12401,27,22,Filip Forsberg,31,82,58,LW,2016
12402,38,23,Filip Forsberg,26,67,64,LW,2017
12403,1,22,Filip Kuba,0,5,1,D,1998
12404,5,23,Filip Kuba,1,13,6,D,1999
12405,21,24,Filip Kuba,9,75,30,D,2000
12406,19,25,Filip Kuba,5,62,24,D,2001
12407,21,26,Filip Kuba,8,78,29,D,2002
12408,19,27,Filip Kuba,5,77,24,D,2003
12409,19,29,Filip Kuba,6,65,25,D,2005
12410,22,30,Filip Kuba,15,81,37,D,2006
12411,25,31,Filip Kuba,6,75,31,D,2007
12412,37,32,Filip Kuba,3,71,40,D,2008
12413,25,33,Filip Kuba,3,53,28,D,2009
12414,14,34,Filip Kuba,2,64,16,D,2010
12415,26,35,Filip Kuba,6,73,32,D,2011
12416,9,36,Filip Kuba,1,44,10,D,2012
12417,0,23,Filip Novak,0,11,0,D,2005
12418,0,24,Filip Novak,0,6,0,D,2006
12419,1,20,Florent Fortier,1,4,2,D,1975
12420,1,20,Florent Fortier,1,4,2,D,1975
12421,2,20,Florent Robidoux,6,39,8,LW,1980
12422,2,21,Florent Robidoux,1,4,3,LW,1981
12423,0,23,Florent Robidoux,0,9,0,LW,1983
12424,3,20,Floyd Lahache,0,11,3,D,1977
12425,3,20,Floyd Lahache,0,11,3,D,1977
12426,22,32,Floyd Smith,24,63,46,RW,1967
12427,19,33,Floyd Smith,15,64,34,RW,1968
12428,14,34,Floyd Smith,4,61,18,RW,1969
12429,11,35,Floyd Smith,6,77,17,RW,1970
12430,1,36,Floyd Smith,0,6,1,RW,1971
12431,6,22,Floyd Thomson,4,49,10,LW,1971
12432,20,23,Floyd Thomson,14,75,34,LW,1972
12433,22,24,Floyd Thomson,11,77,33,LW,1973
12434,27,25,Floyd Thomson,9,77,36,LW,1974
12435,10,26,Floyd Thomson,8,58,18,LW,1975
12436,8,27,Floyd Thomson,7,58,15,LW,1976
12437,1,28,Floyd Thomson,1,6,2,LW,1977
12438,3,30,Floyd Thomson,2,11,5,LW,1979
12439,18,32,Forbes Kennedy,10,73,28,C,1967
12440,10,33,Forbes Kennedy,8,72,18,C,1968
12441,0,24,Fran Huck,0,2,0,C,1969
12442,10,25,Fran Huck,8,34,18,C,1970
12443,20,27,Fran Huck,16,58,36,C,1972
12444,48,28,Fran Huck,26,74,74,C,1973
12445,48,28,Fran Huck,26,74,74,C,1973
12446,45,29,Fran Huck,22,78,67,C,1974
12447,45,29,Fran Huck,22,78,67,C,1974
12448,32,30,Fran Huck,17,59,49,C,1975
12449,32,30,Fran Huck,17,59,49,C,1975
12450,2,31,Fran Huck,2,12,4,C,1976
12451,0,32,Fran Huck,0,5,0,C,1977
12452,0,23,Francis Belanger,0,10,0,LW,2000
12453,13,24,Francis Bouillon,3,74,16,D,1999
12454,6,25,Francis Bouillon,0,29,6,D,2000
12455,5,26,Francis Bouillon,0,28,5,D,2001
12456,1,27,Francis Bouillon,3,24,4,D,2002
12457,16,28,Francis Bouillon,2,73,18,D,2003
12458,19,30,Francis Bouillon,3,67,22,D,2005
12459,11,31,Francis Bouillon,3,62,14,D,2006
12460,6,32,Francis Bouillon,2,74,8,D,2007
12461,4,33,Francis Bouillon,5,54,9,D,2008
12462,8,34,Francis Bouillon,3,81,11,D,2009
12463,9,35,Francis Bouillon,1,44,10,D,2010
12464,7,36,Francis Bouillon,4,66,11,D,2011
12465,8,37,Francis Bouillon,1,48,9,D,2012
12466,4,38,Francis Bouillon,2,52,6,D,2013
12467,4,23,Francis Breault,1,17,5,RW,1990
12468,0,24,Francis Breault,1,6,1,RW,1991
12469,0,25,Francis Breault,0,4,0,RW,1992
12470,0,22,Francis Lessard,0,5,0,D,2001
12471,2,23,Francis Lessard,0,18,2,RW,2002
12472,1,24,Francis Lessard,1,62,2,RW,2003
12473,0,26,Francis Lessard,0,6,0,D,2005
12474,0,31,Francis Lessard,0,24,0,D,2010
12475,0,25,Francis Wathier,0,5,0,LW,2009
12476,0,26,Francis Wathier,0,3,0,LW,2010
12477,0,27,Francis Wathier,0,1,0,LW,2011
12478,0,28,Francis Wathier,0,1,0,LW,2012
12479,0,22,Francois Beauchemin,0,1,0,D,2002
12480,28,25,Francois Beauchemin,8,72,36,D,2005
12481,21,26,Francois Beauchemin,7,71,28,D,2006
12482,19,27,Francois Beauchemin,2,82,21,D,2007
12483,1,28,Francois Beauchemin,4,20,5,D,2008
12484,21,29,Francois Beauchemin,5,82,26,D,2009
12485,12,30,Francois Beauchemin,5,81,17,D,2010
12486,14,31,Francois Beauchemin,8,82,22,D,2011
12487,18,32,Francois Beauchemin,6,48,24,D,2012
12488,13,33,Francois Beauchemin,4,70,17,D,2013
12489,12,34,Francois Beauchemin,11,64,23,D,2014
12490,26,35,Francois Beauchemin,8,82,34,D,2015
12491,13,36,Francois Beauchemin,5,81,18,D,2016
12492,14,37,Francois Beauchemin,3,67,17,D,2017
12493,1,23,Francois Groleau,0,2,1,D,1995
12494,0,24,Francois Groleau,0,5,0,D,1996
12495,0,25,Francois Groleau,0,1,0,D,1997
12496,0,21,Francois Guay,0,1,0,C,1989
12497,16,20,Francois Lacombe,2,72,18,D,1968
12498,0,21,Francois Lacombe,0,2,0,D,1969
12499,1,22,Francois Lacombe,0,1,1,D,1970
12500,18,24,Francois Lacombe,10,62,28,D,1972
12501,26,25,Francois Lacombe,9,71,35,D,1973
12502,26,25,Francois Lacombe,9,71,35,D,1973
12503,17,26,Francois Lacombe,7,55,24,D,1974
12504,17,26,Francois Lacombe,7,55,24,D,1974
12505,28,27,Francois Lacombe,3,71,31,D,1975
12506,28,27,Francois Lacombe,3,71,31,D,1975
12507,22,28,Francois Lacombe,5,81,27,D,1976
12508,22,28,Francois Lacombe,5,81,27,D,1976
12509,7,29,Francois Lacombe,1,22,8,D,1977
12510,7,29,Francois Lacombe,1,22,8,D,1977
12511,21,30,Francois Lacombe,3,78,24,D,1978
12512,21,30,Francois Lacombe,3,78,24,D,1978
12513,0,31,Francois Lacombe,0,3,0,D,1979
12514,0,18,Francois Leroux,0,2,0,D,1988
12515,1,19,Francois Leroux,0,3,1,D,1989
12516,2,20,Francois Leroux,0,1,2,D,1990
12517,0,21,Francois Leroux,0,4,0,D,1991
12518,0,22,Francois Leroux,0,1,0,D,1992
12519,1,23,Francois Leroux,0,23,1,D,1993
12520,2,24,Francois Leroux,0,40,2,D,1994
12521,9,25,Francois Leroux,2,66,11,D,1995
12522,3,26,Francois Leroux,0,59,3,D,1996
12523,2,27,Francois Leroux,1,50,3,LW,1997
12524,2,24,Francois Ouimet,0,9,2,D,1975
12525,2,24,Francois Ouimet,0,9,2,D,1975
12526,8,25,Francois Ouimet,1,16,9,D,1976
12527,0,21,Frank Banham,0,3,0,RW,1996
12528,2,22,Frank Banham,9,21,11,RW,1997
12529,0,24,Frank Banham,0,3,0,RW,1999
12530,0,27,Frank Banham,0,5,0,RW,2002
12531,3,20,Frank Bathe,0,19,3,D,1974
12532,1,21,Frank Bathe,0,7,1,D,1975
12533,0,23,Frank Bathe,0,1,0,D,1977
12534,3,24,Frank Bathe,1,21,4,D,1978
12535,7,25,Frank Bathe,0,47,7,D,1979
12536,3,26,Frank Bathe,0,44,3,D,1980
12537,3,27,Frank Bathe,1,28,4,D,1981
12538,8,28,Frank Bathe,1,57,9,D,1982
12539,3,22,Frank Beaton,2,29,5,LW,1975
12540,3,22,Frank Beaton,2,29,5,LW,1975
12541,9,23,Frank Beaton,4,68,13,LW,1976
12542,9,24,Frank Beaton,6,56,15,LW,1977
12543,0,25,Frank Beaton,0,2,0,LW,1978
12544,1,26,Frank Beaton,1,23,2,LW,1979
12545,0,24,Frank Bialowas,0,3,0,D,1993
12546,0,19,Frank Corrado,0,3,0,D,2012
12547,0,20,Frank Corrado,1,15,1,D,2013
12548,0,21,Frank Corrado,1,10,1,D,2014
12549,5,22,Frank Corrado,1,39,6,D,2015
12550,0,23,Frank Corrado,0,2,0,D,2016
12551,0,24,Frank Corrado,0,5,0,D,2017
12552,12,27,Frank Golembrosky,8,60,20,RW,1972
12553,12,27,Frank Golembrosky,8,52,20,RW,1972
12554,0,27,Frank Golembrosky,0,8,0,RW,1972
12555,12,27,Frank Golembrosky,8,60,20,RW,1972
12556,12,27,Frank Golembrosky,8,52,20,RW,1972
12557,0,27,Frank Golembrosky,0,8,0,RW,1972
12558,0,22,Frank Hughes,0,5,0,LW,1971
12559,19,23,Frank Hughes,22,77,41,RW,1972
12560,19,23,Frank Hughes,22,77,41,RW,1972
12561,42,24,Frank Hughes,42,73,84,RW,1973
12562,35,25,Frank Hughes,48,76,83,RW,1974
12563,45,26,Frank Hughes,31,80,76,RW,1975
12564,45,26,Frank Hughes,31,80,76,RW,1975
12565,37,27,Frank Hughes,27,75,64,RW,1976
12566,29,27,Frank Hughes,24,48,53,RW,1976
12567,8,27,Frank Hughes,3,27,11,RW,1976
12568,37,27,Frank Hughes,27,75,64,RW,1976
12569,29,27,Frank Hughes,24,48,53,RW,1976
12570,8,27,Frank Hughes,3,27,11,RW,1976
12571,2,28,Frank Hughes,3,11,5,RW,1977
12572,2,28,Frank Hughes,3,11,5,RW,1977
12573,26,30,Frank Mahovlich,26,63,52,LW,1967
12574,29,31,Frank Mahovlich,49,76,78,LW,1968
12575,32,32,Frank Mahovlich,38,74,70,LW,1969
12576,42,33,Frank Mahovlich,31,73,73,LW,1970
12577,53,34,Frank Mahovlich,43,76,96,LW,1971
12578,55,35,Frank Mahovlich,38,78,93,LW,1972
12579,49,36,Frank Mahovlich,31,71,80,LW,1973
12580,44,37,Frank Mahovlich*,38,73,82,C,1974
12581,44,37,Frank Mahovlich*,38,73,82,C,1974
12582,55,38,Frank Mahovlich*,34,75,89,LW,1975
12583,55,38,Frank Mahovlich*,34,75,89,LW,1975
12584,20,39,Frank Mahovlich*,3,17,23,LW,1976
12585,24,40,Frank Mahovlich*,14,72,38,LW,1977
12586,15,22,Frank Nigro,6,51,21,RW,1982
12587,3,23,Frank Nigro,2,17,5,RW,1983
12588,11,20,Frank Rochon,12,69,23,LW,1973
12589,11,20,Frank Rochon,12,69,23,LW,1973
12590,29,21,Frank Rochon,27,69,56,LW,1974
12591,29,21,Frank Rochon,27,69,56,LW,1974
12592,12,22,Frank Rochon,17,60,29,LW,1975
12593,12,22,Frank Rochon,17,60,29,LW,1975
12594,8,23,Frank Rochon,15,57,23,LW,1976
12595,8,23,Frank Rochon,15,57,23,LW,1976
12596,8,23,Frank Sanders,8,76,16,D,1972
12597,8,23,Frank Sanders,8,76,16,D,1972
12598,5,22,Frank Simonetti,1,43,6,D,1984
12599,0,23,Frank Simonetti,1,17,1,D,1985
12600,0,24,Frank Simonetti,1,25,1,D,1986
12601,3,25,Frank Simonetti,2,30,5,D,1987
12602,0,20,Frank Spring,0,1,0,RW,1969
12603,0,24,Frank Spring,0,2,0,RW,1973
12604,8,25,Frank Spring,3,31,11,RW,1974
12605,2,26,Frank Spring,0,1,2,RW,1975
12606,10,27,Frank Spring,11,26,21,RW,1976
12607,4,28,Frank Spring,2,13,6,RW,1977
12608,4,28,Frank Spring,2,13,6,RW,1977
12609,16,28,Frank St. Marseille,16,57,32,RW,1967
12610,26,29,Frank St. Marseille,12,72,38,RW,1968
12611,43,30,Frank St. Marseille,16,74,59,RW,1969
12612,32,31,Frank St. Marseille,19,77,51,C,1970
12613,36,32,Frank St. Marseille,16,78,52,C,1971
12614,22,33,Frank St. Marseille,14,74,36,RW,1972
12615,36,34,Frank St. Marseille,14,78,50,C,1973
12616,36,35,Frank St. Marseille,17,80,53,C,1974
12617,16,36,Frank St. Marseille,10,68,26,RW,1975
12618,22,37,Frank St. Marseille,6,49,28,RW,1976
12619,3,21,Frank Vatrano,8,39,11,C,2015
12620,8,22,Frank Vatrano,10,44,18,C,2016
12621,3,23,Frank Vatrano,5,16,8,C,2017
12622,1,22,Frans Nielsen,1,15,2,C,2006
12623,1,23,Frans Nielsen,2,16,3,C,2007
12624,24,24,Frans Nielsen,9,59,33,C,2008
12625,26,25,Frans Nielsen,12,76,38,C,2009
12626,31,26,Frans Nielsen,13,71,44,C,2010
12627,30,27,Frans Nielsen,17,82,47,C,2011
12628,23,28,Frans Nielsen,6,48,29,C,2012
12629,33,29,Frans Nielsen,25,80,58,C,2013
12630,29,30,Frans Nielsen,14,78,43,C,2014
12631,32,31,Frans Nielsen,20,81,52,C,2015
12632,24,32,Frans Nielsen,17,79,41,C,2016
12633,17,33,Frans Nielsen,16,79,33,C,2017
12634,3,24,Frantisek Cernik,4,8,7,RW,1977
12635,3,24,Frantisek Cernik,4,8,7,RW,1977
12636,4,31,Frantisek Cernik,5,49,9,LW,1984
12637,15,26,Frantisek Kaberle,1,51,16,D,1999
12638,11,27,Frantisek Kaberle,4,51,15,D,2000
12639,20,28,Frantisek Kaberle,5,61,25,D,2001
12640,19,29,Frantisek Kaberle,7,79,26,D,2002
12641,26,30,Frantisek Kaberle,3,67,29,D,2003
12642,38,32,Frantisek Kaberle,6,77,44,D,2005
12643,6,33,Frantisek Kaberle,2,27,8,D,2006
12644,22,34,Frantisek Kaberle,0,80,22,D,2007
12645,7,35,Frantisek Kaberle,1,30,8,D,2008
12646,12,22,Frantisek Kucera,2,40,14,D,1990
12647,10,23,Frantisek Kucera,3,61,13,D,1991
12648,14,24,Frantisek Kucera,5,71,19,D,1992
12649,16,25,Frantisek Kucera,5,76,21,D,1993
12650,17,26,Frantisek Kucera,3,48,20,D,1994
12651,6,27,Frantisek Kucera,3,54,9,D,1995
12652,0,28,Frantisek Kucera,0,4,0,D,1996
12653,7,32,Frantisek Kucera,2,55,9,D,2000
12654,13,33,Frantisek Kucera,1,56,14,D,2001
12655,9,22,Frantisek Musil,2,72,11,D,1986
12656,8,23,Frantisek Musil,9,80,17,D,1987
12657,19,24,Frantisek Musil,1,55,20,D,1988
12658,8,25,Frantisek Musil,2,56,10,D,1989
12659,16,26,Frantisek Musil,7,75,23,D,1990
12660,8,27,Frantisek Musil,4,78,12,D,1991
12661,10,28,Frantisek Musil,6,80,16,D,1992
12662,8,29,Frantisek Musil,1,75,9,D,1993
12663,5,30,Frantisek Musil,0,35,5,D,1994
12664,3,31,Frantisek Musil,1,65,4,D,1995
12665,5,32,Frantisek Musil,0,57,5,D,1996
12666,2,33,Frantisek Musil,1,17,3,D,1997
12667,3,34,Frantisek Musil,0,39,3,D,1998
12668,2,36,Frantisek Musil,0,13,2,D,2000
12669,1,,Frantisek Vyborny,0,8,1,LW,1977
12670,1,,Frantisek Vyborny,0,8,1,LW,1977
12671,5,22,Frazer McLaren,1,23,6,LW,2009
12672,0,23,Frazer McLaren,0,9,0,LW,2010
12673,0,24,Frazer McLaren,0,7,0,LW,2011
12674,2,25,Frazer McLaren,3,36,5,LW,2012
12675,0,26,Frazer McLaren,0,27,0,LW,2013
12676,1,22,Fred Ahern,2,3,3,RW,1974
12677,8,23,Fred Ahern,17,44,25,RW,1975
12678,4,24,Fred Ahern,4,25,8,RW,1976
12679,17,25,Fred Ahern,8,74,25,RW,1977
12680,0,19,Fred Arthur,0,3,0,D,1980
12681,7,20,Fred Arthur,1,74,8,D,1981
12682,1,21,Fred Arthur,0,3,1,D,1982
12683,13,21,Fred Barrett,0,57,13,D,1970
12684,4,23,Fred Barrett,2,46,6,D,1972
12685,7,24,Fred Barrett,0,40,7,D,1973
12686,18,25,Fred Barrett,3,62,21,D,1974
12687,9,26,Fred Barrett,2,79,11,D,1975
12688,8,27,Fred Barrett,1,60,9,D,1976
12689,15,28,Fred Barrett,0,79,15,D,1977
12690,9,29,Fred Barrett,1,45,10,D,1978
12691,14,30,Fred Barrett,8,80,22,D,1979
12692,8,31,Fred Barrett,4,62,12,D,1980
12693,15,32,Fred Barrett,1,69,16,D,1981
12694,3,33,Fred Barrett,1,51,4,D,1982
12695,0,34,Fred Barrett,2,15,2,D,1983
12696,0,20,Fred Berry,0,3,0,C,1976
12697,11,20,Fred Boimistruck,2,57,13,D,1981
12698,3,21,Fred Boimistruck,2,26,5,D,1982
12699,13,36,Fred Hucul,2,43,15,D,1967
12700,2,24,Fred Knipscheer,3,11,5,C,1993
12701,1,25,Fred Knipscheer,3,16,4,LW,1994
12702,0,26,Fred Knipscheer,0,1,0,LW,1995
12703,4,23,Fred O'Donnell,10,72,14,RW,1972
12704,7,24,Fred O'Donnell,5,43,12,RW,1973
12705,15,25,Fred O'Donnell,21,76,36,RW,1974
12706,15,25,Fred O'Donnell,21,76,36,RW,1974
12707,11,26,Fred O'Donnell,11,79,22,RW,1975
12708,11,26,Fred O'Donnell,11,79,22,RW,1975
12709,3,19,Fred Perlini,2,7,5,C,1981
12710,0,21,Fred Perlini,0,1,0,C,1983
12711,0,21,Fred Speck,0,5,0,C,1968
12712,0,22,Fred Speck,0,5,0,C,1969
12713,2,24,Fred Speck,1,18,3,C,1971
12714,29,25,Fred Speck,16,75,45,C,1972
12715,16,25,Fred Speck,13,47,29,C,1972
12716,13,25,Fred Speck,3,28,16,C,1972
12717,29,25,Fred Speck,16,75,45,C,1972
12718,16,25,Fred Speck,13,47,29,C,1972
12719,13,25,Fred Speck,3,28,16,C,1972
12720,5,26,Fred Speck,2,18,7,C,1973
12721,5,26,Fred Speck,2,18,7,C,1973
12722,8,27,Fred Speck,4,30,12,C,1974
12723,8,27,Fred Speck,4,30,12,C,1974
12724,44,23,Fred Stanfield,20,73,64,C,1967
12725,29,24,Fred Stanfield,25,71,54,C,1968
12726,35,25,Fred Stanfield,23,73,58,C,1969
12727,52,26,Fred Stanfield,24,75,76,C,1970
12728,56,27,Fred Stanfield,23,78,79,C,1971
12729,58,28,Fred Stanfield,20,78,78,C,1972
12730,28,29,Fred Stanfield,16,71,44,C,1973
12731,39,30,Fred Stanfield,20,72,59,C,1974
12732,30,31,Fred Stanfield,18,80,48,C,1975
12733,14,32,Fred Stanfield,9,79,23,C,1976
12734,8,33,Fred Stanfield,3,57,11,C,1977
12735,5,20,Fred Williams,2,44,7,C,1976
12736,0,22,Freddie Hamilton,0,11,0,C,2013
12737,0,23,Freddie Hamilton,1,18,1,C,2014
12738,1,24,Freddie Hamilton,1,4,2,C,2015
12739,0,25,Freddie Hamilton,2,26,2,C,2016
12740,1,26,Freddie Hamilton,0,8,1,C,2017
12741,0,23,Freddy Meyer,0,1,0,D,2003
12742,21,25,Freddy Meyer,6,57,27,D,2005
12743,6,26,Freddy Meyer,2,60,8,D,2006
12744,9,27,Freddy Meyer,3,57,12,D,2007
12745,5,28,Freddy Meyer,4,27,9,D,2008
12746,11,29,Freddy Meyer,4,64,15,D,2009
12747,1,30,Freddy Meyer,1,15,2,D,2010
12803,1,29,Frédéric St-Denis,0,4,1,D,2014
12748,2,26,Frederic St. Denis,1,17,3,D,2011
12749,1,23,Frederick Gaudreau,0,9,1,C,2016
12750,3,24,Frederick Gaudreau,0,20,3,C,2017
12751,1,20,Frederik Gauthier,0,7,1,C,2015
12752,1,21,Frederik Gauthier,2,21,3,C,2016
12753,0,22,Frederik Gauthier,1,9,1,C,2017
12754,0,25,Fredrik Bremberg,0,8,0,C,1998
12755,2,23,Fredrik Claesson,0,16,2,D,2015
12756,8,24,Fredrik Claesson,3,33,11,D,2016
12757,6,25,Fredrik Claesson,1,64,7,D,2017
12758,7,22,Fredrik Modin,6,76,13,RW,1996
12759,16,23,Fredrik Modin,16,74,32,RW,1997
12760,15,24,Fredrik Modin,16,67,31,LW,1998
12761,26,25,Fredrik Modin,22,80,48,LW,1999
12762,24,26,Fredrik Modin,32,76,56,LW,2000
12763,17,27,Fredrik Modin,14,54,31,LW,2001
12764,23,28,Fredrik Modin,17,76,40,LW,2002
12765,28,29,Fredrik Modin,29,82,57,LW,2003
12766,23,31,Fredrik Modin,31,77,54,LW,2005
12767,20,32,Fredrik Modin,22,79,42,LW,2006
12768,6,33,Fredrik Modin,6,23,12,LW,2007
12769,16,34,Fredrik Modin,9,50,25,LW,2008
12770,6,35,Fredrik Modin,5,44,11,LW,2009
12771,3,36,Fredrik Modin,7,40,10,LW,2010
12772,29,20,Fredrik Olausson,7,72,36,D,1986
12773,10,21,Fredrik Olausson,5,38,15,D,1987
12774,47,22,Fredrik Olausson,15,75,62,D,1988
12775,46,23,Fredrik Olausson,9,77,55,D,1989
12776,29,24,Fredrik Olausson,12,71,41,D,1990
12777,42,25,Fredrik Olausson,20,77,62,D,1991
12778,41,26,Fredrik Olausson,16,68,57,D,1992
12779,24,27,Fredrik Olausson,11,73,35,D,1993
12780,10,28,Fredrik Olausson,0,33,10,D,1994
12781,22,29,Fredrik Olausson,2,56,24,D,1995
12782,29,30,Fredrik Olausson,9,71,38,D,1996
12783,27,31,Fredrik Olausson,6,76,33,D,1997
12784,40,32,Fredrik Olausson,16,74,56,D,1998
12785,19,33,Fredrik Olausson,15,70,34,D,1999
12786,13,35,Fredrik Olausson,2,47,15,D,2001
12787,6,36,Fredrik Olausson,2,44,8,D,2002
12788,6,20,Fredrik Sjostrom,7,57,13,RW,2003
12789,17,22,Fredrik Sjostrom,6,75,23,RW,2005
12790,9,23,Fredrik Sjostrom,9,78,18,RW,2006
12791,9,24,Fredrik Sjostrom,12,69,21,RW,2007
12792,6,25,Fredrik Sjostrom,7,79,13,RW,2008
12793,8,26,Fredrik Sjostrom,3,65,11,RW,2009
12794,3,27,Fredrik Sjostrom,2,66,5,RW,2010
12795,14,29,Freeman Asmundson,2,76,16,D,1972
12796,14,29,Freeman Asmundson,2,76,16,D,1972
12797,14,30,Freeman Asmundson,5,72,19,D,1973
12798,14,30,Freeman Asmundson,5,72,19,D,1973
12799,15,31,Freeman Asmundson,4,38,19,D,1974
12800,15,31,Freeman Asmundson,4,38,19,D,1974
12801,11,32,Freeman Asmundson,5,72,16,D,1975
12802,11,32,Freeman Asmundson,5,72,16,D,1975
12804,0,23,Gabe Gauthier,0,5,0,LW,2006
12805,0,24,Gabe Gauthier,0,3,0,LW,2007
12806,12,21,Gabriel Bourque,7,43,19,LW,2011
12807,5,22,Gabriel Bourque,11,34,16,LW,2012
12808,17,23,Gabriel Bourque,9,74,26,LW,2013
12809,10,24,Gabriel Bourque,3,69,13,LW,2014
12810,3,25,Gabriel Bourque,1,22,4,RW,2015
12811,0,26,Gabriel Bourque,0,6,0,LW,2016
12812,6,27,Gabriel Bourque,5,58,11,LW,2017
12813,1,20,Gabriel Carlsson,0,2,1,D,2016
12814,2,21,Gabriel Carlsson,0,14,2,D,2017
12815,0,21,Gabriel Dumont,0,3,0,C,2011
12816,2,22,Gabriel Dumont,1,10,3,C,2012
12817,0,23,Gabriel Dumont,0,2,0,C,2013
12818,0,24,Gabriel Dumont,0,3,0,C,2014
12819,2,26,Gabriel Dumont,2,39,4,C,2016
12820,0,27,Gabriel Dumont,0,7,0,C,2017
12821,30,19,Gabriel Landeskog,22,82,52,LW,2011
12822,8,20,Gabriel Landeskog,9,36,17,LW,2012
12823,39,21,Gabriel Landeskog,26,81,65,LW,2013
12824,36,22,Gabriel Landeskog,23,82,59,LW,2014
12825,33,23,Gabriel Landeskog,20,75,53,LW,2015
12826,15,24,Gabriel Landeskog,18,72,33,LW,2016
12827,37,25,Gabriel Landeskog,25,78,62,LW,2017
12828,14,19,Gaetan Duchesne,9,74,23,LW,1981
12829,19,20,Gaetan Duchesne,18,77,37,LW,1982
12830,19,21,Gaetan Duchesne,17,79,36,LW,1983
12831,23,22,Gaetan Duchesne,15,67,38,LW,1984
12832,28,23,Gaetan Duchesne,11,80,39,LW,1985
12833,35,24,Gaetan Duchesne,17,74,52,LW,1986
12834,23,25,Gaetan Duchesne,24,80,47,LW,1987
12835,21,26,Gaetan Duchesne,8,70,29,LW,1988
12836,8,27,Gaetan Duchesne,12,72,20,LW,1989
12837,9,28,Gaetan Duchesne,9,68,18,LW,1990
12838,15,29,Gaetan Duchesne,8,73,23,LW,1991
12839,13,30,Gaetan Duchesne,16,84,29,LW,1992
12840,18,31,Gaetan Duchesne,12,84,30,LW,1993
12841,9,32,Gaetan Duchesne,3,46,12,LW,1994
12842,0,25,Gaetan Royer,0,3,0,RW,2001
12843,0,20,Galen Head,0,1,0,RW,1967
12844,3,20,Garnet Bailey,3,8,6,LW,1968
12845,11,21,Garnet Bailey,11,58,22,LW,1969
12846,6,22,Garnet Bailey,0,36,6,LW,1970
12847,13,23,Garnet Bailey,9,73,22,LW,1971
12848,24,24,Garnet Bailey,10,70,34,LW,1972
12849,17,25,Garnet Bailey,16,67,33,LW,1973
12850,39,26,Garnet Bailey,19,71,58,LW,1974
12851,19,27,Garnet Bailey,13,67,32,LW,1975
12852,27,28,Garnet Bailey,19,78,46,LW,1976
12853,12,29,Garnet Bailey,7,40,19,LW,1977
12854,2,21,Garnet Exelby,0,15,2,D,2002
12855,9,22,Garnet Exelby,1,71,10,D,2003
12856,9,24,Garnet Exelby,1,75,10,D,2005
12857,8,25,Garnet Exelby,2,58,10,D,2006
12858,5,26,Garnet Exelby,2,79,7,D,2007
12859,7,27,Garnet Exelby,0,59,7,D,2008
12860,3,28,Garnet Exelby,1,51,4,D,2009
12861,3,24,Garnet Hathaway,0,14,3,RW,2015
12862,4,25,Garnet Hathaway,1,26,5,RW,2016
12863,9,26,Garnet Hathaway,4,59,13,RW,2017
12864,0,23,Garret Stroshein,0,3,0,RW,2003
12865,2,28,Garrett Burnett,1,39,3,LW,2003
12866,0,25,Garrett Mitchell,0,1,0,RW,2016
12867,0,28,Garrett Stafford,0,2,0,D,2007
12868,2,29,Garrett Stafford,0,3,2,D,2008
12869,0,31,Garrett Stafford,0,2,0,D,2010
12870,0,22,Garrett Wilson,0,3,0,LW,2013
12871,0,23,Garrett Wilson,0,2,0,LW,2014
12872,0,24,Garrett Wilson,0,29,0,LW,2015
12873,30,21,Garry Galley,8,78,38,D,1984
12874,13,22,Garry Galley,9,49,22,D,1985
12875,21,23,Garry Galley,6,48,27,D,1986
12876,23,24,Garry Galley,7,58,30,D,1987
12877,22,25,Garry Galley,8,78,30,D,1988
12878,27,26,Garry Galley,8,71,35,D,1989
12879,21,27,Garry Galley,6,70,27,D,1990
12880,27,28,Garry Galley,5,77,32,D,1991
12881,49,29,Garry Galley,13,83,62,D,1992
12882,60,30,Garry Galley,10,81,70,D,1993
12883,29,31,Garry Galley,3,47,32,D,1994
12884,44,32,Garry Galley,10,78,54,D,1995
12885,34,33,Garry Galley,4,71,38,D,1996
12886,28,34,Garry Galley,9,74,37,D,1997
12887,12,35,Garry Galley,4,60,16,D,1998
12888,21,36,Garry Galley,9,70,30,D,1999
12889,14,37,Garry Galley,6,56,20,D,2000
12890,1,20,Garry Howatt,0,8,1,LW,1972
12891,11,21,Garry Howatt,6,78,17,LW,1973
12892,30,22,Garry Howatt,18,77,48,LW,1974
12893,13,23,Garry Howatt,21,80,34,LW,1975
12894,15,24,Garry Howatt,13,70,28,LW,1976
12895,12,25,Garry Howatt,7,61,19,LW,1977
12896,12,26,Garry Howatt,16,75,28,LW,1978
12897,11,27,Garry Howatt,8,77,19,LW,1979
12898,15,28,Garry Howatt,4,70,19,LW,1980
12899,32,29,Garry Howatt,18,80,50,LW,1981
12900,4,30,Garry Howatt,1,38,5,LW,1982
12901,0,31,Garry Howatt,0,6,0,LW,1983
12902,1,20,Garry Lariviere,0,4,1,D,1974
12903,17,21,Garry Lariviere,7,79,24,D,1975
12904,26,22,Garry Lariviere,7,76,33,D,1976
12905,23,22,Garry Lariviere,7,61,30,D,1976
12906,3,22,Garry Lariviere,0,15,3,D,1976
12907,26,22,Garry Lariviere,7,76,33,D,1976
12908,23,22,Garry Lariviere,7,61,30,D,1976
12909,3,22,Garry Lariviere,0,15,3,D,1976
12910,49,23,Garry Lariviere,7,80,56,D,1977
12911,49,23,Garry Lariviere,7,80,56,D,1977
12912,33,24,Garry Lariviere,5,50,38,D,1978
12913,33,24,Garry Lariviere,5,50,38,D,1978
12914,19,25,Garry Lariviere,2,75,21,D,1979
12915,15,26,Garry Lariviere,3,65,18,D,1980
12916,21,27,Garry Lariviere,1,62,22,D,1981
12917,2,28,Garry Lariviere,0,17,2,D,1982
12918,0,21,Garry Monahan,0,11,0,LW,1967
12919,0,22,Garry Monahan,0,3,0,LW,1968
12920,7,23,Garry Monahan,3,72,10,LW,1969
12921,22,24,Garry Monahan,15,78,37,LW,1970
12922,17,25,Garry Monahan,14,78,31,LW,1971
12923,18,26,Garry Monahan,13,78,31,C,1972
12924,16,27,Garry Monahan,9,78,25,LW,1973
12925,20,28,Garry Monahan,14,79,34,LW,1974
12926,17,29,Garry Monahan,16,66,33,LW,1975
12927,26,30,Garry Monahan,18,76,44,LW,1976
12928,19,31,Garry Monahan,10,67,29,LW,1977
12929,7,32,Garry Monahan,4,62,11,LW,1978
12930,5,25,Garry Peters,7,31,12,C,1967
12931,6,26,Garry Peters,8,66,14,C,1968
12932,10,27,Garry Peters,6,59,16,C,1969
12933,7,28,Garry Peters,6,73,13,C,1970
12934,0,29,Garry Peters,0,2,0,C,1971
12935,7,30,Garry Peters,2,23,9,C,1972
12936,7,30,Garry Peters,2,23,9,C,1972
12937,5,31,Garry Peters,2,34,7,C,1973
12938,5,31,Garry Peters,2,34,7,C,1973
12939,1,21,Garry Swain,1,9,2,C,1968
12940,15,27,Garry Swain,7,66,22,C,1974
12941,15,27,Garry Swain,7,66,22,C,1974
12942,16,28,Garry Swain,10,79,26,C,1975
12943,2,29,Garry Swain,5,26,7,C,1976
12944,11,20,Garry Unger,6,28,17,C,1967
12945,20,21,Garry Unger,24,76,44,C,1968
12946,24,22,Garry Unger,42,76,66,C,1969
12947,28,23,Garry Unger,28,79,56,C,1970
12948,34,24,Garry Unger,36,78,70,C,1971
12949,39,25,Garry Unger,41,78,80,C,1972
12950,35,26,Garry Unger,33,78,68,C,1973
12951,44,27,Garry Unger,36,80,80,C,1974
12952,44,28,Garry Unger,39,80,83,C,1975
12953,27,29,Garry Unger,30,80,57,C,1976
12954,20,30,Garry Unger,32,80,52,C,1977
12955,26,31,Garry Unger,30,80,56,C,1978
12956,16,32,Garry Unger,17,79,33,C,1979
12957,10,33,Garry Unger,10,71,20,C,1980
12958,13,34,Garry Unger,7,46,20,C,1981
12959,0,35,Garry Unger,2,16,2,C,1982
12960,11,23,Garry Valk,10,59,21,LW,1990
12961,17,24,Garry Valk,8,65,25,LW,1991
12962,7,25,Garry Valk,6,48,13,LW,1992
12963,27,26,Garry Valk,18,78,45,LW,1993
12964,6,27,Garry Valk,3,36,9,LW,1994
12965,12,28,Garry Valk,12,79,24,LW,1995
12966,11,29,Garry Valk,10,70,21,LW,1996
12967,1,30,Garry Valk,2,39,3,LW,1997
12968,21,31,Garry Valk,8,77,29,LW,1998
12969,14,32,Garry Valk,10,73,24,RW,1999
12970,18,33,Garry Valk,8,74,26,RW,2000
12971,10,34,Garry Valk,5,63,15,LW,2001
12972,1,35,Garry Valk,0,16,1,LW,2002
12973,0,19,Garth Butcher,0,5,0,D,1981
12974,13,20,Garth Butcher,1,55,14,D,1982
12975,0,21,Garth Butcher,2,28,2,D,1983
12976,9,22,Garth Butcher,3,75,12,D,1984
12977,7,23,Garth Butcher,4,70,11,D,1985
12978,15,24,Garth Butcher,5,70,20,D,1986
12979,17,25,Garth Butcher,6,80,23,D,1987
12980,20,26,Garth Butcher,0,78,20,D,1988
12981,14,27,Garth Butcher,6,80,20,D,1989
12982,16,28,Garth Butcher,6,82,22,D,1990
12983,15,29,Garth Butcher,5,68,20,D,1991
12984,10,30,Garth Butcher,5,84,15,D,1992
12985,15,31,Garth Butcher,4,77,19,D,1993
12986,7,32,Garth Butcher,1,45,8,D,1994
12987,0,23,Garth MacGuigan,0,2,0,C,1979
12988,1,27,Garth MacGuigan,0,3,1,C,1983
12989,0,21,Garth Murray,1,20,1,C,2003
12990,1,23,Garth Murray,5,36,6,C,2005
12991,1,24,Garth Murray,2,43,3,LW,2006
12992,0,25,Garth Murray,0,7,0,C,2007
12993,0,26,Garth Murray,0,10,0,C,2008
12994,4,23,Garth Rizzuto,3,37,7,C,1970
12995,10,25,Garth Rizzuto,10,61,20,C,1972
12996,10,25,Garth Rizzuto,10,61,20,C,1972
12997,4,26,Garth Rizzuto,3,41,7,C,1973
12998,4,26,Garth Rizzuto,3,41,7,C,1973
12999,28,29,Gary Bergman,13,74,41,D,1967
13000,30,30,Gary Bergman,7,76,37,D,1968
13001,17,31,Gary Bergman,6,69,23,D,1969
13002,25,32,Gary Bergman,8,68,33,D,1970
13003,31,33,Gary Bergman,6,75,37,D,1971
13004,28,34,Gary Bergman,3,68,31,D,1972
13005,29,35,Gary Bergman,3,68,32,D,1973
13006,25,36,Gary Bergman,5,76,30,D,1974
13007,33,37,Gary Bergman,5,75,38,D,1975
13008,23,26,Gary Bredin,18,77,41,RW,1974
13009,21,26,Gary Bredin,15,67,36,RW,1974
13010,2,26,Gary Bredin,3,10,5,RW,1974
13011,21,26,Gary Bredin,15,67,36,RW,1974
13012,2,26,Gary Bredin,3,10,5,RW,1974
13013,8,27,Gary Bredin,8,67,16,RW,1975
13014,2,26,Gary Burns,2,11,4,C,1980
13015,0,23,Gary Coalter,0,4,0,RW,1973
13016,4,24,Gary Coalter,2,30,6,RW,1974
13017,1,23,Gary Connelly,0,4,1,RW,1973
13018,1,23,Gary Connelly,0,4,1,RW,1973
13019,1,22,Gary Croteau,5,11,6,LW,1968
13020,2,23,Gary Croteau,0,13,2,LW,1969
13021,28,24,Gary Croteau,15,74,43,LW,1970
13022,12,25,Gary Croteau,12,73,24,RW,1971
13023,15,26,Gary Croteau,6,47,21,LW,1972
13024,21,27,Gary Croteau,14,76,35,LW,1973
13025,11,28,Gary Croteau,8,77,19,LW,1974
13026,14,29,Gary Croteau,19,79,33,LW,1975
13027,27,30,Gary Croteau,24,78,51,LW,1976
13028,22,31,Gary Croteau,17,62,39,LW,1977
13029,18,32,Gary Croteau,23,79,41,LW,1978
13030,4,33,Gary Croteau,1,15,5,LW,1979
13031,0,23,Gary Cunningham,0,2,0,D,1973
13032,1,21,Gary Dillon,1,13,2,C,1980
13033,1,25,Gary Dineen,0,4,1,C,1968
13034,10,21,Gary Doak,2,59,12,D,1967
13035,3,22,Gary Doak,3,22,6,D,1968
13036,7,23,Gary Doak,1,44,8,D,1969
13037,10,24,Gary Doak,2,77,12,D,1970
13038,11,25,Gary Doak,1,55,12,D,1971
13039,5,26,Gary Doak,0,49,5,D,1972
13040,4,27,Gary Doak,0,69,4,D,1973
13041,0,28,Gary Doak,0,40,0,D,1974
13042,6,29,Gary Doak,1,58,7,D,1975
13043,13,30,Gary Doak,3,76,16,D,1976
13044,13,31,Gary Doak,4,61,17,D,1977
13045,11,32,Gary Doak,6,63,17,D,1978
13046,5,33,Gary Doak,0,52,5,D,1979
13047,0,34,Gary Doak,0,11,0,D,1980
13048,0,21,Gary Donaldson,0,1,0,RW,1973
13049,0,24,Gary Donaldson,0,5,0,RW,1976
13050,30,24,Gary Dornhoefer,13,65,43,RW,1967
13051,16,25,Gary Dornhoefer,8,60,24,RW,1968
13052,29,26,Gary Dornhoefer,26,65,55,RW,1969
13053,20,27,Gary Dornhoefer,20,57,40,RW,1970
13054,32,28,Gary Dornhoefer,17,75,49,RW,1971
13055,49,29,Gary Dornhoefer,30,77,79,RW,1972
13056,39,30,Gary Dornhoefer,11,57,50,RW,1973
13057,27,31,Gary Dornhoefer,17,69,44,RW,1974
13058,35,32,Gary Dornhoefer,28,74,63,RW,1975
13059,34,33,Gary Dornhoefer,25,79,59,RW,1976
13060,5,34,Gary Dornhoefer,7,47,12,RW,1977
13061,0,30,Gary Emmons,1,3,1,C,1993
13062,0,25,Gary Gambucci,1,9,1,C,1971
13063,7,27,Gary Gambucci,1,42,8,LW,1973
13064,18,28,Gary Gambucci,19,68,37,C,1974
13065,18,28,Gary Gambucci,19,68,37,C,1974
13066,6,29,Gary Gambucci,10,45,16,C,1975
13067,6,29,Gary Gambucci,10,45,16,C,1975
13068,0,20,Gary Geldart,0,4,0,D,1970
13069,1,29,Gary Gresdal,0,2,1,D,1975
13070,1,29,Gary Gresdal,0,2,1,D,1975
13071,0,22,Gary Holt,0,1,0,LW,1973
13072,1,23,Gary Holt,0,1,1,LW,1974
13073,5,24,Gary Holt,6,48,11,LW,1975
13074,1,25,Gary Holt,0,2,1,LW,1976
13075,4,26,Gary Holt,7,49,11,LW,1977
13076,0,27,Gary Jaquith,0,2,0,D,1975
13077,0,27,Gary Jaquith,0,2,0,D,1975
13078,21,25,Gary Jarrett,18,68,39,LW,1967
13079,23,26,Gary Jarrett,22,63,45,LW,1968
13080,19,27,Gary Jarrett,12,75,31,LW,1969
13081,19,28,Gary Jarrett,15,75,34,LW,1970
13082,10,29,Gary Jarrett,5,55,15,LW,1971
13083,39,30,Gary Jarrett,40,77,79,LW,1972
13084,39,31,Gary Jarrett,31,75,70,LW,1973
13085,39,31,Gary Jarrett,31,75,70,LW,1973
13086,24,32,Gary Jarrett,17,77,41,LW,1974
13087,24,32,Gary Jarrett,17,77,41,LW,1974
13088,17,33,Gary Jarrett,16,69,33,LW,1975
13089,17,33,Gary Jarrett,16,69,33,LW,1975
13090,8,19,Gary Leeman,4,52,12,D,1983
13091,26,20,Gary Leeman,5,53,31,LW,1984
13092,23,21,Gary Leeman,9,53,32,RW,1985
13093,31,22,Gary Leeman,21,80,52,RW,1986
13094,31,23,Gary Leeman,30,80,61,RW,1987
13095,43,24,Gary Leeman,32,61,75,RW,1988
13096,44,25,Gary Leeman,51,80,95,RW,1989
13097,12,26,Gary Leeman,17,52,29,RW,1990
13098,20,27,Gary Leeman,9,63,29,RW,1991
13099,17,28,Gary Leeman,15,50,32,RW,1992
13100,11,29,Gary Leeman,4,31,15,RW,1993
13101,0,30,Gary Leeman,2,10,2,RW,1994
13102,1,32,Gary Leeman,0,2,1,RW,1996
13103,11,20,Gary Lupul,9,51,20,C,1979
13104,2,21,Gary Lupul,0,7,2,C,1980
13105,7,22,Gary Lupul,10,41,17,C,1981
13106,10,23,Gary Lupul,18,40,28,LW,1982
13107,27,24,Gary Lupul,17,69,44,C,1983
13108,17,25,Gary Lupul,12,66,29,LW,1984
13109,1,26,Gary Lupul,4,19,5,LW,1985
13110,34,20,Gary MacGregor,42,78,76,C,1974
13111,34,20,Gary MacGregor,42,78,76,C,1974
13112,17,21,Gary MacGregor,21,73,38,C,1975
13113,17,21,Gary MacGregor,21,73,38,C,1975
13114,13,22,Gary MacGregor,8,46,21,C,1976
13115,8,22,Gary MacGregor,8,30,16,C,1976
13116,5,22,Gary MacGregor,0,16,5,C,1976
13117,13,22,Gary MacGregor,8,46,21,C,1976
13118,8,22,Gary MacGregor,8,30,16,C,1976
13119,5,22,Gary MacGregor,0,16,5,C,1976
13120,2,23,Gary MacGregor,11,37,13,C,1977
13121,2,23,Gary MacGregor,11,37,13,C,1977
13122,4,24,Gary MacGregor,8,17,12,C,1978
13123,3,21,Gary Marsh,1,6,4,LW,1967
13124,0,22,Gary Marsh,0,1,0,LW,1968
13125,2,20,Gary McAdam,1,31,3,RW,1975
13126,16,21,Gary McAdam,13,73,29,RW,1976
13127,22,22,Gary McAdam,19,79,41,LW,1977
13128,14,23,Gary McAdam,11,68,25,LW,1978
13129,22,24,Gary McAdam,19,78,41,LW,1979
13130,23,25,Gary McAdam,8,74,31,RW,1980
13131,15,26,Gary McAdam,12,46,27,LW,1981
13132,0,27,Gary McAdam,1,4,1,RW,1982
13133,11,28,Gary McAdam,10,62,21,LW,1983
13134,1,29,Gary McAdam,1,4,2,LW,1984
13135,6,30,Gary McAdam,1,15,7,LW,1985
13136,2,24,Gary Morrison,0,3,2,RW,1979
13137,13,25,Gary Morrison,1,33,14,RW,1980
13138,0,26,Gary Morrison,0,7,0,RW,1981
13139,3,19,Gary Nylund,0,16,3,D,1982
13140,14,20,Gary Nylund,2,47,16,D,1983
13141,17,21,Gary Nylund,3,76,20,D,1984
13142,16,22,Gary Nylund,2,79,18,D,1985
13143,20,23,Gary Nylund,7,80,27,D,1986
13144,15,24,Gary Nylund,4,76,19,D,1987
13145,10,25,Gary Nylund,7,69,17,D,1988
13146,21,26,Gary Nylund,4,64,25,D,1989
13147,21,27,Gary Nylund,2,72,23,D,1990
13148,1,28,Gary Nylund,0,7,1,D,1991
13149,1,29,Gary Nylund,1,22,2,D,1992
13150,3,22,Gary Rissling,3,26,6,D,1978
13151,1,23,Gary Rissling,0,11,1,D,1979
13152,0,24,Gary Rissling,1,25,1,LW,1980
13153,0,25,Gary Rissling,0,16,0,LW,1981
13154,4,26,Gary Rissling,5,40,9,LW,1982
13155,13,27,Gary Rissling,4,47,17,LW,1983
13156,9,28,Gary Rissling,10,56,19,LW,1984
13157,10,20,Gary Roberts,5,32,15,LW,1986
13158,15,21,Gary Roberts,13,74,28,LW,1987
13159,16,22,Gary Roberts,22,71,38,LW,1988
13160,33,23,Gary Roberts,39,78,72,LW,1989
13161,31,24,Gary Roberts,22,80,53,LW,1990
13162,37,25,Gary Roberts,53,76,90,LW,1991
13163,41,26,Gary Roberts,38,58,79,LW,1992
13164,43,27,Gary Roberts,41,73,84,LW,1993
13165,2,28,Gary Roberts,2,8,4,LW,1994
13166,20,29,Gary Roberts,22,35,42,LW,1995
13167,29,31,Gary Roberts,20,61,49,LW,1997
13168,28,32,Gary Roberts,14,77,42,LW,1998
13169,30,33,Gary Roberts,23,69,53,LW,1999
13170,24,34,Gary Roberts,29,82,53,LW,2000
13171,27,35,Gary Roberts,21,69,48,LW,2001
13172,3,36,Gary Roberts,5,14,8,LW,2002
13173,20,37,Gary Roberts,28,72,48,LW,2003
13174,26,39,Gary Roberts,14,58,40,LW,2005
13175,22,40,Gary Roberts,20,69,42,LW,2006
13176,12,41,Gary Roberts,3,38,15,LW,2007
13177,3,42,Gary Roberts,4,30,7,LW,2008
13178,10,24,Gary Sabourin,13,50,23,RW,1967
13179,23,25,Gary Sabourin,25,75,48,RW,1968
13180,14,26,Gary Sabourin,28,72,42,RW,1969
13181,17,27,Gary Sabourin,14,59,31,RW,1970
13182,17,28,Gary Sabourin,28,77,45,RW,1971
13183,27,29,Gary Sabourin,21,76,48,RW,1972
13184,23,30,Gary Sabourin,7,54,30,RW,1973
13185,18,31,Gary Sabourin,5,55,23,RW,1974
13186,28,32,Gary Sabourin,21,76,49,RW,1975
13187,11,33,Gary Sabourin,7,33,18,RW,1976
13188,1,24,Gary Sampson,1,15,2,LW,1983
13189,15,25,Gary Sampson,10,46,25,C,1984
13190,4,26,Gary Sampson,1,19,5,LW,1985
13191,2,27,Gary Sampson,1,25,3,LW,1986
13192,16,21,Gary Sargent,8,63,24,D,1975
13193,40,22,Gary Sargent,14,80,54,D,1976
13194,34,23,Gary Sargent,7,72,41,D,1977
13195,32,24,Gary Sargent,12,79,44,D,1978
13196,21,25,Gary Sargent,13,52,34,D,1979
13197,7,26,Gary Sargent,4,23,11,D,1980
13198,5,27,Gary Sargent,0,15,5,D,1981
13199,6,28,Gary Sargent,3,18,9,D,1982
13200,2,23,Gary Shuchuk,1,6,3,RW,1990
13201,4,25,Gary Shuchuk,2,25,6,RW,1992
13202,4,26,Gary Shuchuk,3,56,7,RW,1993
13203,6,27,Gary Shuchuk,3,22,9,C,1994
13204,10,28,Gary Shuchuk,4,33,14,RW,1995
13205,1,22,Gary Sittler,1,5,2,D,1974
13206,1,22,Gary Sittler,1,5,2,D,1974
13207,50,21,Gary Suter,18,80,68,D,1985
13208,39,22,Gary Suter,9,68,48,D,1986
13209,70,23,Gary Suter,21,75,91,D,1987
13210,49,24,Gary Suter,13,63,62,D,1988
13211,60,25,Gary Suter,16,76,76,D,1989
13212,58,26,Gary Suter,12,79,70,D,1990
13213,43,27,Gary Suter,12,70,55,D,1991
13214,58,28,Gary Suter,23,81,81,D,1992
13215,12,29,Gary Suter,6,41,18,D,1993
13216,27,30,Gary Suter,10,48,37,D,1994
13217,47,31,Gary Suter,20,82,67,D,1995
13218,21,32,Gary Suter,7,82,28,D,1996
13219,28,33,Gary Suter,14,73,42,D,1997
13220,0,34,Gary Suter,0,1,0,D,1998
13221,28,35,Gary Suter,6,76,34,D,1999
13222,24,36,Gary Suter,10,68,34,D,2000
13223,27,37,Gary Suter,6,82,33,D,2001
13224,1,24,Gary Veneruzzo,1,5,2,LW,1967
13225,0,28,Gary Veneruzzo,0,2,0,LW,1971
13226,30,29,Gary Veneruzzo,43,78,73,RW,1972
13227,30,29,Gary Veneruzzo,43,78,73,RW,1972
13228,29,30,Gary Veneruzzo,39,78,68,LW,1973
13229,29,30,Gary Veneruzzo,39,78,68,LW,1973
13230,27,31,Gary Veneruzzo,33,77,60,LW,1974
13231,27,31,Gary Veneruzzo,33,77,60,LW,1974
13232,26,32,Gary Veneruzzo,22,75,48,RW,1975
13233,11,33,Gary Veneruzzo,14,40,25,RW,1976
13234,6,23,Gary Williamson,2,9,8,LW,1973
13235,6,23,Gary Williamson,2,9,8,LW,1973
13236,3,20,Gary Yaremchuk,0,18,3,C,1981
13237,0,21,Gary Yaremchuk,0,3,0,C,1982
13238,0,22,Gary Yaremchuk,0,1,0,C,1983
13239,1,23,Gary Yaremchuk,1,12,2,C,1984
13240,21,19,Gaston Gingras,13,60,34,D,1978
13241,21,19,Gaston Gingras,13,60,34,D,1978
13242,7,20,Gaston Gingras,3,34,10,D,1979
13243,16,21,Gaston Gingras,5,55,21,D,1980
13244,18,22,Gaston Gingras,6,34,24,D,1981
13245,26,23,Gaston Gingras,11,67,37,D,1982
13246,20,24,Gaston Gingras,7,59,27,D,1983
13247,2,25,Gaston Gingras,0,5,2,D,1984
13248,18,26,Gaston Gingras,8,34,26,D,1985
13249,34,27,Gaston Gingras,11,66,45,D,1986
13250,23,28,Gaston Gingras,7,70,30,D,1987
13251,10,29,Gaston Gingras,3,52,13,D,1988
13252,1,20,Gaston Therrien,0,3,1,D,1980
13253,7,21,Gaston Therrien,0,14,7,D,1981
13254,0,22,Gaston Therrien,0,5,0,D,1982
13255,6,22,Gates Orlando,3,11,9,C,1984
13256,12,23,Gates Orlando,13,60,25,C,1985
13257,8,24,Gates Orlando,2,27,10,C,1986
13258,40,21,Gavin Kirk,28,78,68,C,1972
13259,40,21,Gavin Kirk,28,78,68,C,1972
13260,48,22,Gavin Kirk,20,78,68,C,1973
13261,48,22,Gavin Kirk,20,78,68,C,1973
13262,58,23,Gavin Kirk,15,78,73,C,1974
13263,58,23,Gavin Kirk,15,78,73,C,1974
13264,46,24,Gavin Kirk,35,77,81,C,1975
13265,46,24,Gavin Kirk,35,77,81,C,1975
13266,46,25,Gavin Kirk,17,81,63,C,1976
13267,28,25,Gavin Kirk,8,52,36,C,1976
13268,18,25,Gavin Kirk,9,29,27,C,1976
13269,46,25,Gavin Kirk,17,81,63,C,1976
13270,28,25,Gavin Kirk,8,52,36,C,1976
13271,18,25,Gavin Kirk,9,29,27,C,1976
13272,5,27,Gavin Kirk,1,30,6,C,1978
13273,5,27,Gavin Kirk,1,30,6,C,1978
13274,0,27,Gavin Morgan,0,6,0,C,2003
13275,3,22,Gemel Smith,3,17,6,C,2016
13276,5,23,Gemel Smith,6,46,11,C,2017
13277,10,20,Gene Carr,11,74,21,C,1971
13278,10,21,Gene Carr,9,50,19,C,1972
13279,16,22,Gene Carr,7,50,23,C,1973
13280,32,23,Gene Carr,7,80,39,C,1974
13281,11,24,Gene Carr,8,38,19,LW,1975
13282,12,25,Gene Carr,15,68,27,C,1976
13283,37,26,Gene Carr,19,75,56,C,1977
13284,8,27,Gene Carr,3,30,11,LW,1978
13285,34,24,Gene Peacosh,37,67,71,C,1972
13286,34,24,Gene Peacosh,37,67,71,C,1972
13287,32,25,Gene Peacosh,21,68,53,LW,1973
13288,32,25,Gene Peacosh,21,68,53,LW,1973
13289,36,26,Gene Peacosh,43,78,79,LW,1974
13290,36,26,Gene Peacosh,43,78,79,LW,1974
13291,33,27,Gene Peacosh,37,79,70,LW,1975
13292,33,27,Gene Peacosh,37,79,70,LW,1975
13293,30,28,Gene Peacosh,27,75,57,LW,1976
13294,26,28,Gene Peacosh,22,64,48,LW,1976
13295,4,28,Gene Peacosh,5,11,9,LW,1976
13296,30,28,Gene Peacosh,27,75,57,LW,1976
13297,26,28,Gene Peacosh,22,64,48,LW,1976
13298,4,28,Gene Peacosh,5,11,9,LW,1976
13299,0,22,Gene Sobchuk,0,1,0,LW,1973
13300,0,23,Gene Sobchuk,1,3,1,LW,1974
13301,0,23,Gene Sobchuk,1,3,1,LW,1974
13302,18,24,Gene Sobchuk,23,78,41,LW,1975
13303,18,24,Gene Sobchuk,23,78,41,LW,1975
13304,15,30,Gene Ubriaco,18,65,33,C,1967
13305,18,31,Gene Ubriaco,19,75,37,LW,1968
13306,2,32,Gene Ubriaco,2,37,4,LW,1969
13307,0,21,Geoff Courtnall,0,4,0,LW,1983
13308,16,22,Geoff Courtnall,12,64,28,LW,1984
13309,16,23,Geoff Courtnall,21,64,37,LW,1985
13310,23,24,Geoff Courtnall,13,65,36,LW,1986
13311,30,25,Geoff Courtnall,36,74,66,LW,1987
13312,38,26,Geoff Courtnall,42,79,80,LW,1988
13313,39,27,Geoff Courtnall,35,80,74,LW,1989
13314,32,28,Geoff Courtnall,33,77,65,LW,1990
13315,34,29,Geoff Courtnall,23,70,57,LW,1991
13316,46,30,Geoff Courtnall,31,84,77,LW,1992
13317,44,31,Geoff Courtnall,26,82,70,LW,1993
13318,18,32,Geoff Courtnall,16,45,34,LW,1994
13319,16,33,Geoff Courtnall,24,69,40,LW,1995
13320,40,34,Geoff Courtnall,17,82,57,LW,1996
13321,31,35,Geoff Courtnall,31,79,62,LW,1997
13322,7,36,Geoff Courtnall,5,24,12,LW,1998
13323,2,37,Geoff Courtnall,2,6,4,LW,1999
13324,0,23,Geoff Kinrade,0,1,0,D,2008
13325,5,20,Geoff Platt,0,15,5,C,2005
13326,5,21,Geoff Platt,4,26,9,C,2006
13327,0,22,Geoff Platt,0,5,0,C,2007
13328,0,22,Geoff Powis,0,2,0,C,1967
13329,0,18,Geoff Sanderson,1,2,1,C,1990
13330,18,19,Geoff Sanderson,13,64,31,C,1991
13331,43,20,Geoff Sanderson,46,82,89,LW,1992
13332,26,21,Geoff Sanderson,41,82,67,LW,1993
13333,14,22,Geoff Sanderson,18,46,32,LW,1994
13334,31,23,Geoff Sanderson,34,81,65,LW,1995
13335,31,24,Geoff Sanderson,36,82,67,LW,1996
13336,18,25,Geoff Sanderson,11,75,29,LW,1997
13337,18,26,Geoff Sanderson,12,75,30,LW,1998
13338,13,27,Geoff Sanderson,13,67,26,LW,1999
13339,26,28,Geoff Sanderson,30,68,56,LW,2000
13340,5,29,Geoff Sanderson,11,42,16,LW,2001
13341,33,30,Geoff Sanderson,34,82,67,LW,2002
13342,20,31,Geoff Sanderson,16,80,36,LW,2003
13343,21,33,Geoff Sanderson,25,77,46,LW,2005
13344,18,34,Geoff Sanderson,11,58,29,LW,2006
13345,10,35,Geoff Sanderson,3,41,13,LW,2007
13346,11,20,Geoff Smith,4,74,15,D,1989
13347,12,21,Geoff Smith,1,59,13,D,1990
13348,16,22,Geoff Smith,2,74,18,D,1991
13349,14,23,Geoff Smith,4,78,18,D,1992
13350,8,24,Geoff Smith,1,77,9,D,1993
13351,4,25,Geoff Smith,2,47,6,D,1994
13352,7,26,Geoff Smith,3,31,10,D,1995
13353,0,27,Geoff Smith,0,3,0,D,1996
13354,1,28,Geoff Smith,1,15,2,D,1997
13355,0,29,Geoff Smith,0,4,0,D,1998
13356,0,26,Geordie Kinnear,0,4,0,D,1999
13357,2,23,Geordie Robertson,1,5,3,RW,1982
13358,21,37,George Armstrong,13,62,34,RW,1967
13359,16,38,George Armstrong,11,53,27,RW,1968
13360,15,39,George Armstrong,13,49,28,RW,1969
13361,18,40,George Armstrong,7,59,25,RW,1970
13362,13,20,George Ferguson,10,72,23,RW,1972
13363,4,21,George Ferguson,0,16,4,C,1973
13364,30,22,George Ferguson,19,69,49,RW,1974
13365,32,23,George Ferguson,12,79,44,RW,1975
13366,15,24,George Ferguson,9,50,24,RW,1976
13367,16,25,George Ferguson,7,73,23,RW,1977
13368,29,26,George Ferguson,21,80,50,RW,1978
13369,28,27,George Ferguson,21,73,49,RW,1979
13370,18,28,George Ferguson,25,79,43,RW,1980
13371,31,29,George Ferguson,22,71,53,RW,1981
13372,12,30,George Ferguson,8,72,20,C,1982
13373,10,31,George Ferguson,6,63,16,C,1983
13374,8,30,George Konik,7,52,15,D,1967
13375,12,35,George Konik,4,54,16,D,1972
13376,12,22,George Kuzmicz,0,34,12,D,1974
13377,12,22,George Kuzmicz,0,34,12,D,1974
13378,0,23,George Kuzmicz,0,1,0,D,1975
13379,33,23,George Lyle,39,75,72,LW,1976
13380,33,23,George Lyle,39,75,72,LW,1976
13381,24,24,George Lyle,30,68,54,LW,1977
13382,24,24,George Lyle,30,68,54,LW,1977
13383,18,25,George Lyle,17,59,35,LW,1978
13384,18,25,George Lyle,17,59,35,LW,1978
13385,4,26,George Lyle,7,27,11,LW,1979
13386,14,27,George Lyle,10,31,24,LW,1980
13387,14,28,George Lyle,3,25,17,LW,1981
13388,6,29,George Lyle,4,16,10,LW,1982
13389,1,25,George McPhee,1,9,2,LW,1983
13390,15,26,George McPhee,12,49,27,LW,1984
13391,4,27,George McPhee,4,30,8,LW,1985
13392,4,28,George McPhee,4,21,8,LW,1986
13393,0,29,George McPhee,3,5,3,LW,1987
13394,1,30,George McPhee,0,1,1,LW,1988
13395,10,22,George Morrison,15,73,25,LW,1970
13396,11,23,George Morrison,2,42,13,LW,1971
13397,24,24,George Morrison,16,70,40,LW,1972
13398,24,24,George Morrison,16,70,40,LW,1972
13399,38,25,George Morrison,40,73,78,LW,1973
13400,29,26,George Morrison,31,76,60,LW,1974
13401,32,27,George Morrison,25,79,57,C,1975
13402,32,27,George Morrison,25,79,57,C,1975
13403,19,28,George Morrison,11,63,30,C,1976
13404,19,28,George Morrison,11,63,30,C,1976
13405,3,26,George Parros,2,55,5,RW,2005
13406,0,27,George Parros,1,34,1,RW,2006
13407,4,28,George Parros,1,69,5,RW,2007
13408,5,29,George Parros,5,74,10,RW,2008
13409,0,30,George Parros,4,57,4,RW,2009
13410,1,31,George Parros,3,78,4,RW,2010
13411,3,32,George Parros,1,46,4,RW,2011
13412,1,33,George Parros,1,39,2,RW,2012
13413,1,34,George Parros,0,22,1,RW,2013
13414,13,21,George Pesut,0,47,13,D,1974
13415,9,22,George Pesut,3,45,12,D,1975
13416,0,23,George Pesut,2,17,2,D,1976
13417,0,23,George Pesut,2,17,2,D,1976
13418,0,25,George Servinis,0,5,0,LW,1987
13419,0,26,George Standing,0,2,0,RW,1967
13420,5,25,George Swarbrick,13,49,18,RW,1967
13421,19,26,George Swarbrick,4,69,23,RW,1968
13422,1,27,George Swarbrick,0,12,1,RW,1969
13423,0,28,George Swarbrick,0,2,0,RW,1970
13424,0,21,Georges Laraque,0,11,0,RW,1997
13425,2,22,Georges Laraque,3,39,5,RW,1998
13426,8,23,Georges Laraque,8,76,16,RW,1999
13427,16,24,Georges Laraque,13,82,29,RW,2000
13428,14,25,Georges Laraque,5,80,19,RW,2001
13429,7,26,Georges Laraque,6,64,13,RW,2002
13430,11,27,Georges Laraque,6,66,17,RW,2003
13431,10,29,Georges Laraque,2,72,12,RW,2005
13432,19,30,Georges Laraque,5,73,24,RW,2006
13433,9,31,Georges Laraque,4,71,13,RW,2007
13434,2,32,Georges Laraque,0,33,2,RW,2008
13435,2,33,Georges Laraque,1,28,3,RW,2009
13436,8,19,Gerald Diduck,2,65,10,D,1984
13437,2,20,Gerald Diduck,1,10,3,D,1985
13438,3,21,Gerald Diduck,2,30,5,D,1986
13439,12,22,Gerald Diduck,7,68,19,D,1987
13440,21,23,Gerald Diduck,11,65,32,D,1988
13441,17,24,Gerald Diduck,3,76,20,D,1989
13442,9,25,Gerald Diduck,4,63,13,D,1990
13443,21,26,Gerald Diduck,6,77,27,D,1991
13444,14,27,Gerald Diduck,6,80,20,D,1992
13445,10,28,Gerald Diduck,1,55,11,D,1993
13446,3,29,Gerald Diduck,2,35,5,D,1994
13447,9,30,Gerald Diduck,1,79,10,D,1995
13448,12,31,Gerald Diduck,2,67,14,D,1996
13449,10,32,Gerald Diduck,8,78,18,D,1997
13450,2,33,Gerald Diduck,0,44,2,D,1998
13451,3,34,Gerald Diduck,0,26,3,D,1999
13452,0,35,Gerald Diduck,0,14,0,D,2000
13453,12,21,Gerard Gallant,6,32,18,LW,1984
13454,19,22,Gerard Gallant,20,52,39,LW,1985
13455,34,23,Gerard Gallant,38,80,72,LW,1986
13456,39,24,Gerard Gallant,34,73,73,LW,1987
13457,54,25,Gerard Gallant,39,76,93,LW,1988
13458,44,26,Gerard Gallant,36,69,80,LW,1989
13459,16,27,Gerard Gallant,10,45,26,LW,1990
13460,22,28,Gerard Gallant,14,69,36,LW,1991
13461,20,29,Gerard Gallant,10,67,30,LW,1992
13462,9,30,Gerard Gallant,4,51,13,LW,1993
13463,0,31,Gerard Gallant,0,1,0,LW,1994
13464,0,29,Germain Gagnon,0,4,0,LW,1971
13465,29,30,Germain Gagnon,12,63,41,LW,1972
13466,28,31,Germain Gagnon,11,76,39,LW,1973
13467,35,32,Germain Gagnon,16,80,51,LW,1974
13468,9,33,Germain Gagnon,1,36,10,LW,1975
13469,18,28,German Titov,27,76,45,LW,1993
13470,12,29,German Titov,12,40,24,LW,1994
13471,39,30,German Titov,28,82,67,LW,1995
13472,30,31,German Titov,22,79,52,LW,1996
13473,22,32,German Titov,18,68,40,C,1997
13474,45,33,German Titov,11,72,56,C,1998
13475,29,34,German Titov,17,70,46,LW,1999
13476,11,35,German Titov,9,71,20,LW,2000
13477,14,36,German Titov,13,66,27,LW,2001
13478,4,21,Gerrard Gibbons,1,26,5,D,1973
13479,4,21,Gerrard Gibbons,1,26,5,D,1973
13480,0,23,Gerrard Gibbons,1,5,1,D,1975
13481,0,23,Gerrard Gibbons,1,5,1,D,1975
13482,25,35,Gerry Ehman,19,73,44,RW,1967
13483,24,36,Gerry Ehman,21,70,45,RW,1968
13484,19,37,Gerry Ehman,11,76,30,LW,1969
13485,18,38,Gerry Ehman,18,78,36,RW,1970
13486,0,27,Gerry Fleming,0,5,0,LW,1993
13487,0,28,Gerry Fleming,0,6,0,LW,1994
13488,0,36,Gerry Foley,0,1,0,RW,1968
13489,2,31,Gerry Goyer,1,40,3,C,1967
13490,0,21,Gerry Hart,0,1,0,D,1968
13491,0,22,Gerry Hart,0,3,0,D,1969
13492,7,23,Gerry Hart,2,64,9,D,1970
13493,0,24,Gerry Hart,0,3,0,D,1971
13494,11,25,Gerry Hart,1,47,12,D,1972
13495,10,26,Gerry Hart,1,70,11,D,1973
13496,14,27,Gerry Hart,4,71,18,D,1974
13497,18,28,Gerry Hart,6,80,24,D,1975
13498,18,29,Gerry Hart,4,80,22,D,1976
13499,23,30,Gerry Hart,2,78,25,D,1977
13500,14,31,Gerry Hart,2,50,16,D,1978
13501,23,32,Gerry Hart,3,71,26,D,1979
13502,11,33,Gerry Hart,4,69,15,D,1980
13503,1,34,Gerry Hart,0,35,1,D,1981
13504,0,35,Gerry Hart,0,8,0,D,1982
13505,3,20,Gerry Leroux,0,10,3,LW,1978
13506,3,20,Gerry Leroux,0,10,3,LW,1978
13507,0,23,Gerry McDonald,0,3,0,D,1981
13508,0,25,Gerry McDonald,0,5,0,D,1983
13509,5,22,Gerry Meehan,0,37,5,C,1968
13510,31,24,Gerry Meehan,24,77,55,C,1970
13511,27,25,Gerry Meehan,19,77,46,C,1971
13512,29,26,Gerry Meehan,31,77,60,C,1972
13513,26,27,Gerry Meehan,20,72,46,C,1973
13514,26,28,Gerry Meehan,14,74,40,C,1974
13515,35,29,Gerry Meehan,23,80,58,C,1975
13516,36,30,Gerry Meehan,28,80,64,C,1976
13517,24,31,Gerry Meehan,19,78,43,C,1977
13518,4,32,Gerry Meehan,2,18,6,C,1978
13519,0,32,Gerry Meehan,0,2,0,C,1978
13520,0,32,Gerry Meehan,0,2,0,C,1978
13521,35,33,Gerry Melnyk,15,73,50,C,1967
13522,1,23,Gerry Methe,0,5,1,D,1974
13523,1,23,Gerry Methe,0,5,1,D,1974
13524,1,21,Gerry Minor,0,5,1,C,1979
13525,14,22,Gerry Minor,10,74,24,C,1980
13526,1,23,Gerry Minor,0,13,1,C,1981
13527,5,24,Gerry Minor,1,39,6,C,1982
13528,0,25,Gerry Minor,0,9,0,C,1983
13529,0,21,Gerry O'Flaherty,0,2,0,LW,1971
13530,17,22,Gerry O'Flaherty,13,78,30,RW,1972
13531,20,23,Gerry O'Flaherty,22,78,42,LW,1973
13532,17,24,Gerry O'Flaherty,25,80,42,LW,1974
13533,18,25,Gerry O'Flaherty,20,68,38,LW,1975
13534,12,26,Gerry O'Flaherty,12,72,24,LW,1976
13535,11,27,Gerry O'Flaherty,6,59,17,LW,1977
13536,0,28,Gerry O'Flaherty,1,1,1,LW,1978
13537,6,29,Gerry Odrowski,4,42,10,D,1967
13538,1,30,Gerry Odrowski,5,74,6,D,1968
13539,2,33,Gerry Odrowski,1,55,3,D,1971
13540,31,34,Gerry Odrowski,6,78,37,D,1972
13541,32,35,Gerry Odrowski,4,77,36,D,1973
13542,38,36,Gerry Odrowski,5,77,43,D,1974
13543,38,36,Gerry Odrowski,5,77,43,D,1974
13544,13,37,Gerry Odrowski,1,50,14,D,1975
13545,13,37,Gerry Odrowski,1,50,14,D,1975
13546,20,21,Gerry Pinder,19,75,39,LW,1969
13547,18,22,Gerry Pinder,13,74,31,LW,1970
13548,31,23,Gerry Pinder,23,74,54,LW,1971
13549,36,24,Gerry Pinder,30,78,66,LW,1972
13550,36,24,Gerry Pinder,30,78,66,LW,1972
13551,33,25,Gerry Pinder,23,73,56,RW,1973
13552,33,25,Gerry Pinder,23,73,56,RW,1973
13553,28,26,Gerry Pinder,13,74,41,LW,1974
13554,28,26,Gerry Pinder,13,74,41,LW,1974
13555,30,27,Gerry Pinder,21,79,51,RW,1975
13556,30,27,Gerry Pinder,21,79,51,RW,1975
13557,13,28,Gerry Pinder,6,44,19,RW,1976
13558,13,28,Gerry Pinder,6,44,19,RW,1976
13559,1,29,Gerry Pinder,0,5,1,LW,1977
13560,1,29,Gerry Pinder,0,5,1,LW,1977
13561,0,20,Gerry Rioux,0,8,0,RW,1979
13562,2,19,Gilbert Brule,2,7,4,C,2005
13563,10,20,Gilbert Brule,9,78,19,C,2006
13564,8,21,Gilbert Brule,1,61,9,C,2007
13565,1,22,Gilbert Brule,2,11,3,C,2008
13566,20,23,Gilbert Brule,17,65,37,C,2009
13567,2,24,Gilbert Brule,7,41,9,C,2010
13568,9,25,Gilbert Brule,5,33,14,C,2011
13569,0,27,Gilbert Brule,0,3,0,C,2013
13570,8,19,Gilbert Delorme,3,60,11,D,1981
13571,21,20,Gilbert Delorme,12,78,33,D,1982
13572,12,21,Gilbert Delorme,2,71,14,D,1983
13573,12,22,Gilbert Delorme,2,74,14,D,1984
13574,18,23,Gilbert Delorme,2,64,20,D,1985
13575,3,24,Gilbert Delorme,4,43,7,D,1986
13576,8,25,Gilbert Delorme,2,55,10,D,1987
13577,3,26,Gilbert Delorme,1,42,4,D,1988
13578,7,27,Gilbert Delorme,3,54,10,D,1989
13579,0,20,Gilbert Dionne,0,2,0,LW,1990
13580,13,21,Gilbert Dionne,21,39,34,LW,1991
13581,28,22,Gilbert Dionne,20,75,48,LW,1992
13582,26,23,Gilbert Dionne,19,74,45,LW,1993
13583,9,24,Gilbert Dionne,0,26,9,LW,1994
13584,3,25,Gilbert Dionne,1,7,4,LW,1995
13585,34,20,Gilbert Perreault,38,78,72,C,1970
13586,48,21,Gilbert Perreault,26,76,74,C,1971
13587,60,22,Gilbert Perreault,28,78,88,C,1972
13588,33,23,Gilbert Perreault,18,55,51,C,1973
13589,57,24,Gilbert Perreault,39,68,96,C,1974
13590,69,25,Gilbert Perreault,44,80,113,C,1975
13591,56,26,Gilbert Perreault,39,80,95,C,1976
13592,48,27,Gilbert Perreault,41,79,89,C,1977
13593,58,28,Gilbert Perreault,27,79,85,C,1978
13594,66,29,Gilbert Perreault,40,80,106,C,1979
13595,39,30,Gilbert Perreault,20,56,59,C,1980
13596,42,31,Gilbert Perreault,31,62,73,C,1981
13597,46,32,Gilbert Perreault,30,77,76,C,1982
13598,59,33,Gilbert Perreault,31,73,90,C,1983
13599,53,34,Gilbert Perreault,30,78,83,C,1984
13600,39,35,Gilbert Perreault,21,72,60,C,1985
13601,7,36,Gilbert Perreault,9,20,16,C,1986
13602,1,20,Gilles Bilodeau,0,14,1,LW,1975
13603,1,20,Gilles Bilodeau,0,14,1,LW,1975
13604,6,21,Gilles Bilodeau,2,34,8,LW,1976
13605,6,21,Gilles Bilodeau,2,34,8,LW,1976
13606,2,22,Gilles Bilodeau,2,59,4,LW,1977
13607,2,22,Gilles Bilodeau,2,59,4,LW,1977
13608,6,23,Gilles Bilodeau,3,36,9,LW,1978
13609,6,23,Gilles Bilodeau,3,36,9,LW,1978
13610,1,24,Gilles Bilodeau,0,9,1,LW,1979
13611,9,20,Gilles Hamel,10,51,19,LW,1980
13612,7,21,Gilles Hamel,2,16,9,LW,1981
13613,20,22,Gilles Hamel,22,66,42,LW,1982
13614,23,23,Gilles Hamel,21,75,44,LW,1983
13615,30,24,Gilles Hamel,18,80,48,C,1984
13616,25,25,Gilles Hamel,19,77,44,LW,1985
13617,21,26,Gilles Hamel,27,79,48,LW,1986
13618,11,27,Gilles Hamel,8,63,19,LW,1987
13619,1,28,Gilles Hamel,0,12,1,LW,1988
13620,3,23,Gilles Lupien,1,46,4,D,1977
13621,9,24,Gilles Lupien,1,72,10,D,1978
13622,7,25,Gilles Lupien,1,56,8,D,1979
13623,5,26,Gilles Lupien,2,51,7,D,1980
13624,1,27,Gilles Lupien,0,1,1,D,1981
13625,21,22,Gilles Marotte,0,73,21,D,1967
13626,29,23,Gilles Marotte,5,68,34,D,1968
13627,19,24,Gilles Marotte,5,72,24,D,1969
13628,27,25,Gilles Marotte,6,78,33,D,1970
13629,24,26,Gilles Marotte,10,72,34,D,1971
13630,39,27,Gilles Marotte,6,78,45,D,1972
13631,28,28,Gilles Marotte,3,68,31,D,1973
13632,32,29,Gilles Marotte,4,77,36,D,1974
13633,17,30,Gilles Marotte,4,57,21,D,1975
13634,4,31,Gilles Marotte,3,47,7,D,1976
13635,20,32,Gilles Marotte,3,73,23,D,1977
13636,13,32,Gilles Marotte,2,44,15,D,1977
13637,7,32,Gilles Marotte,1,29,8,D,1977
13638,20,32,Gilles Marotte,3,73,23,D,1977
13639,13,32,Gilles Marotte,2,44,15,D,1977
13640,7,32,Gilles Marotte,1,29,8,D,1977
13641,3,23,Gilles Thibaudeau,1,9,4,C,1986
13642,6,24,Gilles Thibaudeau,5,17,11,C,1987
13643,6,25,Gilles Thibaudeau,6,32,12,C,1988
13644,15,26,Gilles Thibaudeau,11,41,26,C,1989
13645,7,27,Gilles Thibaudeau,2,20,9,C,1990
13646,28,29,Gilles Tremblay,23,71,51,LW,1967
13647,15,30,Gilles Tremblay,10,44,25,LW,1968
13648,10,22,Gino Cavallini,6,27,16,LW,1984
13649,12,23,Gino Cavallini,13,57,25,LW,1985
13650,26,24,Gino Cavallini,18,80,44,LW,1986
13651,17,25,Gino Cavallini,15,64,32,LW,1987
13652,23,26,Gino Cavallini,20,74,43,LW,1988
13653,15,27,Gino Cavallini,15,80,30,LW,1989
13654,27,28,Gino Cavallini,8,78,35,LW,1990
13655,14,29,Gino Cavallini,10,66,24,LW,1991
13656,15,30,Gino Cavallini,9,67,24,LW,1992
13657,1,20,Gino Odjick,7,45,8,LW,1990
13658,6,21,Gino Odjick,4,65,10,RW,1991
13659,13,22,Gino Odjick,4,75,17,LW,1992
13660,13,23,Gino Odjick,16,76,29,LW,1993
13661,5,24,Gino Odjick,4,23,9,LW,1994
13662,4,25,Gino Odjick,3,55,7,LW,1995
13663,8,26,Gino Odjick,5,70,13,RW,1996
13664,2,27,Gino Odjick,3,48,5,LW,1997
13665,3,28,Gino Odjick,4,23,7,LW,1998
13666,11,29,Gino Odjick,8,59,19,LW,1999
13667,3,30,Gino Odjick,2,30,5,LW,2000
13668,4,31,Gino Odjick,4,36,8,RW,2001
13669,0,21,Giovanni Fiore,0,1,0,LW,2017
13670,2,20,Glen Burdon,0,11,2,C,1974
13671,0,21,Glen Cochrane,0,1,0,D,1978
13672,8,23,Glen Cochrane,1,31,9,D,1980
13673,12,24,Glen Cochrane,6,63,18,D,1981
13674,22,25,Glen Cochrane,2,77,24,D,1982
13675,16,26,Glen Cochrane,7,67,23,D,1983
13676,3,27,Glen Cochrane,0,18,3,D,1984
13677,3,28,Glen Cochrane,0,49,3,D,1985
13678,0,29,Glen Cochrane,0,14,0,D,1986
13679,8,30,Glen Cochrane,1,73,9,D,1987
13680,0,31,Glen Cochrane,0,18,0,D,1988
13681,0,,Glen Critch,0,3,0,D,1975
13682,0,,Glen Critch,0,3,0,D,1975
13683,0,21,Glen Currie,2,32,2,C,1979
13684,13,22,Glen Currie,5,40,18,C,1980
13685,7,23,Glen Currie,7,43,14,C,1981
13686,28,24,Glen Currie,11,68,39,C,1982
13687,24,25,Glen Currie,12,80,36,C,1983
13688,5,26,Glen Currie,1,44,6,C,1984
13689,2,27,Glen Currie,1,12,3,C,1985
13690,0,29,Glen Currie,0,7,0,C,1987
13691,2,20,Glen Featherstone,0,18,2,D,1988
13692,12,21,Glen Featherstone,0,58,12,D,1989
13693,15,22,Glen Featherstone,5,68,20,D,1990
13694,0,23,Glen Featherstone,1,7,1,D,1991
13695,5,24,Glen Featherstone,5,34,10,D,1992
13696,8,25,Glen Featherstone,1,58,9,D,1993
13697,1,26,Glen Featherstone,2,19,3,D,1994
13698,10,27,Glen Featherstone,2,68,12,D,1995
13699,8,28,Glen Featherstone,3,54,11,D,1996
13700,11,23,Glen Irwin,2,70,13,D,1974
13701,8,24,Glen Irwin,3,72,11,D,1975
13702,4,25,Glen Irwin,2,44,6,D,1976
13703,4,25,Glen Irwin,2,44,6,D,1976
13704,0,26,Glen Irwin,0,23,0,D,1977
13705,0,26,Glen Irwin,0,20,0,D,1977
13706,0,26,Glen Irwin,0,3,0,D,1977
13707,0,26,Glen Irwin,0,23,0,D,1977
13708,0,26,Glen Irwin,0,20,0,D,1977
13709,0,26,Glen Irwin,0,3,0,D,1977
13710,1,27,Glen Irwin,0,24,1,D,1978
13711,1,27,Glen Irwin,0,24,1,D,1978
13712,13,25,Glen Metropolit,6,30,19,C,1999
13713,5,26,Glen Metropolit,1,15,6,C,2000
13714,16,27,Glen Metropolit,1,35,17,RW,2001
13715,3,28,Glen Metropolit,2,23,5,RW,2002
13716,19,32,Glen Metropolit,14,77,33,C,2006
13717,22,33,Glen Metropolit,11,82,33,C,2007
13718,11,34,Glen Metropolit,6,76,17,C,2008
13719,13,35,Glen Metropolit,16,69,29,C,2009
13720,1,19,Glen Murray,3,5,4,RW,1991
13721,4,20,Glen Murray,3,27,7,RW,1992
13722,13,21,Glen Murray,18,81,31,RW,1993
13723,2,22,Glen Murray,5,35,7,LW,1994
13724,15,23,Glen Murray,14,69,29,RW,1995
13725,14,24,Glen Murray,16,77,30,RW,1996
13726,31,25,Glen Murray,29,81,60,RW,1997
13727,15,26,Glen Murray,16,61,31,RW,1998
13728,33,27,Glen Murray,29,78,62,RW,1999
13729,21,28,Glen Murray,18,64,39,RW,2000
13730,30,29,Glen Murray,41,82,71,RW,2001
13731,48,30,Glen Murray,44,82,92,RW,2002
13732,28,31,Glen Murray,32,81,60,RW,2003
13733,29,33,Glen Murray,24,64,53,RW,2005
13734,17,34,Glen Murray,28,59,45,RW,2006
13735,13,35,Glen Murray,17,63,30,RW,2007
13736,6,20,Glen Richardson,3,24,9,LW,1975
13737,12,24,Glen Sather,8,65,20,LW,1967
13738,11,25,Glen Sather,4,76,15,LW,1968
13739,14,26,Glen Sather,12,76,26,LW,1969
13740,3,27,Glen Sather,10,77,13,LW,1970
13741,9,28,Glen Sather,5,76,14,LW,1971
13742,15,29,Glen Sather,11,77,26,LW,1972
13743,29,30,Glen Sather,15,71,44,LW,1973
13744,10,31,Glen Sather,6,63,16,LW,1974
13745,10,32,Glen Sather,9,72,19,LW,1975
13746,34,33,Glen Sather*,19,81,53,LW,1976
13747,34,33,Glen Sather*,19,81,53,LW,1976
13748,4,19,Glen Seabrooke,1,10,5,C,1986
13749,1,20,Glen Seabrooke,0,6,1,LW,1987
13750,1,21,Glen Seabrooke,0,3,1,C,1988
13751,32,20,Glen Sharpley,25,80,57,C,1976
13752,33,21,Glen Sharpley,22,79,55,C,1977
13753,34,22,Glen Sharpley,19,80,53,C,1978
13754,27,23,Glen Sharpley,20,51,47,C,1979
13755,28,24,Glen Sharpley,22,63,50,C,1980
13756,7,25,Glen Sharpley,9,36,16,C,1981
13757,0,26,Glen Shirton,0,4,0,D,1973
13758,0,26,Glen Shirton,0,4,0,D,1973
13759,30,19,Glen Wesley,7,79,37,D,1987
13760,35,20,Glen Wesley,19,77,54,D,1988
13761,27,21,Glen Wesley,9,78,36,D,1989
13762,32,22,Glen Wesley,11,80,43,D,1990
13763,37,23,Glen Wesley,9,78,46,D,1991
13764,25,24,Glen Wesley,8,64,33,D,1992
13765,44,25,Glen Wesley,14,81,58,D,1993
13766,14,26,Glen Wesley,2,48,16,D,1994
13767,16,27,Glen Wesley,8,68,24,D,1995
13768,26,28,Glen Wesley,6,68,32,D,1996
13769,19,29,Glen Wesley,6,82,25,D,1997
13770,17,30,Glen Wesley,7,74,24,D,1998
13771,15,31,Glen Wesley,7,78,22,D,1999
13772,16,32,Glen Wesley,5,71,21,D,2000
13773,13,33,Glen Wesley,5,77,18,D,2001
13774,10,34,Glen Wesley,1,70,11,D,2002
13775,6,35,Glen Wesley,0,74,6,D,2003
13776,8,37,Glen Wesley,2,64,10,D,2005
13777,12,38,Glen Wesley,1,68,13,D,2006
13778,7,39,Glen Wesley,1,78,8,D,2007
13779,23,20,Glenn Anderson,30,58,53,RW,1980
13780,67,21,Glenn Anderson,38,80,105,RW,1981
13781,56,22,Glenn Anderson,48,72,104,RW,1982
13782,45,23,Glenn Anderson,54,80,99,RW,1983
13783,39,24,Glenn Anderson,42,80,81,RW,1984
13784,48,25,Glenn Anderson,54,72,102,RW,1985
13785,38,26,Glenn Anderson,35,80,73,RW,1986
13786,50,27,Glenn Anderson,38,80,88,LW,1987
13787,48,28,Glenn Anderson,16,79,64,RW,1988
13788,38,29,Glenn Anderson,34,73,72,RW,1989
13789,31,30,Glenn Anderson,24,74,55,RW,1990
13790,33,31,Glenn Anderson,24,72,57,RW,1991
13791,43,32,Glenn Anderson,22,76,65,RW,1992
13792,20,33,Glenn Anderson,21,85,41,RW,1993
13793,14,34,Glenn Anderson,12,36,26,RW,1994
13794,8,35,Glenn Anderson,6,32,14,RW,1995
13795,0,20,Glenn Goldup,0,6,0,RW,1973
13796,1,21,Glenn Goldup,0,9,1,RW,1974
13797,0,22,Glenn Goldup,0,3,0,RW,1975
13798,6,23,Glenn Goldup,7,28,13,RW,1976
13799,18,24,Glenn Goldup,14,66,32,RW,1977
13800,22,25,Glenn Goldup,15,73,37,RW,1978
13801,11,26,Glenn Goldup,10,55,21,RW,1979
13802,9,27,Glenn Goldup,6,49,15,RW,1980
13803,0,28,Glenn Goldup,0,2,0,RW,1981
13804,10,20,Glenn Hicks,6,69,16,LW,1978
13805,2,21,Glenn Hicks,1,50,3,LW,1979
13806,10,22,Glenn Hicks,5,58,15,LW,1980
13807,0,23,Glenn Johannesen,0,2,0,D,1985
13808,0,22,Glenn Merkosky,0,7,0,C,1981
13809,10,23,Glenn Merkosky,4,34,14,C,1982
13810,0,24,Glenn Merkosky,1,5,1,C,1983
13811,2,26,Glenn Merkosky,0,17,2,C,1985
13812,0,30,Glenn Merkosky,0,3,0,C,1989
13813,0,24,Glenn Mulvenna,0,1,0,C,1991
13814,0,25,Glenn Mulvenna,0,1,0,C,1992
13815,0,23,Glenn Patrick,0,1,0,D,1973
13816,0,24,Glenn Patrick,0,2,0,D,1974
13817,3,26,Glenn Patrick,2,35,5,D,1976
13818,4,26,Glenn Patrick,0,23,4,D,1976
13819,0,25,Glenn Tomalty,0,1,0,D,1979
13820,0,23,Goran Bezina,0,3,0,D,2003
13821,0,21,Gord Brooks,0,2,0,RW,1971
13822,8,23,Gord Brooks,6,30,14,RW,1973
13823,10,24,Gord Brooks,1,38,11,RW,1974
13824,0,20,Gord Buynak,0,4,0,D,1974
13825,0,20,Gord Dineen,0,2,0,D,1982
13826,11,21,Gord Dineen,1,43,12,D,1983
13827,12,22,Gord Dineen,1,48,13,D,1984
13828,8,23,Gord Dineen,1,57,9,D,1985
13829,10,24,Gord Dineen,4,71,14,D,1986
13830,13,25,Gord Dineen,5,70,18,D,1987
13831,3,26,Gord Dineen,1,40,4,D,1988
13832,8,27,Gord Dineen,1,69,9,D,1989
13833,0,28,Gord Dineen,0,9,0,D,1990
13834,0,29,Gord Dineen,0,1,0,D,1991
13835,4,30,Gord Dineen,2,32,6,D,1992
13836,21,31,Gord Dineen,0,77,21,D,1993
13837,0,32,Gord Dineen,0,9,0,D,1994
13838,5,21,Gord Donnelly,0,38,5,D,1983
13839,0,22,Gord Donnelly,0,22,0,D,1984
13840,2,23,Gord Donnelly,2,36,4,D,1985
13841,2,24,Gord Donnelly,0,38,2,RW,1986
13842,3,25,Gord Donnelly,4,63,7,RW,1987
13843,10,26,Gord Donnelly,10,73,20,RW,1988
13844,3,27,Gord Donnelly,3,55,6,RW,1989
13845,4,28,Gord Donnelly,3,57,7,RW,1990
13846,3,29,Gord Donnelly,2,71,5,D,1991
13847,8,30,Gord Donnelly,3,60,11,D,1992
13848,1,31,Gord Donnelly,0,25,1,D,1993
13849,0,32,Gord Donnelly,1,16,1,RW,1994
13850,15,23,Gord Gallant,7,72,22,LW,1973
13851,13,24,Gord Gallant,10,66,23,LW,1974
13852,15,25,Gord Gallant,4,64,19,LW,1975
13853,15,25,Gord Gallant,4,64,19,LW,1975
13854,16,26,Gord Gallant,10,71,26,LW,1976
13855,3,26,Gord Gallant,6,37,9,LW,1976
13856,13,26,Gord Gallant,4,34,17,LW,1976
13857,16,26,Gord Gallant,10,71,26,LW,1976
13858,3,26,Gord Gallant,6,37,9,LW,1976
13859,13,26,Gord Gallant,4,34,17,LW,1976
13860,0,23,Gord Hampson,0,4,0,LW,1982
13861,5,25,Gord Hynes,0,15,5,D,1991
13862,4,26,Gord Hynes,3,37,7,D,1992
13863,1,22,Gord Kannegiesser,0,19,1,D,1967
13864,0,26,Gord Kannegiesser,0,4,0,D,1971
13865,10,27,Gord Kannegiesser,0,45,10,D,1972
13866,10,27,Gord Kannegiesser,0,45,10,D,1972
13867,20,28,Gord Kannegiesser,0,78,20,D,1973
13868,20,28,Gord Kannegiesser,0,78,20,D,1973
13869,4,29,Gord Kannegiesser,1,4,5,D,1974
13870,4,29,Gord Kannegiesser,1,4,5,D,1974
13871,6,18,Gord Kluzak,1,70,7,D,1982
13872,27,19,Gord Kluzak,10,80,37,D,1983
13873,31,21,Gord Kluzak,8,70,39,D,1985
13874,31,23,Gord Kluzak,6,66,37,D,1987
13875,1,24,Gord Kluzak,0,3,1,D,1988
13876,2,25,Gord Kluzak,0,8,2,D,1989
13877,0,26,Gord Kluzak,0,2,0,D,1990
13878,0,21,Gord Kruppke,0,4,0,D,1990
13879,0,23,Gord Kruppke,0,10,0,D,1992
13880,0,24,Gord Kruppke,0,9,0,D,1993
13881,27,28,Gord Labossiere,13,68,40,C,1967
13882,18,29,Gord Labossiere,10,48,28,C,1968
13883,14,31,Gord Labossiere,19,74,33,C,1970
13884,3,32,Gord Labossiere,2,9,5,C,1971
13885,60,33,Gord Labossiere,36,78,96,C,1972
13886,60,33,Gord Labossiere,36,78,96,C,1972
13887,36,34,Gord Labossiere,19,67,55,C,1973
13888,36,34,Gord Labossiere,19,67,55,C,1973
13889,34,35,Gord Labossiere,23,76,57,C,1974
13890,34,35,Gord Labossiere,23,76,57,C,1974
13891,32,36,Gord Labossiere,23,80,55,C,1975
13892,32,36,Gord Labossiere,23,80,55,C,1975
13893,0,22,Gord Lane,1,3,1,D,1975
13894,15,23,Gord Lane,2,80,17,D,1976
13895,9,24,Gord Lane,2,69,11,D,1977
13896,15,25,Gord Lane,3,64,18,D,1978
13897,18,26,Gord Lane,4,74,22,D,1979
13898,9,27,Gord Lane,3,60,12,D,1980
13899,13,28,Gord Lane,0,51,13,D,1981
13900,4,29,Gord Lane,3,44,7,D,1982
13901,3,30,Gord Lane,0,37,3,D,1983
13902,8,31,Gord Lane,1,57,9,D,1984
13903,0,24,Gord McTavish,0,1,0,C,1978
13904,3,25,Gord McTavish,1,10,4,C,1979
13905,31,21,Gord Murphy,4,75,35,D,1988
13906,27,22,Gord Murphy,14,75,41,D,1989
13907,31,23,Gord Murphy,11,80,42,D,1990
13908,14,24,Gord Murphy,5,73,19,D,1991
13909,12,25,Gord Murphy,5,49,17,D,1992
13910,29,26,Gord Murphy,14,84,43,D,1993
13911,16,27,Gord Murphy,6,46,22,D,1994
13912,22,28,Gord Murphy,8,70,30,D,1995
13913,15,29,Gord Murphy,8,80,23,D,1996
13914,11,30,Gord Murphy,6,79,17,D,1997
13915,7,31,Gord Murphy,0,51,7,D,1998
13916,10,32,Gord Murphy,1,58,11,D,1999
13917,11,33,Gord Murphy,3,27,14,D,2000
13918,2,34,Gord Murphy,0,15,2,D,2001
13919,0,20,Gord Sherven,1,2,1,C,1983
13920,19,21,Gord Sherven,11,69,30,RW,1984
13921,3,22,Gord Sherven,1,18,4,C,1985
13922,0,23,Gord Sherven,0,7,0,C,1986
13923,0,24,Gord Sherven,0,1,0,C,1987
13924,8,25,Gord Smith,3,63,11,D,1974
13925,2,26,Gord Smith,1,25,3,D,1975
13926,12,27,Gord Smith,1,79,13,D,1976
13927,7,28,Gord Smith,4,80,11,D,1977
13928,1,29,Gord Smith,0,39,1,D,1978
13929,0,30,Gord Smith,0,13,0,D,1979
13930,1,21,Gord Titcomb,0,2,1,LW,1974
13931,1,21,Gord Titcomb,0,2,1,LW,1974
13932,0,21,Gord Walker,1,1,1,LW,1986
13933,4,22,Gord Walker,1,18,5,LW,1987
13934,0,23,Gord Walker,1,11,1,RW,1988
13935,0,24,Gord Walker,0,1,0,RW,1989
13936,0,21,Gord Wappel,0,2,0,D,1979
13937,1,22,Gord Wappel,0,7,1,D,1980
13938,0,23,Gord Wappel,1,11,1,D,1981
13939,0,21,Gord Williams,0,1,0,RW,1981
13940,0,22,Gord Williams,0,1,0,RW,1982
13941,0,22,Gordie Clark,0,1,0,RW,1974
13942,1,23,Gordie Clark,0,7,1,RW,1975
13943,3,26,Gordie Clark,3,21,6,RW,1978
13944,3,26,Gordie Clark,3,21,6,RW,1978
13945,1,22,Gordie Dwyer,0,24,1,LW,1999
13946,1,23,Gordie Dwyer,0,28,1,LW,2000
13947,2,24,Gordie Dwyer,0,26,2,LW,2001
13948,1,25,Gordie Dwyer,0,28,1,LW,2002
13949,0,26,Gordie Dwyer,0,2,0,LW,2003
13950,43,39,Gordie Howe,39,74,82,RW,1967
13951,59,40,Gordie Howe,44,76,103,RW,1968
13952,40,41,Gordie Howe,31,76,71,RW,1969
13953,29,42,Gordie Howe,23,63,52,RW,1970
13954,26,51,Gordie Howe,15,80,41,RW,1979
13955,69,45,Gordie Howe*,31,70,100,RW,1973
13956,69,45,Gordie Howe*,31,70,100,RW,1973
13957,65,46,Gordie Howe*,34,75,99,RW,1974
13958,65,46,Gordie Howe*,34,75,99,RW,1974
13959,70,47,Gordie Howe*,32,78,102,RW,1975
13960,70,47,Gordie Howe*,32,78,102,RW,1975
13961,44,48,Gordie Howe*,24,62,68,RW,1976
13962,44,48,Gordie Howe*,24,62,68,RW,1976
13963,62,49,Gordie Howe*,34,76,96,RW,1977
13964,62,49,Gordie Howe*,34,76,96,RW,1977
13965,24,50,Gordie Howe*,19,58,43,RW,1978
13966,24,50,Gordie Howe*,19,58,43,RW,1978
13967,0,22,Gordie Nelson,0,3,0,D,1969
13968,19,18,Gordie Roberts,3,77,22,D,1975
13969,19,18,Gordie Roberts,3,77,22,D,1975
13970,33,19,Gordie Roberts,13,77,46,D,1976
13971,33,19,Gordie Roberts,13,77,46,D,1976
13972,46,20,Gordie Roberts,15,78,61,D,1977
13973,46,20,Gordie Roberts,15,78,61,D,1977
13974,46,21,Gordie Roberts,11,79,57,D,1978
13975,46,21,Gordie Roberts,11,79,57,D,1978
13976,28,22,Gordie Roberts,8,80,36,D,1979
13977,42,23,Gordie Roberts,8,77,50,D,1980
13978,30,24,Gordie Roberts,4,79,34,D,1981
13979,41,25,Gordie Roberts,3,80,44,D,1982
13980,45,26,Gordie Roberts,8,77,53,D,1983
13981,36,27,Gordie Roberts,6,78,42,D,1984
13982,21,28,Gordie Roberts,2,76,23,D,1985
13983,10,29,Gordie Roberts,3,67,13,D,1986
13984,15,30,Gordie Roberts,3,70,18,D,1987
13985,24,31,Gordie Roberts,2,77,26,D,1988
13986,14,32,Gordie Roberts,3,75,17,D,1989
13987,13,33,Gordie Roberts,3,64,16,D,1990
13988,22,34,Gordie Roberts,2,73,24,D,1991
13989,12,35,Gordie Roberts,5,65,17,D,1992
13990,6,36,Gordie Roberts,1,59,7,D,1993
13991,5,22,Gordon Mark,3,36,8,D,1986
13992,2,23,Gordon Mark,0,19,2,D,1987
13993,1,29,Gordon Mark,0,12,1,D,1993
13994,2,30,Gordon Mark,0,18,2,D,1994
13995,0,21,Graeme Nicolson,0,1,0,D,1978
13996,7,24,Graeme Nicolson,2,41,9,D,1981
13997,0,25,Graeme Nicolson,0,10,0,D,1982
13998,0,24,Graeme Townshend,0,4,0,RW,1989
13999,5,25,Graeme Townshend,2,18,7,RW,1990
14000,2,26,Graeme Townshend,1,7,3,RW,1991
14001,0,27,Graeme Townshend,0,2,0,RW,1992
14002,0,28,Graeme Townshend,0,14,0,RW,1993
14003,0,24,Graham Mink,0,2,0,C,2003
14004,0,26,Graham Mink,0,3,0,C,2005
14005,0,29,Graham Mink,0,2,0,LW,2008
14006,2,24,Grant Clitsome,1,11,3,D,2009
14007,15,25,Grant Clitsome,4,31,19,D,2010
14008,13,26,Grant Clitsome,4,63,17,D,2011
14009,12,27,Grant Clitsome,4,44,16,D,2012
14010,10,28,Grant Clitsome,2,32,12,D,2013
14011,4,29,Grant Clitsome,0,24,4,D,2014
14012,0,21,Grant Erickson,1,2,1,LW,1968
14013,0,22,Grant Erickson,0,4,0,LW,1969
14014,29,25,Grant Erickson,15,77,44,LW,1972
14015,29,25,Grant Erickson,15,77,44,LW,1972
14016,27,26,Grant Erickson,23,78,50,LW,1973
14017,27,26,Grant Erickson,23,78,50,LW,1973
14018,15,27,Grant Erickson,12,78,27,LW,1974
14019,15,27,Grant Erickson,12,78,27,LW,1974
14020,7,28,Grant Erickson,4,33,11,LW,1975
14021,7,28,Grant Erickson,4,33,11,LW,1975
14022,10,23,Grant Jennings,3,55,13,D,1988
14023,6,24,Grant Jennings,3,64,9,D,1989
14024,7,25,Grant Jennings,2,57,9,D,1990
14025,5,26,Grant Jennings,4,53,9,D,1991
14026,5,27,Grant Jennings,0,58,5,D,1992
14027,4,28,Grant Jennings,2,61,6,D,1993
14028,6,29,Grant Jennings,0,35,6,D,1994
14029,0,30,Grant Jennings,0,6,0,D,1995
14030,12,23,Grant Ledyard,8,42,20,D,1984
14031,27,24,Grant Ledyard,9,79,36,D,1985
14032,23,25,Grant Ledyard,14,67,37,D,1986
14033,10,26,Grant Ledyard,5,44,15,D,1987
14034,16,27,Grant Ledyard,4,74,20,D,1988
14035,13,28,Grant Ledyard,2,67,15,D,1989
14036,23,29,Grant Ledyard,8,60,31,D,1990
14037,16,30,Grant Ledyard,5,50,21,D,1991
14038,14,31,Grant Ledyard,2,50,16,D,1992
14039,37,32,Grant Ledyard,9,84,46,D,1993
14040,13,33,Grant Ledyard,5,38,18,D,1994
14041,19,34,Grant Ledyard,5,73,24,D,1995
14042,15,35,Grant Ledyard,1,67,16,D,1996
14043,20,36,Grant Ledyard,4,71,24,D,1997
14044,8,37,Grant Ledyard,4,47,12,D,1998
14045,4,38,Grant Ledyard,2,40,6,D,1999
14046,3,39,Grant Ledyard,2,22,5,D,2000
14047,3,40,Grant Ledyard,1,53,4,D,2001
14048,0,24,Grant Lewis,0,1,0,D,2008
14049,1,21,Grant Marshall,0,2,1,RW,1994
14050,19,22,Grant Marshall,9,70,28,RW,1995
14051,4,23,Grant Marshall,6,56,10,RW,1996
14052,10,24,Grant Marshall,9,72,19,RW,1997
14053,18,25,Grant Marshall,13,82,31,RW,1998
14054,6,26,Grant Marshall,2,45,8,RW,1999
14055,24,27,Grant Marshall,13,75,37,RW,2000
14056,18,28,Grant Marshall,15,81,33,RW,2001
14057,23,29,Grant Marshall,9,76,32,RW,2002
14058,7,30,Grant Marshall,8,65,15,RW,2003
14059,17,32,Grant Marshall,8,76,25,RW,2005
14060,2,21,Grant Martin,0,12,2,C,1983
14061,1,22,Grant Martin,0,12,1,LW,1984
14062,1,23,Grant Martin,0,11,1,C,1985
14063,0,24,Grant Martin,0,9,0,C,1986
14064,0,20,Grant McNeill,0,3,0,D,2003
14065,4,18,Grant Mulvey,7,74,11,RW,1974
14066,17,19,Grant Mulvey,11,64,28,RW,1975
14067,14,20,Grant Mulvey,10,80,24,RW,1976
14068,24,21,Grant Mulvey,14,78,38,RW,1977
14069,15,22,Grant Mulvey,19,80,34,RW,1978
14070,26,23,Grant Mulvey,39,80,65,RW,1979
14071,14,24,Grant Mulvey,18,42,32,RW,1980
14072,19,25,Grant Mulvey,30,73,49,RW,1981
14073,0,26,Grant Mulvey,0,3,0,RW,1982
14074,2,27,Grant Mulvey,1,12,3,RW,1983
14075,0,19,Grant Sasser,0,3,0,C,1983
14076,12,24,Grant Stevenson,10,47,22,C,2005
14077,0,24,Greg Andrusak,0,3,0,D,1993
14078,4,25,Greg Andrusak,0,7,4,D,1994
14079,0,26,Greg Andrusak,0,2,0,D,1995
14080,1,29,Greg Andrusak,0,7,1,D,1998
14081,1,30,Greg Andrusak,0,9,1,D,1999
14082,0,23,Greg Britz,0,6,0,RW,1983
14083,0,24,Greg Britz,0,1,0,RW,1984
14084,0,26,Greg Britz,0,1,0,RW,1986
14085,2,22,Greg Brown,1,39,3,D,1990
14086,1,24,Greg Brown,0,10,1,D,1992
14087,8,25,Greg Brown,3,36,11,D,1993
14088,3,26,Greg Brown,0,9,3,D,1994
14089,0,20,Greg C Adams,3,6,3,LW,1980
14090,15,21,Greg C Adams,4,33,19,LW,1981
14091,13,22,Greg C Adams,10,79,23,LW,1982
14092,6,23,Greg C Adams,2,57,8,LW,1983
14093,12,24,Greg C Adams,6,51,18,LW,1984
14094,38,25,Greg C Adams,18,78,56,LW,1985
14095,30,26,Greg C Adams,14,67,44,LW,1986
14096,12,27,Greg C Adams,15,78,27,LW,1987
14097,7,28,Greg C Adams,8,61,15,LW,1988
14098,10,29,Greg C Adams,4,35,14,LW,1989
14099,39,20,Greg Carroll,15,77,54,C,1976
14100,39,20,Greg Carroll,15,77,54,C,1976
14101,27,21,Greg Carroll,15,74,42,C,1977
14102,14,21,Greg Carroll,9,48,23,C,1977
14103,13,21,Greg Carroll,6,26,19,C,1977
14104,27,21,Greg Carroll,15,74,42,C,1977
14105,14,21,Greg Carroll,9,48,23,C,1977
14106,13,21,Greg Carroll,6,26,19,C,1977
14107,15,22,Greg Carroll,7,60,22,C,1978
14108,19,23,Greg Carroll,13,71,32,C,1979
14109,4,23,Greg Classen,2,27,6,C,2000
14110,6,24,Greg Classen,5,55,11,C,2001
14111,0,25,Greg Classen,0,8,0,C,2002
14112,0,24,Greg Crozier,0,1,0,LW,2000
14113,9,21,Greg D Adams,12,36,21,C,1984
14114,42,22,Greg D Adams,35,78,77,C,1985
14115,27,23,Greg D Adams,20,72,47,C,1986
14116,40,24,Greg D Adams,36,80,76,C,1987
14117,14,25,Greg D Adams,19,61,33,LW,1988
14118,20,26,Greg D Adams,30,65,50,LW,1989
14119,24,27,Greg D Adams,21,55,45,LW,1990
14120,27,28,Greg D Adams,30,76,57,LW,1991
14121,31,29,Greg D Adams,25,53,56,LW,1992
14122,24,30,Greg D Adams,13,68,37,LW,1993
14123,13,31,Greg D Adams,8,43,21,LW,1994
14124,21,32,Greg D Adams,22,66,43,LW,1995
14125,15,33,Greg D Adams,21,50,36,LW,1996
14126,18,34,Greg D Adams,14,49,32,LW,1997
14127,24,35,Greg D Adams,19,75,43,LW,1998
14128,27,36,Greg D Adams,19,69,46,LW,1999
14129,12,37,Greg D Adams,11,60,23,LW,2000
14323,1,23,Greg de Vries,1,13,2,D,1995
14324,4,24,Greg de Vries,0,37,4,D,1996
14325,4,25,Greg de Vries,7,65,11,D,1997
14326,3,26,Greg de Vries,1,73,4,D,1998
14327,7,27,Greg de Vries,2,69,9,D,1999
14328,12,28,Greg de Vries,5,79,17,D,2000
14329,12,29,Greg de Vries,8,82,20,D,2001
14330,26,30,Greg de Vries,6,82,32,D,2002
14331,13,31,Greg de Vries,3,66,16,D,2003
14332,28,33,Greg de Vries,7,82,35,D,2005
14333,21,34,Greg de Vries,3,82,24,D,2006
14334,11,35,Greg de Vries,4,77,15,D,2007
14335,4,36,Greg de Vries,1,71,5,D,2008
14130,2,24,Greg Fox,1,16,3,D,1977
14131,17,25,Greg Fox,0,78,17,D,1978
14132,11,26,Greg Fox,4,71,15,D,1979
14133,16,27,Greg Fox,3,75,19,D,1980
14134,19,28,Greg Fox,2,79,21,D,1981
14135,12,29,Greg Fox,0,76,12,D,1982
14136,10,30,Greg Fox,2,73,12,D,1983
14137,5,31,Greg Fox,2,26,7,D,1984
14138,0,20,Greg Gilbert,1,1,1,LW,1981
14139,11,21,Greg Gilbert,8,45,19,LW,1982
14140,35,22,Greg Gilbert,31,79,66,LW,1983
14141,25,23,Greg Gilbert,13,58,38,LW,1984
14142,19,24,Greg Gilbert,9,60,28,LW,1985
14143,7,25,Greg Gilbert,6,51,13,LW,1986
14144,28,26,Greg Gilbert,17,76,45,LW,1987
14145,13,27,Greg Gilbert,8,59,21,LW,1988
14146,25,28,Greg Gilbert,12,70,37,LW,1989
14147,15,29,Greg Gilbert,10,72,25,LW,1990
14148,5,30,Greg Gilbert,7,50,12,LW,1991
14149,19,31,Greg Gilbert,13,77,32,LW,1992
14150,11,32,Greg Gilbert,4,76,15,LW,1993
14151,14,33,Greg Gilbert,11,46,25,LW,1994
14152,1,34,Greg Gilbert,0,17,1,LW,1995
14153,0,19,Greg Hawgood,0,1,0,D,1987
14154,24,20,Greg Hawgood,16,56,40,D,1988
14155,27,21,Greg Hawgood,11,77,38,D,1989
14156,1,22,Greg Hawgood,0,6,1,D,1990
14157,11,23,Greg Hawgood,2,20,13,D,1991
14158,35,24,Greg Hawgood,11,69,46,D,1992
14159,28,25,Greg Hawgood,6,64,34,D,1993
14160,4,26,Greg Hawgood,1,21,5,D,1994
14161,12,28,Greg Hawgood,6,63,18,D,1996
14162,17,31,Greg Hawgood,5,79,22,D,1999
14163,5,32,Greg Hawgood,2,16,7,D,2000
14164,0,33,Greg Hawgood,0,2,0,D,2001
14165,0,22,Greg Hickey,0,1,0,LW,1977
14166,0,21,Greg Holst,0,2,0,C,1975
14167,0,22,Greg Holst,0,5,0,C,1976
14168,0,23,Greg Holst,0,4,0,C,1977
14169,10,23,Greg Hotham,3,46,13,D,1979
14170,1,24,Greg Hotham,1,11,2,D,1980
14171,6,25,Greg Hotham,4,28,10,D,1981
14172,30,26,Greg Hotham,2,58,32,D,1982
14173,25,27,Greg Hotham,5,76,30,D,1983
14174,2,28,Greg Hotham,0,11,2,D,1984
14175,8,24,Greg Hubick,6,72,14,D,1975
14176,1,28,Greg Hubick,0,5,1,D,1979
14177,1,23,Greg Jacina,0,11,1,C,2005
14178,0,24,Greg Jacina,0,3,0,C,2006
14179,11,22,Greg Johnson,6,52,17,C,1993
14180,5,23,Greg Johnson,3,22,8,C,1994
14181,22,24,Greg Johnson,18,60,40,LW,1995
14182,19,25,Greg Johnson,13,75,32,RW,1996
14183,22,26,Greg Johnson,12,74,34,C,1997
14184,34,27,Greg Johnson,16,68,50,C,1998
14185,33,28,Greg Johnson,11,82,44,C,1999
14186,17,29,Greg Johnson,15,82,32,C,2000
14187,26,30,Greg Johnson,18,82,44,C,2001
14188,9,31,Greg Johnson,8,38,17,C,2002
14189,18,32,Greg Johnson,14,82,32,C,2003
14190,8,34,Greg Johnson,11,68,19,C,2005
14191,1,19,Greg Johnston,2,15,3,RW,1983
14192,0,20,Greg Johnston,0,6,0,RW,1984
14193,2,21,Greg Johnston,0,20,2,RW,1985
14194,15,22,Greg Johnston,12,76,27,RW,1986
14195,9,24,Greg Johnston,11,57,20,RW,1988
14196,1,25,Greg Johnston,1,9,2,RW,1989
14197,0,26,Greg Johnston,0,1,0,RW,1990
14198,1,27,Greg Johnston,0,3,1,RW,1991
14199,7,20,Greg Joly,1,44,8,D,1974
14200,17,21,Greg Joly,8,54,25,D,1975
14201,11,22,Greg Joly,1,53,12,D,1976
14202,20,23,Greg Joly,7,79,27,D,1977
14203,4,24,Greg Joly,0,20,4,D,1978
14204,10,25,Greg Joly,3,59,13,D,1979
14205,2,26,Greg Joly,0,17,2,D,1980
14206,5,27,Greg Joly,1,37,6,D,1981
14207,0,28,Greg Joly,0,2,0,D,1982
14208,0,25,Greg Koehler,0,1,0,C,2000
14209,0,22,Greg Kuznik,0,1,0,D,2000
14210,0,23,Greg Leeb,0,2,0,C,2000
14211,19,20,Greg Malone,18,66,37,C,1976
14212,43,21,Greg Malone,18,78,61,C,1977
14213,30,22,Greg Malone,35,80,65,C,1978
14214,32,23,Greg Malone,19,51,51,C,1979
14215,29,24,Greg Malone,21,62,50,C,1980
14216,24,25,Greg Malone,15,78,39,C,1981
14217,44,26,Greg Malone,17,80,61,C,1982
14218,37,27,Greg Malone,17,78,54,C,1983
14219,39,28,Greg Malone,22,76,61,C,1984
14220,12,29,Greg Malone,9,49,21,C,1985
14221,1,30,Greg Malone,0,6,1,C,1986
14222,0,21,Greg Mauldin,0,6,0,C,2003
14223,0,27,Greg Mauldin,0,1,0,C,2009
14224,5,28,Greg Mauldin,5,29,10,C,2010
14225,0,21,Greg McKegg,0,1,0,C,2013
14226,0,22,Greg McKegg,0,3,0,C,2014
14227,0,23,Greg McKegg,2,15,2,C,2015
14228,1,24,Greg McKegg,0,15,1,C,2016
14229,2,25,Greg McKegg,2,26,4,C,2017
14230,0,22,Greg Meredith,1,3,1,RW,1980
14231,4,24,Greg Meredith,5,35,9,RW,1982
14232,0,23,Greg Moore,0,6,0,RW,2007
14233,0,25,Greg Moore,0,4,0,RW,2009
14234,1,20,Greg Neeld,0,17,1,D,1975
14235,1,20,Greg Neeld,0,17,1,D,1975
14236,1,20,Greg Nemisz,0,6,1,C,2010
14237,0,21,Greg Nemisz,0,9,0,C,2011
14238,0,23,Greg Pankewicz,0,3,0,RW,1993
14239,3,28,Greg Pankewicz,0,18,3,RW,1998
14240,2,23,Greg Parks,1,20,3,C,1990
14241,0,24,Greg Parks,0,1,0,C,1991
14242,0,25,Greg Parks,0,2,0,C,1992
14243,10,22,Greg Paslawski,9,60,19,RW,1983
14244,20,23,Greg Paslawski,22,72,42,RW,1984
14245,11,24,Greg Paslawski,22,56,33,RW,1985
14246,35,25,Greg Paslawski,29,76,64,RW,1986
14247,1,26,Greg Paslawski,2,17,3,RW,1987
14248,26,27,Greg Paslawski,26,75,52,RW,1988
14249,30,28,Greg Paslawski,18,71,48,RW,1989
14250,11,29,Greg Paslawski,11,55,22,RW,1990
14251,17,30,Greg Paslawski,28,80,45,RW,1991
14252,24,31,Greg Paslawski,18,73,42,RW,1992
14253,0,32,Greg Paslawski,2,15,2,RW,1993
14254,0,22,Greg Pateryn,0,3,0,D,2012
14255,0,24,Greg Pateryn,0,17,0,D,2014
14256,6,25,Greg Pateryn,1,38,7,D,2015
14257,3,26,Greg Pateryn,0,12,3,D,2016
14258,12,27,Greg Pateryn,1,73,13,D,2017
14259,15,20,Greg Polis,18,61,33,LW,1970
14260,19,21,Greg Polis,30,76,49,LW,1971
14261,23,22,Greg Polis,26,78,49,LW,1972
14262,25,23,Greg Polis,22,78,47,LW,1973
14263,15,24,Greg Polis,26,76,41,LW,1974
14264,21,25,Greg Polis,15,79,36,LW,1975
14265,23,26,Greg Polis,16,77,39,LW,1976
14266,16,27,Greg Polis,7,37,23,LW,1977
14267,7,28,Greg Polis,13,25,20,LW,1978
14268,5,29,Greg Polis,1,28,6,LW,1979
14269,0,30,Greg Rallo,0,1,0,C,2011
14270,0,31,Greg Rallo,1,10,1,C,2012
14271,1,20,Greg Smith,0,1,1,D,1975
14272,17,21,Greg Smith,9,74,26,D,1976
14273,30,22,Greg Smith,7,80,37,D,1977
14274,27,23,Greg Smith,5,80,32,D,1978
14275,13,24,Greg Smith,5,55,18,D,1979
14276,21,25,Greg Smith,5,74,26,D,1980
14277,22,26,Greg Smith,10,69,32,D,1981
14278,26,27,Greg Smith,4,73,30,D,1982
14279,20,28,Greg Smith,3,75,23,D,1983
14280,18,29,Greg Smith,2,73,20,D,1984
14281,22,30,Greg Smith,5,76,27,D,1985
14282,9,31,Greg Smith,0,45,9,D,1986
14283,6,32,Greg Smith,1,54,7,D,1987
14284,0,20,Greg Smyth,0,1,0,D,1986
14285,6,21,Greg Smyth,1,48,7,D,1987
14286,1,22,Greg Smyth,0,10,1,D,1988
14287,0,23,Greg Smyth,0,13,0,D,1989
14288,0,24,Greg Smyth,0,1,0,D,1990
14289,3,25,Greg Smyth,1,36,4,D,1991
14290,2,26,Greg Smyth,1,35,3,D,1992
14291,1,27,Greg Smyth,1,61,2,D,1993
14292,3,28,Greg Smyth,0,22,3,D,1994
14293,0,30,Greg Smyth,0,2,0,D,1996
14294,0,21,Greg Stewart,0,1,0,LW,2007
14295,1,22,Greg Stewart,0,20,1,LW,2008
14296,0,23,Greg Stewart,0,5,0,LW,2009
14297,5,21,Greg Tebbutt,2,38,7,D,1978
14298,5,21,Greg Tebbutt,2,38,7,D,1978
14299,1,22,Greg Tebbutt,0,2,1,D,1979
14300,2,26,Greg Tebbutt,0,24,2,D,1983
14301,25,20,Greg Terrion,12,73,37,LW,1980
14302,22,21,Greg Terrion,15,61,37,LW,1981
14303,16,22,Greg Terrion,16,74,32,LW,1982
14304,24,23,Greg Terrion,15,79,39,LW,1983
14305,17,24,Greg Terrion,14,72,31,LW,1984
14306,22,25,Greg Terrion,10,76,32,LW,1985
14307,8,26,Greg Terrion,7,67,15,LW,1986
14308,16,27,Greg Terrion,4,59,20,LW,1987
14309,1,20,Greg Theberge,0,12,1,D,1979
14310,0,21,Greg Theberge,1,1,1,D,1980
14311,32,22,Greg Theberge,5,57,37,D,1981
14312,28,23,Greg Theberge,8,70,36,D,1982
14313,2,24,Greg Theberge,1,13,3,D,1983
14314,0,21,Greg Vaydik,0,5,0,C,1976
14315,2,25,Greg Zanon,0,4,2,D,2005
14316,5,26,Greg Zanon,3,66,8,D,2006
14317,5,27,Greg Zanon,0,78,5,D,2007
14318,7,28,Greg Zanon,4,82,11,D,2008
14319,13,29,Greg Zanon,2,81,15,D,2009
14320,7,30,Greg Zanon,0,82,7,D,2010
14321,5,31,Greg Zanon,3,56,8,D,2011
14322,6,32,Greg Zanon,0,44,6,D,2012
14336,5,22,Gregg Boddy,2,40,7,D,1971
14337,11,23,Gregg Boddy,3,74,14,D,1972
14338,10,24,Gregg Boddy,2,53,12,D,1973
14339,12,25,Gregg Boddy,11,72,23,D,1974
14340,6,26,Gregg Boddy,5,34,11,D,1975
14341,19,27,Gregg Boddy,2,64,21,D,1976
14342,17,27,Gregg Boddy,1,46,18,D,1976
14343,2,27,Gregg Boddy,1,18,3,D,1976
14344,19,27,Gregg Boddy,2,64,21,D,1976
14345,17,27,Gregg Boddy,1,46,18,D,1976
14346,2,27,Gregg Boddy,1,18,3,D,1976
14347,26,23,Gregg Sheppard,24,64,50,C,1972
14348,31,24,Gregg Sheppard,16,75,47,C,1973
14349,48,25,Gregg Sheppard,30,76,78,C,1974
14350,43,26,Gregg Sheppard,31,70,74,C,1975
14351,36,27,Gregg Sheppard,31,77,67,C,1976
14352,36,28,Gregg Sheppard,23,54,59,C,1977
14353,22,29,Gregg Sheppard,15,60,37,C,1978
14354,24,30,Gregg Sheppard,13,76,37,LW,1979
14355,17,31,Gregg Sheppard,11,47,28,C,1980
14356,10,32,Gregg Sheppard,11,58,21,C,1981
14357,0,20,Gregory Campbell,0,2,0,LW,2003
14358,6,22,Gregory Campbell,3,64,9,C,2005
14359,3,23,Gregory Campbell,6,79,9,C,2006
14360,13,24,Gregory Campbell,5,81,18,C,2007
14361,19,25,Gregory Campbell,13,77,32,C,2008
14362,15,26,Gregory Campbell,2,60,17,C,2009
14363,16,27,Gregory Campbell,13,80,29,C,2010
14364,8,28,Gregory Campbell,8,78,16,C,2011
14365,9,29,Gregory Campbell,4,48,13,C,2012
14366,13,30,Gregory Campbell,8,82,21,C,2013
14367,6,31,Gregory Campbell,6,70,12,C,2014
14368,8,32,Gregory Campbell,3,82,11,C,2015
14369,0,23,Griffen Molino,0,5,0,C,2016
14370,1,21,Griffin Reinhart,0,8,1,D,2014
14371,1,22,Griffin Reinhart,0,29,1,D,2015
14372,6,20,Grigori Panteleev,8,39,14,LW,1992
14373,0,21,Grigori Panteleev,0,10,0,LW,1993
14374,0,22,Grigori Panteleev,0,1,0,LW,1994
14375,0,23,Grigori Panteleev,0,4,0,LW,1995
14376,0,24,Guillaume Desbiens,0,1,0,D,2009
14377,0,25,Guillaume Desbiens,0,12,0,D,2010
14378,0,26,Guillaume Desbiens,0,10,0,D,2011
14379,13,19,Guillaume Latendresse,16,80,29,RW,2006
14380,11,20,Guillaume Latendresse,16,73,27,RW,2007
14381,12,21,Guillaume Latendresse,14,56,26,RW,2008
14382,13,22,Guillaume Latendresse,27,78,40,RW,2009
14383,3,23,Guillaume Latendresse,3,11,6,RW,2010
14384,4,24,Guillaume Latendresse,5,16,9,RW,2011
14385,4,25,Guillaume Latendresse,6,27,10,RW,2012
14386,0,20,Guillaume Lefebvre,0,3,0,LW,2001
14387,4,21,Guillaume Lefebvre,2,26,6,LW,2002
14388,0,24,Guillaume Lefebvre,0,9,0,LW,2005
14389,0,28,Guillaume Lefebvre,0,1,0,LW,2009
14390,3,20,Gustav Forsling,2,38,5,D,2016
14391,10,21,Gustav Forsling,3,41,13,D,2017
14392,6,22,Gustav Nyquist,1,18,7,RW,2011
14393,3,23,Gustav Nyquist,3,22,6,RW,2012
14394,20,24,Gustav Nyquist,28,57,48,RW,2013
14395,27,25,Gustav Nyquist,27,82,54,RW,2014
14396,26,26,Gustav Nyquist,17,82,43,RW,2015
14397,36,27,Gustav Nyquist,12,76,48,RW,2016
14398,19,28,Gustav Nyquist,21,82,40,RW,2017
14399,0,21,Gustav Olofsson,0,2,0,D,2015
14400,3,22,Gustav Olofsson,0,13,3,D,2016
14401,8,23,Gustav Olofsson,0,41,8,D,2017
14402,1,20,Guy Carbonneau,0,2,1,C,1980
14403,29,22,Guy Carbonneau,18,77,47,C,1982
14404,30,23,Guy Carbonneau,24,78,54,C,1983
14405,34,24,Guy Carbonneau,23,79,57,C,1984
14406,36,25,Guy Carbonneau,20,80,56,C,1985
14407,27,26,Guy Carbonneau,18,79,45,C,1986
14408,21,27,Guy Carbonneau,17,80,38,C,1987
14409,30,28,Guy Carbonneau,26,79,56,C,1988
14410,36,29,Guy Carbonneau,19,68,55,C,1989
14411,24,30,Guy Carbonneau,20,78,44,C,1990
14412,21,31,Guy Carbonneau,18,72,39,C,1991
14413,13,32,Guy Carbonneau,4,61,17,C,1992
14414,24,33,Guy Carbonneau,14,79,38,C,1993
14415,11,34,Guy Carbonneau,5,42,16,C,1994
14416,15,35,Guy Carbonneau,8,71,23,C,1995
14417,16,36,Guy Carbonneau,5,73,21,C,1996
14418,17,37,Guy Carbonneau,7,77,24,C,1997
14419,12,38,Guy Carbonneau,4,74,16,C,1998
14420,6,39,Guy Carbonneau,10,69,16,C,1999
14421,0,21,Guy Charron,0,5,0,LW,1969
14422,6,22,Guy Charron,10,39,16,LW,1970
14423,16,23,Guy Charron,9,64,25,LW,1971
14424,18,24,Guy Charron,18,75,36,LW,1972
14425,30,25,Guy Charron,25,76,55,LW,1973
14426,39,26,Guy Charron,14,77,53,LW,1974
14427,44,27,Guy Charron,27,78,71,C,1975
14428,46,28,Guy Charron,36,80,82,C,1976
14429,35,29,Guy Charron,38,80,73,C,1977
14430,42,30,Guy Charron,28,80,70,C,1978
14431,20,31,Guy Charron,11,33,31,C,1979
14432,13,32,Guy Charron,5,47,18,C,1980
14433,0,18,Guy Chouinard,0,5,0,C,1974
14434,2,19,Guy Chouinard,0,4,2,C,1975
14435,33,20,Guy Chouinard,17,80,50,C,1976
14436,30,21,Guy Chouinard,28,73,58,C,1977
14437,57,22,Guy Chouinard,50,80,107,C,1978
14438,46,23,Guy Chouinard,31,76,77,C,1979
14439,52,24,Guy Chouinard,31,52,83,C,1980
14440,57,25,Guy Chouinard,23,64,80,C,1981
14441,59,26,Guy Chouinard,13,80,72,C,1982
14442,34,27,Guy Chouinard,12,64,46,C,1983
14443,8,27,Guy Delparte,1,48,9,LW,1976
14444,2,26,Guy Dufour,3,9,5,RW,1972
14445,2,26,Guy Dufour,3,9,5,RW,1972
14446,23,27,Guy Dufour,27,74,50,RW,1973
14447,23,27,Guy Dufour,27,74,50,RW,1973
14448,0,24,Guy Gosselin,0,5,0,D,1987
14449,35,20,Guy Lafleur,29,73,64,RW,1971
14450,27,21,Guy Lafleur,28,69,55,RW,1972
14451,35,22,Guy Lafleur,21,73,56,RW,1973
14452,66,23,Guy Lafleur,53,70,119,RW,1974
14453,69,24,Guy Lafleur,56,80,125,RW,1975
14454,80,25,Guy Lafleur,56,80,136,RW,1976
14455,72,26,Guy Lafleur,60,78,132,RW,1977
14456,77,27,Guy Lafleur,52,80,129,RW,1978
14457,75,28,Guy Lafleur,50,74,125,RW,1979
14458,43,29,Guy Lafleur,27,51,70,RW,1980
14459,57,30,Guy Lafleur,27,66,84,RW,1981
14460,49,31,Guy Lafleur,27,68,76,RW,1982
14461,40,32,Guy Lafleur,30,80,70,RW,1983
14462,3,33,Guy Lafleur,2,19,5,RW,1984
14463,27,37,Guy Lafleur,18,67,45,RW,1988
14464,22,38,Guy Lafleur,12,39,34,RW,1989
14465,16,39,Guy Lafleur,12,59,28,RW,1990
14466,0,20,Guy Lapointe,0,1,0,D,1968
14467,0,21,Guy Lapointe,0,5,0,D,1969
14468,29,22,Guy Lapointe,15,78,44,D,1970
14469,38,23,Guy Lapointe,11,69,49,D,1971
14470,35,24,Guy Lapointe,19,76,54,D,1972
14471,40,25,Guy Lapointe,13,71,53,D,1973
14472,47,26,Guy Lapointe,28,80,75,D,1974
14473,47,27,Guy Lapointe,21,77,68,D,1975
14474,51,28,Guy Lapointe,25,77,76,D,1976
14475,29,29,Guy Lapointe,13,49,42,D,1977
14476,42,30,Guy Lapointe,13,69,55,D,1978
14477,20,31,Guy Lapointe,6,45,26,D,1979
14478,9,32,Guy Lapointe,1,33,10,D,1980
14479,25,33,Guy Lapointe,1,55,26,D,1981
14480,23,34,Guy Lapointe,3,54,26,D,1982
14481,16,35,Guy Lapointe,2,45,18,D,1983
14482,1,21,Guy Larose,0,3,1,C,1988
14483,0,23,Guy Larose,0,7,0,C,1990
14484,5,24,Guy Larose,9,34,14,C,1991
14485,0,25,Guy Larose,0,9,0,C,1992
14486,3,26,Guy Larose,1,17,4,C,1993
14487,1,20,Guy Leveque,2,12,3,C,1992
14488,1,21,Guy Leveque,0,5,1,C,1993
14489,3,23,Guy Smith,3,22,6,RW,1972
14490,3,23,Guy Smith,3,22,6,RW,1972
14491,5,24,Guy Smith,1,16,6,RW,1973
14492,5,24,Guy Smith,1,16,6,RW,1973
14493,0,27,Guy Trottier,0,2,0,RW,1968
14494,5,29,Guy Trottier,19,61,24,RW,1970
14495,12,30,Guy Trottier,9,52,21,RW,1971
14496,32,31,Guy Trottier,26,72,58,RW,1972
14497,32,31,Guy Trottier,26,72,58,RW,1972
14498,35,32,Guy Trottier,27,71,62,RW,1973
14499,35,32,Guy Trottier,27,71,62,RW,1973
14500,6,33,Guy Trottier,7,23,13,RW,1974
14501,4,33,Guy Trottier,5,17,9,RW,1974
14502,2,33,Guy Trottier,2,6,4,RW,1974
14503,6,33,Guy Trottier,7,23,13,RW,1974
14504,4,33,Guy Trottier,5,17,9,RW,1974
14505,2,33,Guy Trottier,2,6,4,RW,1974
14506,25,23,Hakan Loob,30,77,55,RW,1983
14507,35,24,Hakan Loob,37,78,72,RW,1984
14508,36,25,Hakan Loob,31,68,67,RW,1985
14509,26,26,Hakan Loob,18,68,44,RW,1986
14510,56,27,Hakan Loob,50,80,106,RW,1987
14511,58,28,Hakan Loob,27,79,85,RW,1988
14512,4,22,Hal Gill,2,68,6,D,1997
14513,7,23,Hal Gill,3,80,10,D,1998
14514,9,24,Hal Gill,3,81,12,D,1999
14515,10,25,Hal Gill,1,80,11,D,2000
14516,18,26,Hal Gill,4,79,22,D,2001
14517,13,27,Hal Gill,4,76,17,D,2002
14518,7,28,Hal Gill,2,82,9,D,2003
14519,9,30,Hal Gill,1,80,10,D,2005
14520,14,31,Hal Gill,6,82,20,D,2006
14521,21,32,Hal Gill,3,81,24,D,2007
14522,8,33,Hal Gill,2,62,10,D,2008
14523,9,34,Hal Gill,2,68,11,D,2009
14524,7,35,Hal Gill,2,75,9,D,2010
14525,12,36,Hal Gill,1,76,13,D,2011
14526,0,37,Hal Gill,0,32,0,D,2012
14527,0,38,Hal Gill,0,6,0,D,2013
14528,21,26,Hal Willis,3,74,24,D,1972
14529,21,26,Hal Willis,3,74,24,D,1972
14530,2,27,Hal Willis,1,18,3,D,1973
14531,2,27,Hal Willis,1,18,3,D,1973
14532,24,20,Hampus Lindholm,6,78,30,D,2013
14533,27,21,Hampus Lindholm,7,78,34,D,2014
14534,18,22,Hampus Lindholm,10,80,28,D,2015
14535,14,23,Hampus Lindholm,6,66,20,D,2016
14536,18,24,Hampus Lindholm,13,69,31,D,2017
14537,2,27,Hank Lammens,1,27,3,D,1993
14538,9,23,Hank Monteith,1,34,10,LW,1968
14539,0,24,Hank Monteith,0,9,0,LW,1969
14540,3,25,Hank Monteith,4,34,7,LW,1970
14541,0,23,Hank Nowak,0,13,0,LW,1973
14542,21,24,Hank Nowak,12,77,33,LW,1974
14543,3,25,Hank Nowak,7,66,10,LW,1975
14544,5,26,Hank Nowak,7,24,12,LW,1976
14545,0,26,Hannes Hyvonen,0,6,0,D,2001
14546,5,27,Hannes Hyvonen,4,36,9,RW,2002
14547,0,28,Hannu Helander,0,1,0,RW,1978
14548,0,28,Hannu Helander,0,1,0,RW,1978
14549,8,23,Hannu Jarvenpaa,1,20,9,RW,1986
14550,11,24,Hannu Jarvenpaa,6,41,17,RW,1987
14551,7,25,Hannu Jarvenpaa,4,53,11,RW,1988
14552,1,18,Hannu Virta,0,3,1,D,1981
14553,24,19,Hannu Virta,13,74,37,D,1982
14554,30,20,Hannu Virta,6,70,36,D,1983
14555,23,21,Hannu Virta,1,51,24,D,1984
14556,23,22,Hannu Virta,5,47,28,D,1985
14557,11,26,Hans Jonsson,3,68,14,D,1999
14558,18,27,Hans Jonsson,4,58,22,D,2000
14559,5,28,Hans Jonsson,2,53,7,D,2001
14560,4,29,Hans Jonsson,1,63,5,D,2002
14561,0,23,Hap Myers,0,13,0,D,1970
14562,0,25,Harijs Vitolinsh,0,8,0,C,1993
14563,9,21,Harold Druken,7,33,16,C,1999
14564,15,22,Harold Druken,15,55,30,C,2000
14565,4,23,Harold Druken,4,27,8,LW,2001
14566,4,24,Harold Druken,1,22,5,C,2002
14567,4,25,Harold Druken,0,9,4,C,2003
14568,36,21,Harold Phillipoff,17,67,53,LW,1977
14569,21,22,Harold Phillipoff,9,65,30,LW,1978
14570,0,23,Harold Phillipoff,0,9,0,LW,1979
14571,2,20,Harold Snepsts,1,27,3,D,1974
14572,15,21,Harold Snepsts,3,78,18,D,1975
14573,18,22,Harold Snepsts,4,79,22,D,1976
14574,16,23,Harold Snepsts,4,75,20,D,1977
14575,24,24,Harold Snepsts,7,76,31,D,1978
14576,20,25,Harold Snepsts,3,79,23,D,1979
14577,16,26,Harold Snepsts,3,76,19,D,1980
14578,14,27,Harold Snepsts,3,68,17,D,1981
14579,8,28,Harold Snepsts,2,46,10,D,1982
14580,16,29,Harold Snepsts,4,79,20,D,1983
14581,7,30,Harold Snepsts,0,71,7,D,1984
14582,6,31,Harold Snepsts,0,35,6,D,1985
14583,13,32,Harold Snepsts,1,54,14,D,1986
14584,4,33,Harold Snepsts,1,31,5,D,1987
14585,8,34,Harold Snepsts,0,59,8,D,1988
14586,4,35,Harold Snepsts,1,46,5,D,1989
14587,4,36,Harold Snepsts,1,54,5,D,1990
14588,0,24,Harri Pesonen,0,4,0,C,2012
14589,2,28,Harri Tuhoimaa,0,1,2,RW,1978
14590,2,28,Harri Tuhoimaa,0,1,2,RW,1978
14591,24,35,Harry Howell,5,74,29,D,1967
14592,7,36,Harry Howell,4,56,11,D,1968
14593,16,37,Harry Howell,4,55,20,D,1969
14594,17,38,Harry Howell,3,46,20,D,1970
14595,17,39,Harry Howell,1,77,18,D,1971
14596,11,40,Harry Howell,4,73,15,D,1972
14597,23,41,Harry Howell*,3,65,26,D,1973
14598,23,41,Harry Howell*,3,65,26,D,1973
14599,10,42,Harry Howell*,4,74,14,D,1974
14600,10,42,Harry Howell*,4,74,14,D,1974
14601,3,43,Harry Howell*,0,31,3,D,1975
14602,3,43,Harry Howell*,0,31,3,D,1975
14603,18,22,Harry York,14,74,32,C,1996
14604,6,23,Harry York,4,60,10,C,1997
14605,9,24,Harry York,7,56,16,C,1998
14606,13,25,Harry York,4,54,17,C,1999
14607,3,24,Harry Zolnierczyk,3,37,6,LW,2011
14608,1,25,Harry Zolnierczyk,0,7,1,LW,2012
14609,0,26,Harry Zolnierczyk,2,13,2,LW,2013
14610,0,27,Harry Zolnierczyk,0,2,0,LW,2014
14611,0,28,Harry Zolnierczyk,0,1,0,LW,2015
14612,2,29,Harry Zolnierczyk,2,24,4,LW,2016
14613,0,22,Hartland Monahan,0,1,0,RW,1973
14614,1,23,Hartland Monahan,0,6,1,RW,1974
14615,29,24,Hartland Monahan,17,80,46,RW,1975
14616,27,25,Hartland Monahan,23,79,50,RW,1976
14617,9,26,Hartland Monahan,12,71,21,RW,1977
14618,12,28,Hartland Monahan,5,72,17,RW,1979
14619,2,29,Hartland Monahan,4,25,6,RW,1980
14620,0,22,Harvey Bennett,0,7,0,C,1974
14621,13,23,Harvey Bennett,15,74,28,C,1975
14622,14,24,Harvey Bennett,14,69,28,C,1976
14623,10,25,Harvey Bennett,12,66,22,C,1977
14624,9,26,Harvey Bennett,3,52,12,C,1978
14625,0,20,Harvie Pocza,0,1,0,LW,1979
14626,0,22,Harvie Pocza,0,2,0,LW,1981
14627,8,21,Haydn Fleury,0,67,8,D,2017
14628,0,22,Hector Marini,0,1,0,RW,1978
14629,7,24,Hector Marini,4,14,11,RW,1980
14630,9,25,Hector Marini,4,30,13,RW,1981
14631,28,26,Hector Marini,17,77,45,RW,1982
14632,2,27,Hector Marini,2,32,4,RW,1983
14633,14,26,Heikki Riihiranta,8,64,22,D,1974
14634,14,26,Heikki Riihiranta,8,64,22,D,1974
14635,8,27,Heikki Riihiranta,1,70,9,D,1975
14636,8,27,Heikki Riihiranta,1,70,9,D,1975
14637,16,28,Heikki Riihiranta,1,53,17,D,1976
14638,16,28,Heikki Riihiranta,1,53,17,D,1976
14639,6,37,Helmut Balderis,3,26,9,RW,1989
14640,19,31,Henri Richard,9,54,28,C,1967
14641,37,32,Henri Richard,15,64,52,C,1968
14642,36,33,Henri Richard,16,62,52,C,1969
14643,37,34,Henri Richard,12,75,49,C,1970
14644,32,35,Henri Richard,12,75,44,C,1971
14645,35,36,Henri Richard,8,71,43,C,1972
14646,36,37,Henri Richard,19,75,55,C,1973
14647,10,38,Henri Richard,3,16,13,C,1974
14648,0,20,Henrik Borgström,1,4,1,C,2017
14649,1,23,Henrik Haapala,0,5,1,LW,2017
14650,0,20,Henrik Samuelsson,0,3,0,C,2014
14651,20,20,Henrik Sedin,9,82,29,LW,2000
14652,20,21,Henrik Sedin,16,82,36,C,2001
14653,31,22,Henrik Sedin,8,78,39,C,2002
14654,31,23,Henrik Sedin,11,76,42,C,2003
14655,57,25,Henrik Sedin,18,82,75,C,2005
14656,71,26,Henrik Sedin,10,82,81,C,2006
14657,61,27,Henrik Sedin,15,82,76,C,2007
14658,60,28,Henrik Sedin,22,82,82,C,2008
14659,83,29,Henrik Sedin,29,82,112,C,2009
14660,75,30,Henrik Sedin,19,82,94,C,2010
14661,67,31,Henrik Sedin,14,82,81,C,2011
14662,34,32,Henrik Sedin,11,48,45,C,2012
14663,39,33,Henrik Sedin,11,70,50,C,2013
14664,55,34,Henrik Sedin,18,82,73,C,2014
14665,44,35,Henrik Sedin,11,74,55,C,2015
14666,35,36,Henrik Sedin,15,82,50,C,2016
14667,47,37,Henrik Sedin,3,82,50,C,2017
14668,0,23,Henrik Tallinder,0,2,0,D,2001
14669,10,24,Henrik Tallinder,3,46,13,D,2002
14670,9,25,Henrik Tallinder,1,72,10,D,2003
14671,15,27,Henrik Tallinder,6,82,21,D,2005
14672,10,28,Henrik Tallinder,4,47,14,D,2006
14673,17,29,Henrik Tallinder,1,71,18,D,2007
14674,11,30,Henrik Tallinder,1,66,12,D,2008
14675,16,31,Henrik Tallinder,4,82,20,D,2009
14676,11,32,Henrik Tallinder,5,82,16,D,2010
14677,6,33,Henrik Tallinder,0,39,6,D,2011
14678,3,34,Henrik Tallinder,1,25,4,D,2012
14679,6,35,Henrik Tallinder,2,64,8,D,2013
14680,22,22,Henrik Zetterberg,22,79,44,LW,2002
14681,28,23,Henrik Zetterberg,15,61,43,LW,2003
14682,46,25,Henrik Zetterberg,39,77,85,LW,2005
14683,35,26,Henrik Zetterberg,33,63,68,LW,2006
14684,49,27,Henrik Zetterberg,43,75,92,LW,2007
14685,42,28,Henrik Zetterberg,31,77,73,C,2008
14686,47,29,Henrik Zetterberg,23,74,70,LW,2009
14687,56,30,Henrik Zetterberg,24,80,80,LW,2010
14688,47,31,Henrik Zetterberg,22,82,69,LW,2011
14689,37,32,Henrik Zetterberg,11,46,48,LW,2012
14690,32,33,Henrik Zetterberg,16,45,48,LW,2013
14691,49,34,Henrik Zetterberg,17,77,66,LW,2014
14692,37,35,Henrik Zetterberg,13,82,50,LW,2015
14693,51,36,Henrik Zetterberg,17,82,68,LW,2016
14694,45,37,Henrik Zetterberg,11,82,56,LW,2017
14695,0,20,Henry Boucha,1,16,1,C,1971
14696,14,21,Henry Boucha,14,73,28,C,1972
14697,12,22,Henry Boucha,19,70,31,C,1973
14698,14,23,Henry Boucha,15,51,29,C,1974
14699,7,24,Henry Boucha,4,28,11,C,1975
14700,20,24,Henry Boucha,15,36,35,C,1975
14701,20,24,Henry Boucha,15,36,35,C,1975
14702,2,25,Henry Boucha,0,9,2,C,1976
14703,0,24,Henry Lehvonen,0,4,0,D,1974
14704,0,18,Herb Raglan,0,7,0,RW,1985
14705,10,19,Herb Raglan,6,62,16,RW,1986
14706,15,20,Herb Raglan,10,73,25,RW,1987
14707,10,21,Herb Raglan,7,50,17,RW,1988
14708,1,22,Herb Raglan,0,11,1,RW,1989
14709,6,23,Herb Raglan,4,47,10,LW,1990
14710,14,24,Herb Raglan,6,62,20,RW,1991
14711,0,25,Herb Raglan,0,2,0,RW,1992
14712,0,26,Herb Raglan,0,29,0,RW,1993
14713,0,22,Herbert Vasiljevs,0,5,0,C,1998
14714,0,23,Herbert Vasiljevs,1,7,1,C,1999
14715,5,24,Herbert Vasiljevs,4,21,9,RW,2000
14716,2,25,Herbert Vasiljevs,3,18,5,C,2001
14717,0,20,Hilliard Graves,0,14,0,RW,1970
14718,25,22,Hilliard Graves,27,75,52,RW,1972
14719,18,23,Hilliard Graves,11,64,29,RW,1973
14720,19,24,Hilliard Graves,10,67,29,RW,1974
14721,30,25,Hilliard Graves,19,80,49,RW,1975
14722,25,26,Hilliard Graves,18,79,43,RW,1976
14723,26,27,Hilliard Graves,21,80,47,LW,1977
14724,15,28,Hilliard Graves,11,62,26,LW,1978
14725,5,29,Hilliard Graves,1,35,6,LW,1979
14726,3,20,Hnat Domenichelli,3,23,6,LW,1996
14727,7,21,Hnat Domenichelli,9,31,16,LW,1997
14728,5,22,Hnat Domenichelli,5,23,10,C,1998
14729,18,23,Hnat Domenichelli,11,59,29,C,1999
14730,12,24,Hnat Domenichelli,15,63,27,LW,2000
14731,16,25,Hnat Domenichelli,9,67,25,RW,2001
14732,0,26,Hnat Domenichelli,0,1,0,RW,2002
14733,4,20,Howard Scruton,0,4,4,D,1982
14734,11,22,Howard Walker,2,64,13,D,1980
14735,2,23,Howard Walker,0,16,2,D,1981
14736,0,24,Howard Walker,0,3,0,D,1982
14737,0,23,Howie Colborne,0,2,0,LW,1973
14738,0,23,Howie Colborne,0,2,0,LW,1973
14739,0,33,Howie Glover,0,1,0,RW,1968
14740,1,23,Howie Heggedal,2,8,3,C,1972
14741,1,23,Howie Heggedal,2,8,3,C,1972
14742,14,28,Howie Hughes,9,74,23,RW,1967
14743,14,29,Howie Hughes,16,73,30,RW,1968
14744,4,30,Howie Hughes,0,21,4,RW,1969
14745,15,25,Howie Menard,9,35,24,C,1967
14746,17,26,Howie Menard,10,56,27,C,1968
14747,10,27,Howie Menard,4,57,14,C,1969
14748,17,30,Howie Young,2,62,19,D,1967
14749,7,31,Howie Young,3,57,10,D,1968
14750,2,33,Howie Young,0,11,2,D,1970
14751,22,37,Howie Young,16,72,38,D,1974
14752,10,37,Howie Young,13,42,23,D,1974
14753,12,37,Howie Young,3,30,15,D,1974
14754,22,37,Howie Young,16,72,38,D,1974
14755,10,37,Howie Young,13,42,23,D,1974
14756,12,37,Howie Young,3,30,15,D,1974
14757,3,39,Howie Young,1,26,4,D,1976
14758,3,39,Howie Young,1,26,4,D,1976
14759,1,25,Hubie McDonough,0,4,1,C,1988
14760,15,26,Hubie McDonough,21,76,36,C,1989
14761,6,27,Hubie McDonough,6,52,12,C,1990
14762,2,28,Hubie McDonough,7,33,9,C,1991
14763,2,29,Hubie McDonough,6,30,8,C,1992
14764,1,20,Hudson Fasching,1,7,2,RW,2015
14765,1,21,Hudson Fasching,0,10,1,RW,2016
14766,0,22,Hudson Fasching,0,5,0,RW,2017
14767,26,24,Hugh Harris,12,60,38,LW,1972
14768,28,25,Hugh Harris,24,75,52,LW,1973
14769,28,25,Hugh Harris,24,75,52,LW,1973
14770,44,26,Hugh Harris,33,80,77,LW,1974
14771,34,26,Hugh Harris,23,58,57,LW,1974
14772,10,26,Hugh Harris,10,22,20,LW,1974
14773,34,26,Hugh Harris,23,58,57,LW,1974
14774,10,26,Hugh Harris,10,22,20,LW,1974
14775,37,27,Hugh Harris,17,71,54,LW,1975
14776,35,28,Hugh Harris,21,46,56,LW,1976
14777,35,28,Hugh Harris,21,46,56,LW,1976
14778,30,29,Hugh Harris,12,64,42,LW,1977
14779,23,29,Hugh Harris,11,45,34,LW,1977
14780,7,29,Hugh Harris,1,19,8,LW,1977
14781,30,29,Hugh Harris,12,64,42,LW,1977
14782,0,25,Hugh Harvey,0,8,0,C,1974
14783,1,26,Hugh Harvey,1,10,2,C,1975
14784,0,26,Hugh Jessiman,0,2,0,RW,2010
14785,1,21,Hunter Shinkaruk,2,8,3,C,2015
14786,1,22,Hunter Shinkaruk,0,7,1,LW,2016
14787,2,23,Iain Duncan,1,6,3,LW,1986
14788,23,24,Iain Duncan,19,62,42,LW,1987
14789,30,25,Iain Duncan,14,57,44,LW,1988
14790,0,27,Iain Duncan,0,2,0,LW,1990
14791,2,23,Iain Fraser,2,7,4,C,1992
14792,20,24,Iain Fraser,17,60,37,RW,1993
14793,0,25,Iain Fraser,3,13,3,C,1994
14794,1,26,Iain Fraser,1,12,2,C,1995
14795,0,27,Iain Fraser,0,2,0,C,1996
14796,3,21,Ian Cole,1,26,4,D,2010
14797,5,22,Ian Cole,1,26,6,D,2011
14798,1,23,Ian Cole,0,15,1,D,2012
14799,8,24,Ian Cole,3,46,11,D,2013
14800,12,25,Ian Cole,5,74,17,D,2014
14801,12,26,Ian Cole,0,70,12,D,2015
14802,21,27,Ian Cole,5,81,26,D,2016
14803,5,28,Ian Cole,2,20,7,D,2017
14804,2,26,Ian Herbers,0,22,2,D,1993
14805,3,32,Ian Herbers,0,43,3,D,1999
14806,7,23,Ian Kidd,4,19,11,D,1987
14807,0,24,Ian Kidd,0,1,0,D,1988
14808,0,20,Ian Laperriere,0,1,0,C,1993
14809,14,21,Ian Laperriere,13,37,27,C,1994
14810,11,22,Ian Laperriere,6,71,17,C,1995
14811,15,23,Ian Laperriere,8,62,23,C,1996
14812,15,24,Ian Laperriere,6,77,21,C,1997
14813,10,25,Ian Laperriere,3,72,13,C,1998
14814,13,26,Ian Laperriere,9,79,22,C,1999
14815,10,27,Ian Laperriere,8,79,18,RW,2000
14816,14,28,Ian Laperriere,8,81,22,C,2001
14817,12,29,Ian Laperriere,7,73,19,RW,2002
14818,12,30,Ian Laperriere,10,62,22,RW,2003
14819,24,32,Ian Laperriere,21,82,45,C,2005
14820,21,33,Ian Laperriere,8,81,29,RW,2006
14821,15,34,Ian Laperriere,4,70,19,RW,2007
14822,12,35,Ian Laperriere,7,74,19,RW,2008
14823,17,36,Ian Laperriere,3,82,20,C,2009
14824,0,25,Ian MacNeil,0,2,0,C,2002
14825,1,21,Ian McCoshen,0,3,1,D,2016
14826,1,22,Ian McCoshen,3,38,4,D,2017
14827,0,29,Ian McKegney,0,3,0,D,1976
14828,1,23,Ian Moran,1,51,2,D,1995
14829,5,24,Ian Moran,4,36,9,D,1996
14830,6,25,Ian Moran,1,37,7,RW,1997
14831,5,26,Ian Moran,4,62,9,RW,1998
14832,8,27,Ian Moran,4,73,12,D,1999
14833,4,28,Ian Moran,3,40,7,D,2000
14834,8,29,Ian Moran,2,64,10,D,2001
14835,8,30,Ian Moran,0,78,8,D,2002
14836,4,31,Ian Moran,1,35,5,D,2003
14837,1,33,Ian Moran,1,12,2,D,2005
14838,0,34,Ian Moran,0,1,0,D,2006
14839,27,20,Ian Turnbull,8,78,35,D,1973
14840,7,21,Ian Turnbull,6,22,13,D,1974
14841,36,22,Ian Turnbull,20,76,56,D,1975
14842,57,23,Ian Turnbull,22,80,79,D,1976
14843,47,24,Ian Turnbull,14,77,61,D,1977
14844,51,25,Ian Turnbull,12,80,63,D,1978
14845,28,26,Ian Turnbull,11,75,39,D,1979
14846,47,27,Ian Turnbull,19,80,66,D,1980
14847,17,28,Ian Turnbull,11,54,28,D,1981
14848,0,29,Ian Turnbull,0,6,0,D,1982
14849,5,21,Ian White,1,12,6,D,2005
14850,23,22,Ian White,3,76,26,D,2006
14851,16,23,Ian White,5,81,21,D,2007
14852,16,24,Ian White,10,71,26,D,2008
14853,25,25,Ian White,13,83,38,D,2009
14854,22,26,Ian White,4,78,26,D,2010
14855,25,27,Ian White,7,77,32,D,2011
14856,2,28,Ian White,2,25,4,D,2012
14857,11,25,Igor Chibirev,4,37,15,C,1993
14858,1,26,Igor Chibirev,3,8,4,C,1994
14859,23,22,Igor Korolev,4,74,27,RW,1992
14860,10,23,Igor Korolev,6,73,16,RW,1993
14861,22,24,Igor Korolev,8,45,30,LW,1994
14862,29,25,Igor Korolev,22,73,51,RW,1995
14863,7,26,Igor Korolev,3,41,10,RW,1996
14864,22,27,Igor Korolev,17,78,39,RW,1997
14865,34,28,Igor Korolev,13,66,47,RW,1998
14866,26,29,Igor Korolev,20,80,46,RW,1999
14867,19,30,Igor Korolev,10,73,29,RW,2000
14868,20,31,Igor Korolev,9,82,29,C,2001
14869,5,32,Igor Korolev,4,48,9,C,2002
14870,10,33,Igor Korolev,3,62,13,C,2003
14871,8,25,Igor Kravchuk,1,18,9,D,1991
14872,17,26,Igor Kravchuk,10,55,27,D,1992
14873,38,27,Igor Kravchuk,12,81,50,D,1993
14874,11,28,Igor Kravchuk,7,36,18,D,1994
14875,16,29,Igor Kravchuk,7,66,23,D,1995
14876,24,30,Igor Kravchuk,4,82,28,D,1996
14877,27,31,Igor Kravchuk,8,81,35,D,1997
14878,21,32,Igor Kravchuk,4,79,25,D,1998
14879,12,33,Igor Kravchuk,6,64,18,D,1999
14880,13,34,Igor Kravchuk,1,52,14,D,2000
14881,22,35,Igor Kravchuk,4,78,26,D,2001
14882,1,36,Igor Kravchuk,0,7,1,D,2002
14883,27,29,Igor Larionov,17,74,44,C,1989
14884,21,30,Igor Larionov,13,64,34,C,1990
14885,44,31,Igor Larionov,21,72,65,C,1991
14886,38,33,Igor Larionov,18,60,56,C,1993
14887,20,34,Igor Larionov,4,33,24,C,1994
14888,51,35,Igor Larionov,22,73,73,C,1995
14889,42,36,Igor Larionov,12,64,54,C,1996
14890,39,37,Igor Larionov,8,69,47,C,1997
14891,49,38,Igor Larionov,14,75,63,C,1998
14892,38,39,Igor Larionov,9,79,47,C,1999
14893,31,40,Igor Larionov,9,65,40,C,2000
14894,32,41,Igor Larionov,11,70,43,C,2001
14895,33,42,Igor Larionov,10,74,43,C,2002
14896,10,43,Igor Larionov,1,49,11,C,2003
14897,18,28,Igor Liba,7,37,25,RW,1988
14898,0,20,Igor Radulov,5,7,5,LW,2002
14899,7,21,Igor Radulov,4,36,11,RW,2003
14900,3,,Igor Romashin,3,8,6,C,1977
14901,3,,Igor Romashin,3,8,6,C,1977
14902,9,22,Igor Ulanov,2,27,11,D,1991
14903,14,23,Igor Ulanov,2,56,16,D,1992
14904,17,24,Igor Ulanov,0,74,17,D,1993
14905,4,25,Igor Ulanov,1,22,5,D,1994
14906,9,26,Igor Ulanov,3,64,12,D,1995
14907,7,27,Igor Ulanov,1,59,8,D,1996
14908,8,28,Igor Ulanov,2,49,10,D,1997
14909,9,29,Igor Ulanov,3,76,12,D,1998
14910,8,30,Igor Ulanov,1,57,9,D,1999
14911,20,31,Igor Ulanov,3,67,23,D,2000
14912,10,32,Igor Ulanov,0,53,10,D,2001
14913,1,33,Igor Ulanov,1,56,2,D,2002
14914,13,34,Igor Ulanov,5,42,18,D,2003
14915,6,36,Igor Ulanov,3,37,9,D,2005
14916,0,25,Igor Vyazmikin,1,4,1,RW,1990
14917,30,23,Iiro Jarvi,11,75,41,RW,1988
14918,13,24,Iiro Jarvi,7,41,20,LW,1989
14919,2,23,Iiro Pakarinen,1,17,3,RW,2014
14920,8,24,Iiro Pakarinen,5,63,13,RW,2015
14921,2,25,Iiro Pakarinen,2,14,4,RW,2016
14922,1,26,Iiro Pakarinen,2,40,3,RW,2017
14923,20,30,Ilja Byakin,8,44,28,D,1993
14924,5,31,Ilja Byakin,0,13,5,D,1994
14925,0,25,Ilkka Heikkinen,0,7,0,D,2009
14926,3,28,Ilkka Pikkarainen,1,31,4,RW,2009
14927,22,23,Ilkka Sinisalo,15,66,37,LW,1981
14928,29,24,Ilkka Sinisalo,21,61,50,LW,1982
14929,17,25,Ilkka Sinisalo,29,73,46,LW,1983
14930,37,26,Ilkka Sinisalo,36,70,73,RW,1984
14931,37,27,Ilkka Sinisalo,39,74,76,LW,1985
14932,21,28,Ilkka Sinisalo,10,42,31,LW,1986
14933,17,29,Ilkka Sinisalo,25,68,42,RW,1987
14934,6,30,Ilkka Sinisalo,1,13,7,RW,1988
14935,23,31,Ilkka Sinisalo,23,59,46,RW,1989
14936,12,32,Ilkka Sinisalo,5,53,17,RW,1990
14937,1,33,Ilkka Sinisalo,0,3,1,RW,1991
14938,22,18,Ilya Kovalchuk,29,65,51,LW,2001
14939,29,19,Ilya Kovalchuk,38,81,67,LW,2002
14940,46,20,Ilya Kovalchuk,41,81,87,LW,2003
14941,46,22,Ilya Kovalchuk,52,78,98,LW,2005
14942,34,23,Ilya Kovalchuk,42,82,76,LW,2006
14943,35,24,Ilya Kovalchuk,52,79,87,LW,2007
14944,48,25,Ilya Kovalchuk,43,79,91,LW,2008
14945,44,26,Ilya Kovalchuk,41,76,85,LW,2009
14946,29,27,Ilya Kovalchuk,31,81,60,LW,2010
14947,46,28,Ilya Kovalchuk,37,77,83,LW,2011
14948,20,29,Ilya Kovalchuk,11,37,31,LW,2012
14949,0,20,Ilya Zubov,0,1,0,C,2007
14950,2,21,Ilya Zubov,0,10,2,C,2008
14951,23,26,Inge Hammarstrom,20,66,43,LW,1973
14952,20,27,Inge Hammarstrom,21,69,41,LW,1974
14953,21,28,Inge Hammarstrom,19,76,40,LW,1975
14954,17,29,Inge Hammarstrom,24,78,41,LW,1976
14955,20,30,Inge Hammarstrom,20,73,40,LW,1977
14956,22,31,Inge Hammarstrom,12,65,34,LW,1978
14957,1,30,Irv Spencer,0,5,1,D,1967
14958,27,35,Irv Spencer,2,54,29,D,1972
14959,1,36,Irv Spencer,0,19,1,D,1973
14960,0,28,Ismo Villa,1,1,1,RW,1978
14961,1,22,Ivan Baranka,0,1,1,D,2007
14962,7,21,Ivan Barbashev,5,30,12,C,2016
14963,6,22,Ivan Barbashev,7,53,13,C,2017
14964,0,21,Ivan Boldirev,0,2,0,C,1970
14965,25,22,Ivan Boldirev,16,68,41,C,1971
14966,23,23,Ivan Boldirev,11,56,34,C,1972
14967,31,24,Ivan Boldirev,25,78,56,C,1973
14968,43,25,Ivan Boldirev,24,80,67,C,1974
14969,34,26,Ivan Boldirev,28,78,62,C,1975
14970,38,27,Ivan Boldirev,24,80,62,C,1976
14971,45,28,Ivan Boldirev,35,80,80,C,1977
14972,43,29,Ivan Boldirev,35,79,78,C,1978
14973,35,30,Ivan Boldirev,32,79,67,C,1979
14974,33,31,Ivan Boldirev,26,72,59,C,1980
14975,40,32,Ivan Boldirev,33,78,73,C,1981
14976,37,33,Ivan Boldirev,18,72,55,C,1982
14977,48,34,Ivan Boldirev,35,75,83,LW,1983
14978,30,35,Ivan Boldirev,19,75,49,LW,1984
14979,0,20,Ivan Ciernik,0,2,0,RW,1997
14980,0,23,Ivan Ciernik,2,4,2,LW,2000
14981,3,24,Ivan Ciernik,1,29,4,LW,2001
14982,10,25,Ivan Ciernik,8,47,18,LW,2002
14983,1,26,Ivan Ciernik,1,7,2,RW,2003
14984,1,21,Ivan Droppa,0,12,1,D,1993
14985,0,23,Ivan Droppa,0,7,0,D,1995
14986,37,32,Ivan Hlinka,23,72,60,C,1981
14987,44,33,Ivan Hlinka,19,65,63,C,1982
14988,1,20,Ivan Huml,0,1,1,LW,2001
14989,11,21,Ivan Huml,6,41,17,LW,2002
14990,0,22,Ivan Huml,0,7,0,LW,2003
14991,8,26,Ivan Majesky,4,82,12,D,2002
14992,7,27,Ivan Majesky,3,63,10,D,2003
14993,8,29,Ivan Majesky,1,57,9,D,2005
14994,1,21,Ivan Novoseltsev,2,14,3,RW,1999
14995,6,22,Ivan Novoseltsev,3,38,9,RW,2000
14996,16,23,Ivan Novoseltsev,13,70,29,RW,2001
14997,17,24,Ivan Novoseltsev,10,78,27,RW,2002
14998,4,25,Ivan Novoseltsev,3,34,7,RW,2003
14999,24,20,Ivan Provorov,6,82,30,D,2016
15000,24,21,Ivan Provorov,17,82,41,D,2017
15001,2,20,Ivan Vishnevskiy,0,3,2,D,2008
15002,0,21,Ivan Vishnevskiy,0,2,0,D,2009
15003,1,22,J.C. Lipon,0,9,1,RW,2015
15004,26,29,J.C. Tremblay,4,73,30,D,1967
15005,32,30,J.C. Tremblay,7,75,39,D,1968
15006,19,31,J.C. Tremblay,2,58,21,D,1969
15007,52,32,J.C. Tremblay,11,76,63,D,1970
15008,51,33,J.C. Tremblay,6,76,57,D,1971
15009,75,34,J.C. Tremblay,14,75,89,D,1972
15010,75,34,J.C. Tremblay,14,75,89,D,1972
15011,44,35,J.C. Tremblay,9,68,53,D,1973
15012,44,35,J.C. Tremblay,9,68,53,D,1973
15013,56,36,J.C. Tremblay,16,68,72,D,1974
15014,56,36,J.C. Tremblay,16,68,72,D,1974
15015,77,37,J.C. Tremblay,12,80,89,D,1975
15016,77,37,J.C. Tremblay,12,80,89,D,1975
15017,31,38,J.C. Tremblay,4,53,35,D,1976
15018,31,38,J.C. Tremblay,4,53,35,D,1976
15019,37,39,J.C. Tremblay,5,54,42,D,1977
15020,37,39,J.C. Tremblay,5,54,42,D,1977
15021,38,40,J.C. Tremblay,6,56,44,D,1978
15022,38,40,J.C. Tremblay,6,56,44,D,1978
15023,23,19,J.J. Daigneault,4,67,27,D,1984
15024,23,20,J.J. Daigneault,5,64,28,D,1985
15025,16,21,J.J. Daigneault,6,77,22,D,1986
15026,2,22,J.J. Daigneault,2,28,4,D,1987
15027,10,24,J.J. Daigneault,2,36,12,D,1989
15028,16,25,J.J. Daigneault,3,51,19,D,1990
15029,14,26,J.J. Daigneault,4,79,18,D,1991
15030,10,27,J.J. Daigneault,8,66,18,D,1992
15031,12,28,J.J. Daigneault,2,68,14,D,1993
15032,5,29,J.J. Daigneault,3,45,8,D,1994
15033,7,30,J.J. Daigneault,4,57,11,D,1995
15034,23,31,J.J. Daigneault,5,66,28,D,1996
15035,21,32,J.J. Daigneault,2,71,23,D,1997
15036,9,33,J.J. Daigneault,2,70,11,D,1998
15037,6,34,J.J. Daigneault,1,53,7,D,1999
15038,0,35,J.J. Daigneault,0,1,0,D,2000
15039,2,22,J.P. Bordeleau,0,3,2,RW,1971
15040,15,23,J.P. Bordeleau,15,73,30,RW,1972
15041,9,24,J.P. Bordeleau,11,64,20,RW,1973
15042,8,25,J.P. Bordeleau,7,59,15,RW,1974
15043,18,26,J.P. Bordeleau,12,76,30,RW,1975
15044,14,27,J.P. Bordeleau,15,60,29,RW,1976
15045,25,28,J.P. Bordeleau,15,76,40,RW,1977
15046,21,29,J.P. Bordeleau,15,63,36,RW,1978
15047,14,30,J.P. Bordeleau,7,45,21,RW,1979
15048,6,20,J.P. Dumont,9,25,15,RW,1998
15049,8,21,J.P. Dumont,10,47,18,LW,1999
15050,28,22,J.P. Dumont,23,79,51,LW,2000
15051,21,23,J.P. Dumont,23,76,44,LW,2001
15052,21,24,J.P. Dumont,14,76,35,RW,2002
15053,31,25,J.P. Dumont,22,77,53,RW,2003
15054,20,27,J.P. Dumont,20,54,40,RW,2005
15055,45,28,J.P. Dumont,21,82,66,RW,2006
15056,43,29,J.P. Dumont,29,80,72,RW,2007
15057,49,30,J.P. Dumont,16,82,65,RW,2008
15058,28,31,J.P. Dumont,17,74,45,RW,2009
15059,9,32,J.P. Dumont,10,70,19,RW,2010
15060,2,22,J.P. LeBlanc,1,6,3,C,1968
15061,50,26,J.P. LeBlanc,19,77,69,C,1972
15062,50,26,J.P. LeBlanc,19,77,69,C,1972
15063,46,27,J.P. LeBlanc,20,78,66,C,1973
15064,46,27,J.P. LeBlanc,20,78,66,C,1973
15065,33,28,J.P. LeBlanc,16,78,49,C,1974
15066,33,28,J.P. LeBlanc,16,78,49,C,1974
15067,9,29,J.P. LeBlanc,4,46,13,C,1975
15068,5,29,J.P. LeBlanc,1,15,6,C,1975
15069,5,29,J.P. LeBlanc,1,15,6,C,1975
15070,11,30,J.P. LeBlanc,7,74,18,C,1976
15071,2,31,J.P. LeBlanc,0,3,2,C,1977
15072,6,32,J.P. LeBlanc,2,24,8,C,1978
15073,17,26,J.P. Parise,11,44,28,LW,1967
15074,27,27,J.P. Parise,22,76,49,LW,1968
15075,48,28,J.P. Parise,24,74,72,LW,1969
15076,23,29,J.P. Parise,11,73,34,LW,1970
15077,18,30,J.P. Parise,19,71,37,LW,1971
15078,48,31,J.P. Parise,27,78,75,LW,1972
15079,37,32,J.P. Parise,18,78,55,LW,1973
15080,32,33,J.P. Parise,23,79,55,LW,1974
15081,35,34,J.P. Parise,22,80,57,LW,1975
15082,31,35,J.P. Parise,25,80,56,LW,1976
15083,29,36,J.P. Parise,21,79,50,LW,1977
15084,9,37,J.P. Parise,13,57,22,LW,1978
15085,0,24,J.P. Vigier,0,2,0,RW,2000
15086,1,25,J.P. Vigier,4,15,5,RW,2001
15087,0,26,J.P. Vigier,0,13,0,RW,2002
15088,8,27,J.P. Vigier,10,70,18,RW,2003
15089,6,29,J.P. Vigier,4,41,10,RW,2005
15090,8,30,J.P. Vigier,5,72,13,RW,2006
15091,1,21,J.T. Brown,0,5,1,LW,2011
15092,15,23,J.T. Brown,4,63,19,RW,2013
15093,6,24,J.T. Brown,3,52,9,RW,2014
15094,14,25,J.T. Brown,8,78,22,RW,2015
15095,3,26,J.T. Brown,3,64,6,RW,2016
15096,2,27,J.T. Brown,1,23,3,RW,2017
15097,2,21,J.T. Compher,3,21,5,LW,2016
15098,10,22,J.T. Compher,13,69,23,LW,2017
15099,2,19,J.T. Miller,2,26,4,C,2012
15100,3,20,J.T. Miller,3,30,6,C,2013
15101,13,21,J.T. Miller,10,58,23,C,2014
15102,21,22,J.T. Miller,22,82,43,C,2015
15103,34,23,J.T. Miller,22,82,56,LW,2016
15104,8,24,J.T. Miller,10,19,18,LW,2017
15105,0,23,J.T. Wyman,0,3,0,RW,2009
15106,9,25,J.T. Wyman,2,40,11,RW,2011
15107,0,26,J.T. Wyman,0,1,0,RW,2012
15108,18,21,Jaccob Slavin,2,63,20,D,2015
15109,29,22,Jaccob Slavin,5,82,34,D,2016
15110,22,23,Jaccob Slavin,8,82,30,D,2017
15111,0,25,Jack Borotsik,0,1,0,C,1974
15112,15,22,Jack Brownschidle,2,40,17,D,1977
15113,24,23,Jack Brownschidle,10,64,34,D,1978
15114,32,24,Jack Brownschidle,12,77,44,D,1979
15115,23,25,Jack Brownschidle,5,71,28,D,1980
15116,33,26,Jack Brownschidle,5,80,38,D,1981
15117,22,27,Jack Brownschidle,1,72,23,D,1982
15118,9,28,Jack Brownschidle,3,64,12,D,1983
15119,4,29,Jack Brownschidle,1,17,5,D,1984
15120,0,30,Jack Brownschidle,0,9,0,D,1985
15121,0,23,Jack Capuano,0,1,0,D,1989
15122,0,24,Jack Capuano,0,3,0,D,1990
15123,0,25,Jack Capuano,0,2,0,D,1991
15124,5,20,Jack Carlson,5,32,10,LW,1974
15125,5,20,Jack Carlson,5,32,10,LW,1974
15126,11,21,Jack Carlson,9,68,20,LW,1975
15127,11,21,Jack Carlson,9,68,20,LW,1975
15128,8,22,Jack Carlson,11,71,19,LW,1976
15129,3,22,Jack Carlson,4,36,7,LW,1976
15130,5,22,Jack Carlson,7,35,12,LW,1976
15131,8,22,Jack Carlson,11,71,19,LW,1976
15132,3,22,Jack Carlson,4,36,7,LW,1976
15133,5,22,Jack Carlson,7,35,12,LW,1976
15134,20,23,Jack Carlson,9,67,29,LW,1977
15135,20,23,Jack Carlson,9,67,29,LW,1977
15136,0,24,Jack Carlson,3,16,3,LW,1978
15137,7,24,Jack Carlson,2,34,9,LW,1978
15138,7,24,Jack Carlson,2,34,9,LW,1978
15139,2,26,Jack Carlson,7,43,9,LW,1980
15140,4,27,Jack Carlson,8,57,12,LW,1981
15141,1,28,Jack Carlson,6,54,7,LW,1982
15142,8,29,Jack Carlson,6,58,14,LW,1983
15143,0,32,Jack Carlson,0,8,0,LW,1986
15144,0,27,Jack Chipchase,0,4,0,D,1972
15145,0,27,Jack Chipchase,0,4,0,D,1972
15146,0,21,Jack Egers,3,6,3,LW,1969
15147,10,22,Jack Egers,7,60,17,RW,1970
15148,26,23,Jack Egers,23,80,49,LW,1971
15149,24,24,Jack Egers,24,78,48,LW,1972
15150,4,25,Jack Egers,1,34,5,LW,1973
15151,2,26,Jack Egers,3,14,5,RW,1974
15152,3,27,Jack Egers,3,12,6,RW,1975
15153,32,19,Jack Eichel,24,81,56,C,2015
15154,33,20,Jack Eichel,24,61,57,C,2016
15155,39,21,Jack Eichel,25,67,64,C,2017
15156,13,24,Jack Gibson,22,59,35,LW,1972
15157,9,25,Jack Gibson,16,61,25,LW,1973
15158,9,25,Jack Gibson,16,61,25,LW,1973
15159,0,27,Jack Gibson,0,2,0,LW,1975
15160,0,27,Jack Gibson,0,2,0,LW,1975
15161,1,22,Jack Hillen,0,2,1,D,2007
15162,5,23,Jack Hillen,1,40,6,D,2008
15163,18,24,Jack Hillen,3,69,21,D,2009
15164,18,25,Jack Hillen,4,64,22,D,2010
15165,4,26,Jack Hillen,2,55,6,D,2011
15166,6,27,Jack Hillen,3,23,9,D,2012
15167,1,28,Jack Hillen,0,13,1,D,2013
15168,5,29,Jack Hillen,0,38,5,D,2014
15169,5,23,Jack Hughes,2,38,7,D,1980
15170,0,24,Jack Hughes,0,8,0,D,1981
15171,0,20,Jack Johnson,0,5,0,D,2006
15172,8,21,Jack Johnson,3,74,11,D,2007
15173,5,22,Jack Johnson,6,41,11,D,2008
15174,28,23,Jack Johnson,8,80,36,D,2009
15175,37,24,Jack Johnson,5,82,42,D,2010
15176,26,25,Jack Johnson,12,82,38,D,2011
15177,14,26,Jack Johnson,5,44,19,D,2012
15178,28,27,Jack Johnson,5,82,33,D,2013
15179,32,28,Jack Johnson,8,79,40,D,2014
15180,8,29,Jack Johnson,6,60,14,D,2015
15181,18,30,Jack Johnson,5,82,23,D,2016
15182,8,31,Jack Johnson,3,77,11,D,2017
15183,18,20,Jack Lynch,1,47,19,D,1972
15184,16,21,Jack Lynch,3,52,19,D,1973
15185,20,22,Jack Lynch,3,70,23,D,1974
15186,13,23,Jack Lynch,9,79,22,D,1975
15187,25,24,Jack Lynch,5,75,30,D,1976
15188,8,25,Jack Lynch,1,29,9,D,1977
15189,6,26,Jack Lynch,2,30,8,D,1978
15190,0,22,Jack McIlhargey,0,2,0,D,1974
15191,2,23,Jack McIlhargey,1,57,3,D,1975
15192,8,24,Jack McIlhargey,3,61,11,D,1976
15193,5,25,Jack McIlhargey,3,69,8,D,1977
15194,4,26,Jack McIlhargey,2,53,6,D,1978
15195,6,27,Jack McIlhargey,0,50,6,D,1979
15196,6,28,Jack McIlhargey,1,51,7,D,1980
15197,5,29,Jack McIlhargey,1,50,6,D,1981
15198,11,25,Jack O'Callahan,0,39,11,D,1982
15199,13,26,Jack O'Callahan,4,70,17,D,1983
15200,8,27,Jack O'Callahan,6,66,14,D,1984
15201,19,28,Jack O'Callahan,4,80,23,D,1985
15202,13,29,Jack O'Callahan,1,48,14,D,1986
15203,19,30,Jack O'Callahan,7,50,26,D,1987
15204,21,31,Jack O'Callahan,5,36,26,D,1988
15205,0,23,Jack Rodewald,0,4,0,RW,2017
15206,0,20,Jack Roslovic,0,1,0,C,2016
15207,9,21,Jack Roslovic,5,31,14,C,2017
15208,2,20,Jack Skille,3,16,5,RW,2007
15209,0,21,Jack Skille,1,8,1,RW,2008
15210,1,22,Jack Skille,1,6,2,RW,2009
15211,11,23,Jack Skille,8,62,19,RW,2010
15212,6,24,Jack Skille,4,46,10,RW,2011
15213,9,25,Jack Skille,3,40,12,RW,2012
15214,0,26,Jack Skille,4,16,4,RW,2013
15215,2,27,Jack Skille,6,45,8,RW,2014
15216,6,28,Jack Skille,8,74,14,RW,2015
15217,4,29,Jack Skille,5,55,9,RW,2016
15218,12,30,Jack Stanfield,8,71,20,LW,1972
15219,12,30,Jack Stanfield,8,71,20,LW,1972
15220,3,31,Jack Stanfield,1,41,4,LW,1973
15221,0,20,Jack Valiquette,0,1,0,C,1974
15222,23,21,Jack Valiquette,10,45,33,C,1975
15223,30,22,Jack Valiquette,15,66,45,C,1976
15224,13,23,Jack Valiquette,8,60,21,C,1977
15225,34,24,Jack Valiquette,23,76,57,C,1978
15226,25,25,Jack Valiquette,25,77,50,C,1979
15227,9,26,Jack Valiquette,3,25,12,C,1980
15228,2,19,Jacob De La Rose,4,33,6,LW,2014
15243,1,20,Jacob de La Rose,0,22,1,LW,2015
15244,0,21,Jacob de La Rose,0,9,0,LW,2016
15245,8,22,Jacob de La Rose,4,55,12,LW,2017
15229,7,19,Jacob Josefson,3,28,10,C,2010
15230,7,20,Jacob Josefson,2,41,9,C,2011
15231,2,21,Jacob Josefson,1,22,3,C,2012
15232,2,22,Jacob Josefson,1,27,3,C,2013
15233,5,23,Jacob Josefson,6,62,11,C,2014
15234,10,24,Jacob Josefson,4,58,14,C,2015
15235,9,25,Jacob Josefson,1,38,10,C,2016
15236,2,26,Jacob Josefson,2,39,4,C,2017
15237,0,19,Jacob Larsson,0,4,0,D,2016
15238,19,19,Jacob Trouba,10,65,29,D,2013
15239,15,20,Jacob Trouba,7,65,22,D,2014
15240,15,21,Jacob Trouba,6,81,21,D,2015
15241,25,22,Jacob Trouba,8,60,33,D,2016
15242,21,23,Jacob Trouba,3,55,24,D,2017
15246,10,25,Jacques Blain,1,70,11,D,1972
15247,10,25,Jacques Blain,1,70,11,D,1972
15248,2,21,Jacques Cossette,0,7,2,RW,1975
15249,2,23,Jacques Cossette,1,19,3,RW,1977
15250,2,24,Jacques Cossette,7,38,9,RW,1978
15251,21,26,Jacques Laperriere,4,72,25,D,1967
15252,26,27,Jacques Laperriere,5,69,31,D,1968
15253,31,28,Jacques Laperriere,6,73,37,D,1969
15254,16,29,Jacques Laperriere,0,49,16,D,1970
15255,25,30,Jacques Laperriere,3,73,28,D,1971
15256,16,31,Jacques Laperriere,7,57,23,D,1972
15257,10,32,Jacques Laperriere,2,42,12,D,1973
15258,20,22,Jacques Lemaire,22,69,42,C,1967
15259,34,23,Jacques Lemaire,29,75,63,LW,1968
15260,28,24,Jacques Lemaire,32,69,60,LW,1969
15261,28,25,Jacques Lemaire,28,78,56,LW,1970
15262,49,26,Jacques Lemaire,32,77,81,C,1971
15263,51,27,Jacques Lemaire,44,77,95,C,1972
15264,38,28,Jacques Lemaire,29,66,67,C,1973
15265,56,29,Jacques Lemaire,36,80,92,C,1974
15266,32,30,Jacques Lemaire,20,61,52,C,1975
15267,41,31,Jacques Lemaire,34,75,75,C,1976
15268,61,32,Jacques Lemaire,36,76,97,C,1977
15269,31,33,Jacques Lemaire,24,50,55,C,1978
15270,3,24,Jacques Lemieux,0,16,3,D,1967
15271,1,26,Jacques Lemieux,0,3,1,D,1969
15272,5,21,Jacques Locas,1,23,6,C,1974
15273,4,21,Jacques Locas,1,12,5,C,1974
15274,1,21,Jacques Locas,0,11,1,C,1974
15275,5,21,Jacques Locas,1,23,6,C,1974
15276,4,21,Jacques Locas,1,12,5,C,1974
15277,1,21,Jacques Locas,0,11,1,C,1974
15278,46,22,Jacques Locas,27,80,73,C,1975
15279,46,22,Jacques Locas,27,80,73,C,1975
15280,17,23,Jacques Locas,21,67,38,C,1976
15281,13,23,Jacques Locas,18,45,31,C,1976
15282,4,23,Jacques Locas,3,22,7,C,1976
15283,4,23,Jacques Locas,3,22,7,C,1976
15284,2,24,Jacques Locas,0,17,2,C,1977
15285,2,24,Jacques Locas,0,17,2,C,1977
15286,0,27,Jacques Mailhot,0,5,0,LW,1988
15287,18,20,Jacques Richard,13,74,31,LW,1972
15288,16,21,Jacques Richard,27,78,43,RW,1973
15289,12,22,Jacques Richard,17,63,29,LW,1974
15290,23,23,Jacques Richard,12,73,35,LW,1975
15291,0,24,Jacques Richard,2,21,2,LW,1976
15292,15,26,Jacques Richard,10,61,25,C,1978
15293,12,27,Jacques Richard,3,14,15,LW,1979
15294,51,28,Jacques Richard,52,78,103,RW,1980
15295,26,29,Jacques Richard,15,59,41,RW,1981
15296,14,30,Jacques Richard,9,35,23,C,1982
15297,1,19,Jaden Schwartz,2,7,3,C,2011
15298,6,20,Jaden Schwartz,7,45,13,C,2012
15299,31,21,Jaden Schwartz,25,80,56,LW,2013
15300,35,22,Jaden Schwartz,28,75,63,LW,2014
15301,14,23,Jaden Schwartz,8,33,22,LW,2015
15302,36,24,Jaden Schwartz,19,78,55,LW,2016
15303,35,25,Jaden Schwartz,24,62,59,LW,2017
15304,2,26,Jaime Sifers,0,23,2,D,2008
15305,0,27,Jaime Sifers,0,14,0,D,2009
15306,27,21,Jake Debrusk,16,70,43,LW,2017
15307,11,22,Jake Dotchin,0,35,11,D,2016
15308,8,23,Jake Dotchin,3,48,11,D,2017
15309,1,22,Jake Dowell,2,19,3,C,2007
15310,0,23,Jake Dowell,0,1,0,C,2008
15311,1,24,Jake Dowell,1,3,2,C,2009
15312,15,25,Jake Dowell,6,79,21,C,2010
15313,5,26,Jake Dowell,2,52,7,C,2011
15314,0,27,Jake Dowell,0,2,0,C,2012
15315,0,28,Jake Dowell,0,1,0,C,2013
15316,23,21,Jake Gardiner,7,75,30,D,2011
15317,4,22,Jake Gardiner,0,12,4,D,2012
15318,21,23,Jake Gardiner,10,80,31,D,2013
15319,20,24,Jake Gardiner,4,79,24,D,2014
15320,24,25,Jake Gardiner,7,79,31,D,2015
15321,34,26,Jake Gardiner,9,82,43,D,2016
15322,47,27,Jake Gardiner,5,82,52,D,2017
15323,17,22,Jake Guentzel,16,40,33,C,2016
15324,26,23,Jake Guentzel,22,82,48,C,2017
15325,1,20,Jake McCabe,0,7,1,D,2013
15326,0,21,Jake McCabe,0,2,0,D,2014
15327,10,22,Jake McCabe,4,77,14,D,2015
15328,17,23,Jake McCabe,3,76,20,D,2016
15329,9,24,Jake McCabe,3,53,12,D,2017
15330,1,21,Jake Muzzin,0,11,1,D,2010
15331,9,23,Jake Muzzin,7,45,16,D,2012
15332,19,24,Jake Muzzin,5,76,24,D,2013
15333,31,25,Jake Muzzin,10,76,41,D,2014
15334,32,26,Jake Muzzin,8,82,40,D,2015
15335,19,27,Jake Muzzin,9,82,28,D,2016
15336,34,28,Jake Muzzin,8,74,42,D,2017
15337,0,27,Jake Rathwell,0,1,0,RW,1974
15338,6,19,Jake Virtanen,7,55,13,RW,2015
15339,1,20,Jake Virtanen,0,10,1,RW,2016
15340,10,21,Jake Virtanen,10,75,20,RW,2017
15341,13,18,Jakob Chychrun,7,68,20,D,2016
15342,10,19,Jakob Chychrun,4,50,14,D,2017
15343,0,20,Jakob Forsbacka Karlsson,0,1,0,C,2016
15344,9,22,Jakob Silfverberg,10,48,19,RW,2012
15345,13,23,Jakob Silfverberg,10,52,23,RW,2013
15346,26,24,Jakob Silfverberg,13,81,39,RW,2014
15347,19,25,Jakob Silfverberg,20,82,39,RW,2015
15348,26,26,Jakob Silfverberg,23,79,49,RW,2016
15349,23,27,Jakob Silfverberg,17,77,40,RW,2017
15350,0,19,Jakub Cutta,0,3,0,D,2000
15351,0,20,Jakub Cutta,0,2,0,D,2001
15352,0,22,Jakub Cutta,0,3,0,D,2003
15353,3,26,Jakub Jerabek,1,11,4,D,2017
15354,0,22,Jakub Kindl,0,3,0,D,2009
15355,2,23,Jakub Kindl,2,48,4,D,2010
15356,12,24,Jakub Kindl,1,55,13,D,2011
15357,9,25,Jakub Kindl,4,41,13,D,2012
15358,17,26,Jakub Kindl,2,66,19,D,2013
15359,8,27,Jakub Kindl,5,35,13,D,2014
15360,6,28,Jakub Kindl,2,44,8,D,2015
15361,4,29,Jakub Kindl,0,39,4,D,2016
15362,3,21,Jakub Klepis,1,25,4,C,2005
15363,7,22,Jakub Klepis,3,41,10,C,2006
15364,3,28,Jakub Nakladal,2,27,5,D,2015
15365,0,29,Jakub Nakladal,0,3,0,D,2016
15366,1,23,Jakub Petruzalek,0,2,1,C,2008
15367,29,19,Jakub Voracek,9,80,38,RW,2008
15368,34,20,Jakub Voracek,16,81,50,RW,2009
15369,32,21,Jakub Voracek,14,80,46,RW,2010
15370,31,22,Jakub Voracek,18,78,49,RW,2011
15371,24,23,Jakub Voracek,22,48,46,RW,2012
15372,39,24,Jakub Voracek,23,82,62,RW,2013
15373,59,25,Jakub Voracek,22,82,81,RW,2014
15374,44,26,Jakub Voracek,11,73,55,RW,2015
15375,41,27,Jakub Voracek,20,82,61,RW,2016
15376,65,28,Jakub Voracek,20,82,85,RW,2017
15377,3,20,Jakub Vrana,3,21,6,LW,2016
15378,14,21,Jakub Vrana,13,73,27,LW,2017
15379,1,22,Jamal Mayers,0,6,1,C,1996
15380,5,24,Jamal Mayers,4,34,9,C,1998
15381,10,25,Jamal Mayers,7,79,17,RW,1999
15382,13,26,Jamal Mayers,8,77,21,RW,2000
15383,8,27,Jamal Mayers,9,77,17,C,2001
15384,5,28,Jamal Mayers,2,15,7,RW,2002
15385,5,29,Jamal Mayers,6,80,11,RW,2003
15386,11,31,Jamal Mayers,15,67,26,C,2005
15387,14,32,Jamal Mayers,8,80,22,RW,2006
15388,15,33,Jamal Mayers,12,80,27,RW,2007
15389,9,34,Jamal Mayers,7,71,16,RW,2008
15390,11,35,Jamal Mayers,3,71,14,RW,2009
15391,11,36,Jamal Mayers,3,78,14,RW,2010
15392,9,37,Jamal Mayers,6,81,15,RW,2011
15393,2,38,Jamal Mayers,0,19,2,RW,2012
15394,0,24,Jame Pollock,0,9,0,D,2003
15395,0,20,James Black,0,1,0,C,1989
15396,0,21,James Black,0,1,0,C,1990
15397,6,22,James Black,4,30,10,C,1991
15398,1,23,James Black,2,10,3,C,1992
15399,3,24,James Black,2,15,5,C,1993
15400,3,26,James Black,3,13,6,C,1995
15401,11,27,James Black,12,64,23,LW,1996
15402,5,28,James Black,10,52,15,RW,1997
15403,14,29,James Black,16,75,30,C,1998
15404,9,30,James Black,8,49,17,LW,1999
15405,5,31,James Black,1,42,6,LW,2000
15406,0,20,James Camazzola,0,1,0,LW,1983
15407,0,23,James Camazzola,0,2,0,LW,1986
15408,0,23,James Latos,0,1,0,RW,1988
15409,13,21,James Neal,24,77,37,LW,2008
15410,28,22,James Neal,27,78,55,LW,2009
15411,23,23,James Neal,22,79,45,LW,2010
15412,41,24,James Neal,40,80,81,LW,2011
15413,15,25,James Neal,21,40,36,LW,2012
15414,34,26,James Neal,27,59,61,LW,2013
15415,14,27,James Neal,23,67,37,LW,2014
15416,27,28,James Neal,31,82,58,RW,2015
15417,18,29,James Neal,23,70,41,RW,2016
15418,19,30,James Neal,25,71,44,LW,2017
15419,7,20,James Patrick,1,12,8,D,1983
15420,28,21,James Patrick,8,75,36,D,1984
15421,29,22,James Patrick,14,75,43,D,1985
15422,45,23,James Patrick,10,78,55,D,1986
15423,45,24,James Patrick,17,70,62,D,1987
15424,36,25,James Patrick,11,68,47,D,1988
15425,43,26,James Patrick,14,73,57,D,1989
15426,49,27,James Patrick,10,74,59,D,1990
15427,57,28,James Patrick,14,80,71,D,1991
15428,21,29,James Patrick,5,60,26,D,1992
15429,25,30,James Patrick,10,68,35,D,1993
15430,10,31,James Patrick,0,43,10,D,1994
15431,32,32,James Patrick,3,80,35,D,1995
15432,1,33,James Patrick,3,19,4,D,1996
15433,11,34,James Patrick,6,60,17,D,1997
15434,7,35,James Patrick,1,45,8,D,1998
15435,8,36,James Patrick,5,66,13,D,1999
15436,9,37,James Patrick,4,54,13,D,2000
15437,8,38,James Patrick,5,56,13,D,2001
15438,12,39,James Patrick,4,69,16,D,2002
15439,7,40,James Patrick,4,55,11,D,2003
15440,15,19,James Sheppard,4,78,19,C,2007
15441,19,20,James Sheppard,5,82,24,C,2008
15442,4,21,James Sheppard,2,64,6,C,2009
15443,3,24,James Sheppard,1,32,4,C,2012
15444,16,25,James Sheppard,4,67,20,LW,2013
15445,11,26,James Sheppard,7,71,18,C,2014
15461,20,20,James van Riemsdyk,15,78,35,LW,2009
15462,19,21,James van Riemsdyk,21,75,40,LW,2010
15463,13,22,James van Riemsdyk,11,43,24,LW,2011
15464,14,23,James van Riemsdyk,18,48,32,LW,2012
15465,31,24,James van Riemsdyk,30,80,61,LW,2013
15466,29,25,James van Riemsdyk,27,82,56,LW,2014
15467,15,26,James van Riemsdyk,14,40,29,LW,2015
15468,33,27,James van Riemsdyk,29,82,62,LW,2016
15469,18,28,James van Riemsdyk,36,81,54,LW,2017
15446,5,21,James Wisniewski,2,19,7,D,2005
15447,8,22,James Wisniewski,2,50,10,D,2006
15448,19,23,James Wisniewski,7,68,26,D,2007
15449,21,24,James Wisniewski,3,48,24,D,2008
15450,27,25,James Wisniewski,3,69,30,D,2009
15451,41,26,James Wisniewski,10,75,51,D,2010
15452,21,27,James Wisniewski,6,48,27,D,2011
15453,9,28,James Wisniewski,5,30,14,D,2012
15454,44,29,James Wisniewski,7,75,51,D,2013
15455,26,30,James Wisniewski,8,69,34,D,2014
15456,0,31,James Wisniewski,0,1,0,D,2015
15457,3,19,James Wright,2,48,5,C,2009
15458,0,20,James Wright,0,1,0,C,2010
15459,3,22,James Wright,2,38,5,C,2012
15460,2,23,James Wright,0,59,2,C,2013
15470,0,19,Jamie Allison,0,1,0,D,1994
15471,0,21,Jamie Allison,0,20,0,D,1996
15472,8,22,Jamie Allison,3,43,11,D,1997
15473,2,23,Jamie Allison,2,39,4,D,1998
15474,3,24,Jamie Allison,1,59,4,D,1999
15475,3,25,Jamie Allison,1,44,4,D,2000
15476,2,26,Jamie Allison,0,44,2,D,2001
15477,1,27,Jamie Allison,0,48,1,D,2002
15478,3,28,Jamie Allison,0,47,3,D,2003
15479,1,30,Jamie Allison,0,27,1,D,2005
15480,0,21,Jamie Arniel,0,1,0,C,2010
15481,0,23,Jamie Baker,0,1,0,C,1989
15482,0,24,Jamie Baker,2,18,2,C,1990
15483,10,25,Jamie Baker,7,52,17,C,1991
15484,29,26,Jamie Baker,19,76,48,C,1992
15485,5,27,Jamie Baker,12,65,17,C,1993
15486,4,28,Jamie Baker,7,43,11,C,1994
15487,17,29,Jamie Baker,16,77,33,C,1995
15488,8,30,Jamie Baker,8,58,16,C,1996
15489,5,31,Jamie Baker,0,13,5,C,1997
15490,1,32,Jamie Baker,0,1,1,C,1998
15491,3,20,Jamie Bateman,0,24,3,RW,1974
15492,3,20,Jamie Bateman,0,24,3,RW,1974
15493,0,21,Jamie Bateman,1,7,1,RW,1975
15494,0,21,Jamie Bateman,1,7,1,RW,1975
15495,19,20,Jamie Benn,22,82,41,LW,2009
15496,34,21,Jamie Benn,22,69,56,LW,2010
15497,37,22,Jamie Benn,26,71,63,LW,2011
15498,21,23,Jamie Benn,12,41,33,LW,2012
15499,45,24,Jamie Benn,34,81,79,C,2013
15500,52,25,Jamie Benn,35,82,87,LW,2014
15501,48,26,Jamie Benn,41,82,89,LW,2015
15502,43,27,Jamie Benn,26,77,69,LW,2016
15503,43,28,Jamie Benn,36,82,79,LW,2017
15504,0,22,Jamie Devane,0,2,0,LW,2013
15505,0,20,Jamie Doornbosch,0,1,0,D,2010
15506,0,23,Jamie Fraser,0,1,0,D,2008
15507,0,23,Jamie Fritsch,0,1,0,D,2008
15508,0,20,Jamie Gallimore,0,2,0,RW,1977
15509,0,24,Jamie Heward,0,5,0,D,1995
15510,4,25,Jamie Heward,1,20,5,RW,1996
15511,12,27,Jamie Heward,6,63,18,D,1998
15512,11,28,Jamie Heward,6,54,17,D,1999
15513,16,29,Jamie Heward,11,69,27,D,2000
15514,2,30,Jamie Heward,1,28,3,D,2001
15515,21,34,Jamie Heward,7,71,28,D,2005
15516,18,35,Jamie Heward,6,71,24,D,2006
15517,2,37,Jamie Heward,0,13,2,D,2008
15518,19,23,Jamie Hislop,7,46,26,RW,1976
15519,19,23,Jamie Hislop,7,46,26,RW,1976
15520,43,24,Jamie Hislop,24,80,67,RW,1977
15521,43,24,Jamie Hislop,24,80,67,RW,1977
15522,40,25,Jamie Hislop,30,80,70,RW,1978
15523,40,25,Jamie Hislop,30,80,70,RW,1978
15524,20,26,Jamie Hislop,19,80,39,RW,1979
15525,31,27,Jamie Hislop,25,79,56,RW,1980
15526,25,28,Jamie Hislop,16,80,41,RW,1981
15527,19,29,Jamie Hislop,14,79,33,RW,1982
15528,8,30,Jamie Hislop,1,27,9,RW,1983
15529,0,22,Jamie Hunt,0,1,0,D,2006
15530,2,22,Jamie Huscroft,0,15,2,D,1988
15531,3,23,Jamie Huscroft,2,42,5,D,1989
15532,1,24,Jamie Huscroft,0,8,1,D,1990
15533,1,27,Jamie Huscroft,0,36,1,D,1993
15534,6,28,Jamie Huscroft,0,34,6,D,1994
15535,9,29,Jamie Huscroft,3,70,12,D,1995
15536,5,30,Jamie Huscroft,0,52,5,D,1996
15537,4,31,Jamie Huscroft,0,51,4,D,1997
15538,2,32,Jamie Huscroft,0,37,2,D,1998
15539,0,33,Jamie Huscroft,0,7,0,D,1999
15540,6,26,Jamie Kennedy,4,54,10,RW,1972
15541,0,19,Jamie Langenbrunner,0,2,0,C,1994
15542,2,20,Jamie Langenbrunner,2,12,4,C,1995
15543,26,21,Jamie Langenbrunner,13,76,39,C,1996
15544,29,22,Jamie Langenbrunner,23,81,52,LW,1997
15545,33,23,Jamie Langenbrunner,12,75,45,C,1998
15546,21,24,Jamie Langenbrunner,18,65,39,RW,1999
15547,18,25,Jamie Langenbrunner,12,53,30,RW,2000
15548,19,26,Jamie Langenbrunner,13,82,32,RW,2001
15549,33,27,Jamie Langenbrunner,22,78,55,RW,2002
15550,16,28,Jamie Langenbrunner,10,53,26,RW,2003
15551,34,30,Jamie Langenbrunner,19,80,53,RW,2005
15552,37,31,Jamie Langenbrunner,23,82,60,RW,2006
15553,28,32,Jamie Langenbrunner,13,64,41,RW,2007
15554,40,33,Jamie Langenbrunner,29,81,69,RW,2008
15555,42,34,Jamie Langenbrunner,19,81,61,RW,2009
15556,23,35,Jamie Langenbrunner,9,70,32,RW,2010
15557,18,36,Jamie Langenbrunner,6,70,24,RW,2011
15558,1,37,Jamie Langenbrunner,0,4,1,RW,2012
15559,3,20,Jamie Leach,0,10,3,RW,1989
15560,0,21,Jamie Leach,2,7,2,RW,1990
15561,4,22,Jamie Leach,5,38,9,RW,1991
15562,2,23,Jamie Leach,3,24,5,RW,1992
15563,0,24,Jamie Leach,1,2,1,RW,1993
15564,0,22,Jamie Linden,0,4,0,RW,1994
15565,11,22,Jamie Lundmark,8,55,19,C,2002
15566,8,23,Jamie Lundmark,2,56,10,C,2003
15567,19,25,Jamie Lundmark,10,53,29,C,2005
15568,6,26,Jamie Lundmark,7,68,13,C,2006
15569,8,28,Jamie Lundmark,8,27,16,C,2008
15570,7,29,Jamie Lundmark,5,36,12,C,2009
15571,4,21,Jamie Macoun,1,22,5,D,1982
15572,23,22,Jamie Macoun,9,72,32,D,1983
15573,30,23,Jamie Macoun,9,70,39,D,1984
15574,21,24,Jamie Macoun,11,77,32,D,1985
15575,33,25,Jamie Macoun,7,79,40,D,1986
15576,19,27,Jamie Macoun,8,72,27,D,1988
15577,27,28,Jamie Macoun,8,78,35,D,1989
15578,15,29,Jamie Macoun,7,79,22,D,1990
15579,25,30,Jamie Macoun,5,76,30,D,1991
15580,15,31,Jamie Macoun,4,77,19,D,1992
15581,27,32,Jamie Macoun,3,82,30,D,1993
15582,8,33,Jamie Macoun,2,46,10,D,1994
15583,8,34,Jamie Macoun,0,82,8,D,1995
15584,10,35,Jamie Macoun,1,73,11,D,1996
15585,7,36,Jamie Macoun,0,74,7,D,1997
15586,10,37,Jamie Macoun,1,69,11,D,1998
15587,0,20,Jamie Masters,0,7,0,D,1975
15588,7,21,Jamie Masters,1,16,8,D,1976
15589,6,23,Jamie Masters,0,10,6,D,1978
15590,7,21,Jamie McBain,3,14,10,D,2009
15591,23,22,Jamie McBain,7,76,30,D,2010
15592,19,23,Jamie McBain,8,76,27,D,2011
15593,7,24,Jamie McBain,1,40,8,D,2012
15594,11,25,Jamie McBain,6,69,17,D,2013
15595,6,26,Jamie McBain,3,26,9,D,2014
15596,7,27,Jamie McBain,2,44,9,D,2015
15597,0,28,Jamie McBain,0,3,0,D,2016
15598,2,20,Jamie McGinn,4,35,6,LW,2008
15599,3,21,Jamie McGinn,10,59,13,LW,2009
15600,5,22,Jamie McGinn,1,49,6,LW,2010
15601,17,23,Jamie McGinn,20,78,37,LW,2011
15602,11,24,Jamie McGinn,11,47,22,LW,2012
15603,19,25,Jamie McGinn,19,79,38,LW,2013
15604,2,26,Jamie McGinn,4,19,6,LW,2014
15605,17,27,Jamie McGinn,22,84,39,LW,2015
15606,8,28,Jamie McGinn,9,72,17,LW,2016
15607,16,29,Jamie McGinn,13,76,29,LW,2017
15608,2,20,Jamie Oleksiak,0,16,2,D,2012
15609,0,21,Jamie Oleksiak,0,7,0,D,2013
15610,7,22,Jamie Oleksiak,1,36,8,D,2014
15611,2,23,Jamie Oleksiak,0,19,2,D,2015
15612,2,24,Jamie Oleksiak,5,41,7,D,2016
15613,2,25,Jamie Oleksiak,1,21,3,D,2017
15614,1,22,Jamie Pushor,0,5,1,D,1995
15615,7,23,Jamie Pushor,4,75,11,D,1996
15616,7,24,Jamie Pushor,2,64,9,D,1997
15617,2,25,Jamie Pushor,1,70,3,D,1998
15618,8,26,Jamie Pushor,0,62,8,D,1999
15619,10,27,Jamie Pushor,3,75,13,D,2000
15620,8,28,Jamie Pushor,0,76,8,D,2001
15621,1,29,Jamie Pushor,3,76,4,D,2002
15622,0,30,Jamie Pushor,0,14,0,D,2003
15623,2,32,Jamie Pushor,1,4,3,D,2005
15624,0,20,Jamie Rivers,0,3,0,D,1995
15625,5,21,Jamie Rivers,2,15,7,D,1996
15626,4,22,Jamie Rivers,2,59,6,D,1997
15627,5,23,Jamie Rivers,2,76,7,D,1998
15628,16,24,Jamie Rivers,1,75,17,D,1999
15629,4,25,Jamie Rivers,2,45,6,D,2000
15630,2,26,Jamie Rivers,4,66,6,D,2001
15631,0,27,Jamie Rivers,0,1,0,D,2002
15632,4,28,Jamie Rivers,3,50,7,D,2003
15633,6,30,Jamie Rivers,0,33,6,D,2005
15634,3,31,Jamie Rivers,1,31,4,D,2006
15635,0,28,Jamie Tardif,0,2,0,RW,2012
15636,2,21,Jamie Wright,4,21,6,LW,1997
15637,0,22,Jamie Wright,0,11,0,LW,1998
15638,4,23,Jamie Wright,1,23,5,LW,1999
15639,0,24,Jamie Wright,1,2,1,LW,2000
15640,12,25,Jamie Wright,4,44,16,LW,2001
15641,2,26,Jamie Wright,2,23,4,LW,2002
15642,3,25,Jan Benda,0,9,3,C,1997
15643,11,19,Jan Bulis,5,48,16,C,1997
15644,16,20,Jan Bulis,7,38,23,C,1998
15645,22,21,Jan Bulis,9,56,31,C,1999
15646,18,22,Jan Bulis,5,51,23,C,2000
15647,10,23,Jan Bulis,9,53,19,LW,2001
15648,24,24,Jan Bulis,16,82,40,LW,2002
15649,17,25,Jan Bulis,13,72,30,LW,2003
15650,20,27,Jan Bulis,20,73,40,LW,2005
15651,11,28,Jan Bulis,12,79,23,C,2006
15652,3,23,Jan Caloun,8,11,11,RW,1995
15653,0,24,Jan Caloun,0,2,0,RW,1996
15654,3,28,Jan Caloun,0,11,3,RW,2000
15655,25,21,Jan Erixon,5,75,30,RW,1983
15656,22,22,Jan Erixon,7,66,29,LW,1984
15657,17,23,Jan Erixon,2,31,19,RW,1985
15658,18,24,Jan Erixon,8,68,26,RW,1986
15659,19,25,Jan Erixon,7,70,26,RW,1987
15660,11,26,Jan Erixon,4,44,15,RW,1988
15661,9,27,Jan Erixon,4,58,13,RW,1989
15662,18,28,Jan Erixon,7,53,25,RW,1990
15663,9,29,Jan Erixon,8,46,17,RW,1991
15664,11,30,Jan Erixon,5,45,16,LW,1992
15665,8,28,Jan Hejda,1,39,9,D,2006
15666,13,29,Jan Hejda,0,81,13,D,2007
15667,18,30,Jan Hejda,3,82,21,D,2008
15668,10,31,Jan Hejda,3,62,13,D,2009
15669,15,32,Jan Hejda,5,77,20,D,2010
15670,14,33,Jan Hejda,5,81,19,D,2011
15671,9,34,Jan Hejda,1,46,10,D,2012
15672,11,35,Jan Hejda,6,78,17,D,2013
15673,12,36,Jan Hejda,1,81,13,D,2014
15674,23,23,Jan Hlavac,19,67,42,LW,1999
15675,36,24,Jan Hlavac,28,79,64,LW,2000
15676,15,25,Jan Hlavac,16,77,31,LW,2001
15677,16,26,Jan Hlavac,10,61,26,LW,2002
15678,21,27,Jan Hlavac,5,72,26,LW,2003
15679,23,31,Jan Hlavac,12,80,35,LW,2007
15680,29,22,Jan Hrdina,13,82,42,C,1998
15681,33,23,Jan Hrdina,13,70,46,C,1999
15682,28,24,Jan Hrdina,15,78,43,C,2000
15683,33,25,Jan Hrdina,24,79,57,LW,2001
15684,29,26,Jan Hrdina,14,61,43,LW,2002
15685,21,27,Jan Hrdina,12,68,33,C,2003
15686,23,29,Jan Hrdina,10,75,33,C,2005
15687,0,,Jan Klabouch,1,5,1,LW,1977
15688,10,21,Jan Ludvig,7,51,17,RW,1982
15689,32,22,Jan Ludvig,22,74,54,RW,1983
15690,19,23,Jan Ludvig,12,74,31,LW,1984
15691,9,24,Jan Ludvig,5,42,14,RW,1985
15692,9,25,Jan Ludvig,7,47,16,RW,1986
15693,6,26,Jan Ludvig,1,13,7,RW,1987
15694,2,27,Jan Ludvig,0,13,2,RW,1988
15695,2,28,Jan Mertzig,0,23,2,D,1998
15696,0,23,Jan Mursak,1,19,1,LW,2010
15697,2,24,Jan Mursak,1,25,3,LW,2011
15698,0,25,Jan Mursak,0,2,0,LW,2012
15699,1,28,Jan Neliba,0,6,1,RW,1978
15700,1,28,Jan Neliba,0,6,1,RW,1978
15701,0,22,Jan Nemecek,1,6,1,D,1998
15702,0,23,Jan Nemecek,0,1,0,D,1999
15703,34,25,Jan Popiel,31,76,65,LW,1972
15704,34,25,Jan Popiel,31,76,65,LW,1972
15705,17,26,Jan Popiel,22,63,39,LW,1973
15706,17,26,Jan Popiel,22,63,39,LW,1973
15707,22,27,Jan Popiel,18,60,40,LW,1974
15708,22,27,Jan Popiel,18,60,40,LW,1974
15709,7,28,Jan Popiel,4,68,11,LW,1975
15710,7,28,Jan Popiel,4,68,11,LW,1975
15711,2,29,Jan Popiel,3,28,5,LW,1976
15712,2,29,Jan Popiel,3,28,5,LW,1976
15713,14,27,Jan Rutta,6,57,20,D,2017
15714,0,28,Jan Sterbak,0,6,0,RW,1978
15715,4,22,Jan Vopat,1,11,5,D,1995
15716,5,23,Jan Vopat,4,33,9,D,1996
15717,5,24,Jan Vopat,1,21,6,D,1997
15718,6,25,Jan Vopat,5,55,11,D,1998
15719,0,26,Jan Vopat,0,6,0,D,1999
15720,0,20,Jani Rita,0,1,0,LW,2001
15721,1,21,Jani Rita,3,12,4,LW,2002
15722,0,22,Jani Rita,0,2,0,RW,2003
15723,4,24,Jani Rita,6,51,10,LW,2005
15724,2,25,Janis Sprukts,1,13,3,C,2006
15725,0,27,Janis Sprukts,0,1,0,C,2008
15726,0,19,Janne Kuokkanen,0,4,0,C,2017
15727,3,24,Janne Laukkanen,0,11,3,D,1994
15728,2,25,Janne Laukkanen,1,23,3,D,1995
15729,18,26,Janne Laukkanen,3,76,21,D,1996
15730,17,27,Janne Laukkanen,4,60,21,D,1997
15731,11,28,Janne Laukkanen,1,50,12,D,1998
15732,18,29,Janne Laukkanen,2,71,20,D,1999
15733,17,30,Janne Laukkanen,3,50,20,D,2000
15734,7,31,Janne Laukkanen,6,47,13,D,2001
15735,6,32,Janne Laukkanen,2,19,8,D,2002
15736,40,21,Janne Niinimaa,4,77,44,D,1996
15737,39,22,Janne Niinimaa,4,77,43,D,1997
15738,24,23,Janne Niinimaa,4,81,28,D,1998
15739,25,24,Janne Niinimaa,8,81,33,D,1999
15740,34,25,Janne Niinimaa,12,82,46,D,2000
15741,39,26,Janne Niinimaa,5,81,44,D,2001
15742,29,27,Janne Niinimaa,5,76,34,D,2002
15743,19,28,Janne Niinimaa,9,82,28,D,2003
15744,13,30,Janne Niinimaa,3,63,16,D,2005
15745,3,31,Janne Niinimaa,0,41,3,D,2006
15746,2,27,Janne Niskala,1,6,3,D,2008
15747,1,20,Janne Ojanen,0,3,1,C,1988
15748,13,21,Janne Ojanen,17,64,30,C,1989
15749,9,24,Janne Ojanen,4,31,13,C,1992
15750,0,26,Janne Pesonen,0,7,0,LW,2008
15751,0,21,Jannik Hansen,0,5,0,RW,2007
15752,15,22,Jannik Hansen,6,55,21,RW,2008
15753,6,23,Jannik Hansen,9,47,15,LW,2009
15754,20,24,Jannik Hansen,9,82,29,LW,2010
15755,23,25,Jannik Hansen,16,82,39,LW,2011
15756,17,26,Jannik Hansen,10,47,27,LW,2012
15757,9,27,Jannik Hansen,11,71,20,RW,2013
15758,17,28,Jannik Hansen,16,81,33,RW,2014
15759,16,29,Jannik Hansen,22,67,38,RW,2015
15760,5,30,Jannik Hansen,2,15,7,RW,2016
15761,12,31,Jannik Hansen,2,46,14,RW,2017
15762,2,26,Jarda Krupicka,2,36,4,RW,1972
15763,2,26,Jarda Krupicka,1,30,3,RW,1972
15764,0,26,Jarda Krupicka,1,6,1,RW,1972
15765,2,26,Jarda Krupicka,1,30,3,RW,1972
15766,0,26,Jarda Krupicka,1,6,1,RW,1972
15767,2,20,Jared Aulin,2,17,4,C,2002
15768,5,21,Jared Boll,5,75,10,RW,2007
15769,10,22,Jared Boll,4,75,14,RW,2008
15770,3,23,Jared Boll,4,68,7,RW,2009
15771,5,24,Jared Boll,7,73,12,RW,2010
15772,1,25,Jared Boll,2,54,3,RW,2011
15773,4,26,Jared Boll,2,43,6,RW,2012
15774,1,27,Jared Boll,1,28,2,RW,2013
15775,4,28,Jared Boll,1,72,5,RW,2014
15776,2,29,Jared Boll,1,30,3,RW,2015
15777,3,30,Jared Boll,0,51,3,RW,2016
15778,0,31,Jared Boll,1,10,1,RW,2017
15779,0,19,Jared Cowen,0,1,0,D,2009
15780,12,21,Jared Cowen,5,82,17,D,2011
15781,0,22,Jared Cowen,1,7,1,D,2012
15782,9,23,Jared Cowen,6,68,15,D,2013
15783,6,24,Jared Cowen,3,54,9,D,2014
15784,4,25,Jared Cowen,0,37,4,D,2015
15785,9,19,Jared McCann,9,69,18,C,2015
15786,6,20,Jared McCann,1,29,7,C,2016
15787,19,21,Jared McCann,9,68,28,C,2017
15788,0,26,Jared Ross,0,10,0,C,2008
15789,0,27,Jared Ross,0,3,0,C,2009
15790,8,21,Jared Spurgeon,4,53,12,D,2010
15791,20,22,Jared Spurgeon,3,70,23,D,2011
15792,10,23,Jared Spurgeon,5,39,15,D,2012
15793,21,24,Jared Spurgeon,5,67,26,D,2013
15794,16,25,Jared Spurgeon,9,66,25,D,2014
15795,18,26,Jared Spurgeon,11,77,29,D,2015
15796,28,27,Jared Spurgeon,10,76,38,D,2016
15797,28,28,Jared Spurgeon,9,61,37,D,2017
15798,0,22,Jared Staal,0,2,0,RW,2012
15799,6,24,Jari Gronstrand,1,47,7,D,1986
15800,11,25,Jari Gronstrand,3,62,14,D,1987
15801,3,26,Jari Gronstrand,1,25,4,D,1988
15802,5,27,Jari Gronstrand,3,48,8,D,1989
15803,1,28,Jari Gronstrand,0,3,1,D,1990
15804,43,20,Jari Kurri,32,75,75,LW,1980
15805,54,21,Jari Kurri,32,71,86,LW,1981
15806,59,22,Jari Kurri,45,80,104,RW,1982
15807,61,23,Jari Kurri,52,64,113,RW,1983
15808,64,24,Jari Kurri,71,73,135,RW,1984
15809,63,25,Jari Kurri,68,78,131,RW,1985
15810,54,26,Jari Kurri,54,79,108,RW,1986
15811,53,27,Jari Kurri,43,80,96,RW,1987
15812,58,28,Jari Kurri,44,76,102,RW,1988
15813,60,29,Jari Kurri,33,78,93,RW,1989
15814,37,31,Jari Kurri,23,73,60,RW,1991
15815,60,32,Jari Kurri,27,82,87,RW,1992
15816,46,33,Jari Kurri,31,81,77,RW,1993
15817,19,34,Jari Kurri,10,38,29,RW,1994
15818,27,35,Jari Kurri,18,71,45,RW,1995
15819,22,36,Jari Kurri,13,82,35,RW,1996
15820,17,37,Jari Kurri,5,70,22,C,1997
15821,0,18,Jari Kurri*,0,1,0,RW,1978
15822,0,18,Jari Kurri*,0,1,0,RW,1978
15823,0,23,Jari Torkki,1,4,1,LW,1988
15824,0,23,Jarkko Immonen,2,6,2,C,2005
15825,5,24,Jarkko Immonen,1,14,6,C,2006
15826,1,24,Jarkko Ruutu,0,8,1,LW,1999
15827,3,25,Jarkko Ruutu,3,21,6,LW,2000
15828,7,26,Jarkko Ruutu,2,49,9,RW,2001
15829,2,27,Jarkko Ruutu,2,36,4,RW,2002
15830,8,28,Jarkko Ruutu,6,71,14,RW,2003
15831,7,30,Jarkko Ruutu,10,82,17,RW,2005
15832,9,31,Jarkko Ruutu,7,81,16,LW,2006
15833,10,32,Jarkko Ruutu,6,71,16,LW,2007
15834,14,33,Jarkko Ruutu,7,78,21,LW,2008
15835,14,34,Jarkko Ruutu,12,82,26,LW,2009
15836,9,35,Jarkko Ruutu,3,73,12,LW,2010
15837,3,21,Jarkko Varvio,2,8,5,LW,1993
15838,1,22,Jarkko Varvio,1,5,2,RW,1994
15839,2,23,Jarmo Kekalainen,2,11,4,LW,1989
15840,1,24,Jarmo Kekalainen,2,16,3,LW,1990
15841,5,27,Jarmo Kekalainen,1,28,6,LW,1993
15842,0,28,Jarmo Mikatolo,0,1,0,RW,1978
15843,0,28,Jarmo Mikatolo,0,1,0,RW,1978
15844,8,28,Jarno Kultanen,2,62,10,D,2000
15845,3,29,Jarno Kultanen,0,38,3,D,2001
15846,0,30,Jarno Kultanen,0,2,0,D,2002
15847,0,25,Jarod Palmer,1,6,1,RW,2011
15848,29,19,Jarome Iginla,21,82,50,RW,1996
15849,19,20,Jarome Iginla,13,70,32,RW,1997
15850,23,21,Jarome Iginla,28,82,51,RW,1998
15851,34,22,Jarome Iginla,29,77,63,RW,1999
15852,40,23,Jarome Iginla,31,77,71,RW,2000
15853,44,24,Jarome Iginla,52,82,96,RW,2001
15854,32,25,Jarome Iginla,35,75,67,RW,2002
15855,32,26,Jarome Iginla,41,81,73,RW,2003
15856,32,28,Jarome Iginla,35,82,67,RW,2005
15857,55,29,Jarome Iginla,39,70,94,RW,2006
15858,48,30,Jarome Iginla,50,82,98,RW,2007
15859,54,31,Jarome Iginla,35,82,89,RW,2008
15860,37,32,Jarome Iginla,32,82,69,RW,2009
15861,43,33,Jarome Iginla,43,82,86,RW,2010
15862,35,34,Jarome Iginla,32,82,67,RW,2011
15863,19,35,Jarome Iginla,14,44,33,RW,2012
15864,31,36,Jarome Iginla,30,78,61,RW,2013
15865,30,37,Jarome Iginla,29,82,59,RW,2014
15866,25,38,Jarome Iginla,22,82,47,RW,2015
15867,3,39,Jarome Iginla,6,19,9,RW,2016
15868,30,18,Jaromir Jagr,27,80,57,RW,1990
15869,37,19,Jaromir Jagr,32,70,69,RW,1991
15870,60,20,Jaromir Jagr,34,81,94,RW,1992
15871,67,21,Jaromir Jagr,32,80,99,RW,1993
15872,38,22,Jaromir Jagr,32,48,70,RW,1994
15873,87,23,Jaromir Jagr,62,82,149,RW,1995
15874,48,24,Jaromir Jagr,47,63,95,RW,1996
15875,67,25,Jaromir Jagr,35,77,102,RW,1997
15876,83,26,Jaromir Jagr,44,81,127,RW,1998
15877,54,27,Jaromir Jagr,42,63,96,RW,1999
15878,69,28,Jaromir Jagr,52,81,121,RW,2000
15879,48,29,Jaromir Jagr,31,69,79,RW,2001
15880,41,30,Jaromir Jagr,36,75,77,RW,2002
15881,43,31,Jaromir Jagr,31,77,74,RW,2003
15882,69,33,Jaromir Jagr,54,82,123,RW,2005
15883,66,34,Jaromir Jagr,30,82,96,RW,2006
15884,46,35,Jaromir Jagr,25,82,71,RW,2007
15885,35,39,Jaromir Jagr,19,73,54,RW,2011
15886,19,40,Jaromir Jagr,16,45,35,RW,2012
15887,43,41,Jaromir Jagr,24,82,67,RW,2013
15888,30,42,Jaromir Jagr,17,77,47,RW,2014
15889,39,43,Jaromir Jagr,27,79,66,RW,2015
15890,30,44,Jaromir Jagr,16,82,46,RW,2016
15891,6,45,Jaromir Jagr,1,22,7,RW,2017
15892,10,26,Jaroslav Balastik,12,66,22,LW,2005
15893,1,27,Jaroslav Balastik,1,8,2,LW,2006
15894,2,25,Jaroslav Bednar,4,22,6,RW,2001
15895,22,26,Jaroslav Bednar,5,67,27,RW,2002
15896,1,27,Jaroslav Bednar,1,13,2,RW,2003
15897,20,31,Jaroslav Hlinka,8,63,28,LW,2007
15898,0,30,Jaroslav Jirik,0,3,0,RW,1969
15899,1,,Jaroslav Kocer,0,6,1,D,1977
15900,1,,Jaroslav Kocer,0,6,1,D,1977
15901,0,22,Jaroslav Kristek,0,6,0,RW,2002
15902,0,,Jaroslav Lycka,1,8,1,D,1977
15903,0,,Jaroslav Lycka,1,8,1,D,1977
15904,1,28,Jaroslav Lycka,0,5,1,RW,1978
15905,1,28,Jaroslav Lycka,0,5,1,RW,1978
15906,5,,Jaroslav Mec,2,8,7,C,1977
15907,5,,Jaroslav Mec,2,8,7,C,1977
15908,15,22,Jaroslav Modry,2,41,17,D,1993
15909,0,23,Jaroslav Modry,0,11,0,D,1994
15910,17,24,Jaroslav Modry,4,73,21,D,1995
15911,3,25,Jaroslav Modry,3,30,6,D,1996
15912,1,27,Jaroslav Modry,0,5,1,D,1998
15913,4,28,Jaroslav Modry,5,26,9,D,1999
15914,15,29,Jaroslav Modry,4,63,19,D,2000
15915,38,30,Jaroslav Modry,4,80,42,D,2001
15916,25,31,Jaroslav Modry,13,82,38,D,2002
15917,27,32,Jaroslav Modry,5,79,32,D,2003
15918,31,34,Jaroslav Modry,7,79,38,D,2005
15919,17,35,Jaroslav Modry,1,76,18,D,2006
15920,8,36,Jaroslav Modry,1,80,9,D,2007
15921,0,24,Jaroslav Obsut,0,4,0,D,2000
15922,0,25,Jaroslav Obsut,0,3,0,D,2001
15923,2,24,Jaroslav Otevrel,0,7,2,C,1992
15924,2,25,Jaroslav Otevrel,3,9,5,C,1993
15925,18,31,Jaroslav Pouzar,15,74,33,LW,1982
15926,19,32,Jaroslav Pouzar,13,67,32,LW,1983
15927,8,33,Jaroslav Pouzar,4,33,12,LW,1984
15928,3,35,Jaroslav Pouzar,2,12,5,LW,1986
15929,2,24,Jaroslav Sevcik,0,13,2,LW,1989
15930,12,24,Jaroslav Spacek,3,63,15,D,1998
15931,26,25,Jaroslav Spacek,10,82,36,D,1999
15932,19,26,Jaroslav Spacek,7,62,26,D,2000
15933,13,27,Jaroslav Spacek,5,74,18,D,2001
15934,36,28,Jaroslav Spacek,9,81,45,D,2002
15935,17,29,Jaroslav Spacek,5,58,22,D,2003
15936,31,31,Jaroslav Spacek,12,76,43,D,2005
15937,16,32,Jaroslav Spacek,5,65,21,D,2006
15938,23,33,Jaroslav Spacek,9,60,32,D,2007
15939,37,34,Jaroslav Spacek,8,80,45,D,2008
15940,18,35,Jaroslav Spacek,3,74,21,D,2009
15941,15,36,Jaroslav Spacek,1,59,16,D,2010
15942,10,37,Jaroslav Spacek,5,46,15,D,2011
15943,3,20,Jaroslav Svejkovsky,7,19,10,LW,1996
15944,1,21,Jaroslav Svejkovsky,4,17,5,RW,1997
15945,8,22,Jaroslav Svejkovsky,6,25,14,RW,1998
15946,7,23,Jaroslav Svejkovsky,6,52,13,LW,1999
15947,2,21,Jaroslav Svoboda,2,10,4,LW,2001
15948,11,22,Jaroslav Svoboda,3,48,14,LW,2002
15949,1,23,Jaroslav Svoboda,3,33,4,LW,2003
15950,3,25,Jaroslav Svoboda,4,43,7,LW,2005
15951,0,28,Jaroslav Vlk,0,4,0,RW,1978
15952,0,28,Jaroslav Vlk,0,4,0,RW,1978
15953,2,20,Jarred Tinordi,0,8,2,D,2012
15954,2,21,Jarred Tinordi,0,22,2,D,2013
15955,2,22,Jarred Tinordi,0,13,2,D,2014
15956,0,23,Jarred Tinordi,0,10,0,D,2015
15957,1,20,Jarret Stoll,0,4,1,C,2002
15958,11,21,Jarret Stoll,10,68,21,C,2003
15959,46,23,Jarret Stoll,22,82,68,C,2005
15960,26,24,Jarret Stoll,13,51,39,C,2006
15961,22,25,Jarret Stoll,14,81,36,C,2007
15962,23,26,Jarret Stoll,18,74,41,C,2008
15963,31,27,Jarret Stoll,16,73,47,C,2009
15964,23,28,Jarret Stoll,20,82,43,C,2010
15965,15,29,Jarret Stoll,6,78,21,C,2011
15966,11,30,Jarret Stoll,7,48,18,C,2012
15967,19,31,Jarret Stoll,8,78,27,C,2013
15968,11,32,Jarret Stoll,6,73,17,C,2014
15969,5,33,Jarret Stoll,4,80,9,C,2015
15970,1,21,Jarrett Deuling,0,14,1,LW,1995
15971,0,22,Jarrett Deuling,0,1,0,LW,1996
15972,1,19,Jarrod Skalde,0,1,1,C,1990
15973,4,20,Jarrod Skalde,2,15,6,C,1991
15974,2,21,Jarrod Skalde,0,11,2,C,1992
15975,4,22,Jarrod Skalde,5,20,9,C,1993
15976,0,24,Jarrod Skalde,0,1,0,C,1995
15977,7,26,Jarrod Skalde,4,30,11,C,1997
15978,1,27,Jarrod Skalde,1,17,2,C,1998
15979,2,29,Jarrod Skalde,1,19,3,C,2000
15980,0,30,Jarrod Skalde,0,1,0,C,2001
15981,0,22,Jason Akeson,1,1,1,C,2012
15982,1,23,Jason Akeson,0,1,1,RW,2013
15983,0,24,Jason Akeson,0,13,0,RW,2014
15984,1,18,Jason Allison,0,2,1,C,1993
15985,1,19,Jason Allison,2,12,3,C,1994
15986,3,20,Jason Allison,0,19,3,C,1995
15987,26,21,Jason Allison,8,72,34,C,1996
15988,50,22,Jason Allison,33,81,83,C,1997
15989,53,23,Jason Allison,23,82,76,C,1998
15990,18,24,Jason Allison,10,37,28,C,1999
15991,59,25,Jason Allison,36,82,95,C,2000
15992,55,26,Jason Allison,19,73,74,C,2001
15993,22,27,Jason Allison,6,26,28,C,2002
15994,43,30,Jason Allison,17,66,60,C,2005
15995,35,19,Jason Arnott,33,78,68,C,1993
15996,22,20,Jason Arnott,15,42,37,C,1994
15997,31,21,Jason Arnott,28,64,59,C,1995
15998,38,22,Jason Arnott,19,67,57,C,1996
15999,23,23,Jason Arnott,10,70,33,RW,1997
16000,27,24,Jason Arnott,27,74,54,C,1998
16001,34,25,Jason Arnott,22,76,56,RW,1999
16002,34,26,Jason Arnott,21,54,55,C,2000
16003,20,27,Jason Arnott,25,73,45,C,2001
16004,24,28,Jason Arnott,23,72,47,C,2002
16005,36,29,Jason Arnott,21,73,57,C,2003
16006,44,31,Jason Arnott,32,81,76,C,2005
16007,27,32,Jason Arnott,27,68,54,C,2006
16008,44,33,Jason Arnott,28,79,72,C,2007
16009,24,34,Jason Arnott,33,65,57,C,2008
16010,27,35,Jason Arnott,19,63,46,C,2009
16011,14,36,Jason Arnott,17,73,31,C,2010
16012,17,37,Jason Arnott,17,72,34,C,2011
16013,0,25,Jason Blake,1,1,1,C,1998
16014,18,26,Jason Blake,5,64,23,C,1999
16015,11,27,Jason Blake,5,47,16,C,2000
16016,10,28,Jason Blake,8,82,18,C,2001
16017,30,29,Jason Blake,25,81,55,LW,2002
16018,25,30,Jason Blake,22,75,47,LW,2003
16019,29,32,Jason Blake,28,76,57,LW,2005
16020,29,33,Jason Blake,40,82,69,LW,2006
16021,37,34,Jason Blake,15,82,52,LW,2007
16022,38,35,Jason Blake,25,78,63,LW,2008
16023,25,36,Jason Blake,16,82,41,C,2009
16024,16,37,Jason Blake,16,76,32,C,2010
16025,5,38,Jason Blake,7,45,12,C,2011
16026,0,18,Jason Bonsignore,1,1,1,C,1994
16027,2,19,Jason Bonsignore,0,20,2,C,1995
16028,8,21,Jason Bonsignore,2,35,10,C,1997
16029,3,22,Jason Bonsignore,0,23,3,C,1998
16030,0,21,Jason Botterill,0,4,0,LW,1997
16031,0,22,Jason Botterill,0,17,0,LW,1998
16032,4,23,Jason Botterill,1,27,5,LW,1999
16033,0,25,Jason Botterill,1,4,1,LW,2001
16034,4,26,Jason Botterill,1,17,5,LW,2002
16035,1,27,Jason Botterill,2,19,3,LW,2003
16036,0,19,Jason Bowen,1,7,1,D,1992
16037,5,20,Jason Bowen,1,56,6,D,1993
16038,0,21,Jason Bowen,0,4,0,D,1994
16039,0,22,Jason Bowen,0,2,0,D,1995
16040,1,23,Jason Bowen,0,4,1,D,1996
16041,0,24,Jason Bowen,0,4,0,D,1997
16042,0,21,Jason Chimera,0,1,0,C,2000
16043,0,22,Jason Chimera,1,3,1,C,2001
16044,9,23,Jason Chimera,14,66,23,C,2002
16045,8,24,Jason Chimera,4,60,12,LW,2003
16046,13,26,Jason Chimera,17,80,30,LW,2005
16047,21,27,Jason Chimera,15,82,36,LW,2006
16048,17,28,Jason Chimera,14,81,31,LW,2007
16049,14,29,Jason Chimera,8,49,22,LW,2008
16050,19,30,Jason Chimera,15,78,34,LW,2009
16051,16,31,Jason Chimera,10,81,26,LW,2010
16052,19,32,Jason Chimera,20,82,39,LW,2011
16053,11,33,Jason Chimera,3,47,14,LW,2012
16054,27,34,Jason Chimera,15,82,42,LW,2013
16055,12,35,Jason Chimera,7,77,19,LW,2014
16056,20,36,Jason Chimera,20,82,40,LW,2015
16057,13,37,Jason Chimera,20,82,33,LW,2016
16058,1,38,Jason Chimera,1,16,2,LW,2017
16059,0,20,Jason Cirone,0,3,0,C,1991
16060,7,20,Jason Dawe,6,32,13,LW,1993
16061,4,21,Jason Dawe,7,42,11,LW,1994
16062,25,22,Jason Dawe,25,67,50,RW,1995
16063,26,23,Jason Dawe,22,81,48,RW,1996
16064,19,24,Jason Dawe,20,81,39,RW,1997
16065,8,25,Jason Dawe,6,59,14,RW,1998
16066,1,26,Jason Dawe,0,3,1,RW,1999
16067,0,28,Jason Dawe,0,1,0,RW,2001
16068,17,21,Jason Demers,4,51,21,D,2009
16069,22,22,Jason Demers,2,75,24,D,2010
16070,9,23,Jason Demers,4,57,13,D,2011
16071,2,24,Jason Demers,1,22,3,D,2012
16072,29,25,Jason Demers,5,75,34,D,2013
16073,20,26,Jason Demers,5,81,25,D,2014
16074,16,27,Jason Demers,7,62,23,D,2015
16075,19,28,Jason Demers,9,81,28,D,2016
16076,14,29,Jason Demers,6,69,20,D,2017
16077,0,20,Jason Dickinson,1,1,1,C,2015
16078,0,21,Jason Dickinson,2,10,2,C,2016
16079,2,22,Jason Dickinson,0,27,2,C,2017
16080,1,19,Jason Doig,1,15,2,D,1995
16081,1,21,Jason Doig,0,4,1,D,1997
16082,1,22,Jason Doig,0,9,1,D,1998
16083,1,23,Jason Doig,0,7,1,D,1999
16084,0,24,Jason Doig,0,3,0,D,2000
16085,5,26,Jason Doig,3,55,8,D,2002
16086,9,27,Jason Doig,2,65,11,D,2003
16087,0,24,Jason Garrison,0,1,0,D,2008
16088,6,25,Jason Garrison,2,39,8,D,2009
16089,13,26,Jason Garrison,5,73,18,D,2010
16090,17,27,Jason Garrison,16,77,33,D,2011
16091,8,28,Jason Garrison,8,47,16,D,2012
16092,26,29,Jason Garrison,7,81,33,D,2013
16093,26,30,Jason Garrison,4,70,30,D,2014
16094,6,31,Jason Garrison,5,72,11,D,2015
16095,8,32,Jason Garrison,1,70,9,D,2016
16096,1,33,Jason Garrison,0,8,1,D,2017
16097,1,25,Jason Herter,0,1,1,D,1995
16098,0,20,Jason Holland,1,4,1,D,1996
16099,0,21,Jason Holland,0,8,0,D,1997
16100,0,22,Jason Holland,0,3,0,D,1998
16101,1,23,Jason Holland,0,9,1,D,1999
16102,0,25,Jason Holland,0,3,0,D,2001
16103,1,26,Jason Holland,0,2,1,D,2002
16104,3,27,Jason Holland,3,52,6,D,2003
16105,4,26,Jason Jaffray,2,19,6,RW,2007
16106,2,27,Jason Jaffray,2,14,4,RW,2008
16107,0,28,Jason Jaffray,0,3,0,RW,2009
16108,1,30,Jason Jaffray,0,13,1,RW,2011
16109,1,20,Jason Jaspers,0,4,1,C,2001
16110,0,21,Jason Jaspers,0,2,0,C,2002
16111,0,22,Jason Jaspers,0,3,0,C,2003
16112,2,21,Jason King,0,8,2,C,2002
16113,9,22,Jason King,12,47,21,RW,2003
16114,0,26,Jason King,0,4,0,RW,2007
16115,4,24,Jason Krog,2,17,6,C,1999
16116,3,25,Jason Krog,0,9,3,LW,2000
16117,0,26,Jason Krog,0,2,0,C,2001
16118,15,27,Jason Krog,10,67,25,C,2002
16119,12,28,Jason Krog,6,80,18,RW,2003
16120,3,31,Jason Krog,3,23,6,C,2006
16121,0,33,Jason Krog,1,4,1,C,2008
16122,15,20,Jason Lafreniere,13,56,28,C,1986
16123,19,21,Jason Lafreniere,10,40,29,C,1987
16124,16,22,Jason Lafreniere,8,38,24,C,1988
16125,3,26,Jason Lafreniere,3,11,6,C,1992
16126,0,27,Jason Lafreniere,0,1,0,LW,1993
16127,0,29,Jason MacDonald,0,4,0,RW,2003
16128,0,20,Jason Marshall,1,2,1,D,1991
16129,0,23,Jason Marshall,0,1,0,D,1994
16130,1,24,Jason Marshall,0,24,1,D,1995
16131,9,25,Jason Marshall,1,73,10,D,1996
16132,6,26,Jason Marshall,3,72,9,D,1997
16133,7,27,Jason Marshall,1,72,8,D,1998
16134,3,28,Jason Marshall,0,55,3,D,1999
16135,4,29,Jason Marshall,3,55,7,D,2000
16136,6,30,Jason Marshall,5,80,11,D,2001
16137,5,31,Jason Marshall,1,45,6,D,2002
16138,6,32,Jason Marshall,1,24,7,D,2003
16139,4,34,Jason Marshall,0,23,4,D,2005
16140,0,21,Jason McBain,0,3,0,D,1995
16141,0,22,Jason McBain,0,6,0,D,1996
16142,0,19,Jason Miller,0,1,0,C,1990
16143,0,20,Jason Miller,0,3,0,C,1991
16144,0,21,Jason Miller,0,2,0,C,1992
16145,0,20,Jason Morgan,0,3,0,C,1996
16146,0,21,Jason Morgan,1,11,1,C,1997
16147,4,27,Jason Morgan,0,19,4,LW,2003
16148,1,29,Jason Morgan,1,7,2,C,2005
16149,0,30,Jason Morgan,0,4,0,C,2006
16150,4,20,Jason Podollan,1,29,5,C,1996
16151,0,22,Jason Podollan,0,10,0,RW,1998
16152,1,23,Jason Podollan,0,1,1,RW,1999
16153,0,25,Jason Podollan,0,1,0,RW,2001
16154,0,21,Jason Pominville,0,1,0,RW,2003
16155,12,23,Jason Pominville,18,57,30,RW,2005
16156,34,24,Jason Pominville,34,82,68,RW,2006
16157,53,25,Jason Pominville,27,82,80,RW,2007
16158,46,26,Jason Pominville,20,82,66,RW,2008
16159,38,27,Jason Pominville,24,82,62,RW,2009
16160,30,28,Jason Pominville,22,73,52,RW,2010
16161,43,29,Jason Pominville,30,82,73,RW,2011
16162,20,30,Jason Pominville,14,47,34,RW,2012
16163,30,31,Jason Pominville,30,82,60,RW,2013
16164,36,32,Jason Pominville,18,82,54,RW,2014
16165,25,33,Jason Pominville,11,75,36,RW,2015
16166,34,34,Jason Pominville,13,78,47,RW,2016
16167,18,35,Jason Pominville,16,82,34,RW,2017
16168,1,23,Jason Ruff,2,8,3,LW,1992
16169,2,24,Jason Ruff,1,6,3,LW,1993
16170,0,22,Jason Ryznar,0,8,0,LW,2005
16171,0,24,Jason Simon,0,4,0,LW,1993
16172,0,27,Jason Simon,0,1,0,LW,1996
16173,5,20,Jason Smith,0,41,5,D,1993
16174,0,21,Jason Smith,0,2,0,D,1994
16175,1,22,Jason Smith,2,64,3,D,1995
16176,7,23,Jason Smith,1,78,8,D,1996
16177,13,24,Jason Smith,3,81,16,D,1997
16178,12,25,Jason Smith,3,72,15,D,1998
16179,11,26,Jason Smith,3,80,14,D,1999
16180,15,27,Jason Smith,5,82,20,D,2000
16181,13,28,Jason Smith,5,74,18,D,2001
16182,8,29,Jason Smith,4,68,12,D,2002
16183,12,30,Jason Smith,7,68,19,D,2003
16184,13,32,Jason Smith,4,76,17,D,2005
16185,9,33,Jason Smith,2,82,11,D,2006
16186,9,34,Jason Smith,1,77,10,D,2007
16187,0,35,Jason Smith,1,63,1,D,2008
16188,14,19,Jason Spezza,7,33,21,C,2002
16189,33,20,Jason Spezza,22,78,55,C,2003
16190,71,22,Jason Spezza,19,68,90,C,2005
16191,53,23,Jason Spezza,34,67,87,C,2006
16192,58,24,Jason Spezza,34,76,92,C,2007
16193,41,25,Jason Spezza,32,82,73,C,2008
16194,34,26,Jason Spezza,23,60,57,C,2009
16195,36,27,Jason Spezza,21,62,57,C,2010
16196,50,28,Jason Spezza,34,80,84,C,2011
16197,3,29,Jason Spezza,2,5,5,C,2012
16198,43,30,Jason Spezza,23,75,66,C,2013
16199,45,31,Jason Spezza,17,82,62,C,2014
16200,30,32,Jason Spezza,33,75,63,C,2015
16201,35,33,Jason Spezza,15,68,50,C,2016
16202,18,34,Jason Spezza,8,78,26,C,2017
16203,0,20,Jason Strudwick,0,1,0,D,1995
16204,2,22,Jason Strudwick,0,28,2,D,1997
16205,3,23,Jason Strudwick,0,65,3,D,1998
16206,3,24,Jason Strudwick,1,63,4,D,1999
16207,4,25,Jason Strudwick,1,60,5,D,2000
16208,4,26,Jason Strudwick,2,44,6,D,2001
16209,3,27,Jason Strudwick,2,48,5,D,2002
16210,3,28,Jason Strudwick,1,54,4,D,2003
16211,4,30,Jason Strudwick,3,65,7,D,2005
16212,0,31,Jason Strudwick,0,8,0,D,2006
16213,1,32,Jason Strudwick,1,52,2,D,2007
16214,7,33,Jason Strudwick,2,71,9,D,2008
16215,6,34,Jason Strudwick,0,72,6,D,2009
16216,2,35,Jason Strudwick,0,43,2,D,2010
16217,1,21,Jason Ward,2,32,3,RW,1999
16218,0,22,Jason Ward,0,12,0,RW,2000
16219,2,24,Jason Ward,3,8,5,RW,2002
16220,7,25,Jason Ward,5,53,12,RW,2003
16221,18,27,Jason Ward,10,81,28,RW,2005
16222,11,28,Jason Ward,8,70,19,RW,2006
16223,6,29,Jason Ward,8,79,14,RW,2007
16224,0,30,Jason Ward,0,1,0,RW,2008
16225,0,21,Jason Widmer,0,1,0,D,1994
16226,0,22,Jason Widmer,0,4,0,D,1995
16227,1,23,Jason Widmer,0,2,1,D,1996
16228,4,18,Jason Wiemer,1,36,5,LW,1994
16229,9,19,Jason Wiemer,9,66,18,LW,1995
16230,5,20,Jason Wiemer,9,63,14,LW,1996
16231,10,21,Jason Wiemer,12,79,22,LW,1997
16232,13,22,Jason Wiemer,8,78,21,C,1998
16233,11,23,Jason Wiemer,11,64,22,LW,1999
16234,5,24,Jason Wiemer,10,65,15,C,2000
16235,20,25,Jason Wiemer,11,70,31,C,2001
16236,19,26,Jason Wiemer,9,81,28,LW,2002
16237,14,27,Jason Wiemer,8,75,22,C,2003
16238,2,29,Jason Wiemer,2,49,4,LW,2005
16239,3,20,Jason Williams,0,5,3,RW,2000
16240,2,21,Jason Williams,8,25,10,RW,2001
16241,3,22,Jason Williams,3,16,6,C,2002
16242,7,23,Jason Williams,6,49,13,C,2003
16243,37,25,Jason Williams,21,80,58,RW,2005
16244,17,26,Jason Williams,15,78,32,C,2006
16245,23,27,Jason Williams,13,43,36,RW,2007
16246,28,28,Jason Williams,19,80,47,RW,2008
16247,9,29,Jason Williams,6,44,15,C,2009
16248,3,30,Jason Williams,2,27,5,C,2010
16249,1,31,Jason Williams,1,8,2,C,2011
16250,0,22,Jason Woolley,0,1,0,D,1991
16251,2,23,Jason Woolley,0,26,2,D,1992
16252,2,24,Jason Woolley,1,10,3,D,1993
16253,9,25,Jason Woolley,4,34,13,D,1994
16254,28,26,Jason Woolley,6,52,34,D,1995
16255,30,27,Jason Woolley,6,60,36,D,1996
16256,26,28,Jason Woolley,9,71,35,D,1997
16257,33,29,Jason Woolley,10,80,43,D,1998
16258,25,30,Jason Woolley,8,74,33,D,1999
16259,18,31,Jason Woolley,5,67,23,D,2000
16260,20,32,Jason Woolley,8,59,28,D,2001
16261,20,33,Jason Woolley,6,76,26,D,2002
16262,15,34,Jason Woolley,4,55,19,D,2003
16263,18,36,Jason Woolley,1,53,19,D,2005
16264,0,22,Jason York,0,2,0,D,1992
16265,2,23,Jason York,1,7,3,D,1993
16266,10,24,Jason York,1,25,11,D,1994
16267,21,25,Jason York,3,79,24,D,1995
16268,17,26,Jason York,4,75,21,D,1996
16269,13,27,Jason York,3,73,16,D,1997
16270,31,28,Jason York,4,79,35,D,1998
16271,22,29,Jason York,8,79,30,D,1999
16272,16,30,Jason York,6,74,22,D,2000
16273,20,31,Jason York,5,74,25,D,2001
16274,15,32,Jason York,4,74,19,D,2002
16275,13,33,Jason York,2,67,15,D,2003
16276,7,36,Jason York,1,49,8,D,2006
16277,3,25,Jason Zent,3,22,6,LW,1996
16278,0,26,Jason Zent,0,3,0,LW,1997
16279,0,27,Jason Zent,0,2,0,LW,1998
16280,2,20,Jason Zucker,0,6,2,LW,2011
16281,1,21,Jason Zucker,4,20,5,LW,2012
16282,1,22,Jason Zucker,4,21,5,LW,2013
16283,5,23,Jason Zucker,21,51,26,LW,2014
16284,10,24,Jason Zucker,13,71,23,LW,2015
16285,25,25,Jason Zucker,22,79,47,LW,2016
16286,31,26,Jason Zucker,33,82,64,LW,2017
16287,2,22,Jassen Cullimore,1,34,3,D,1994
16288,1,23,Jassen Cullimore,1,27,2,D,1995
16289,6,24,Jassen Cullimore,2,52,8,D,1996
16290,2,25,Jassen Cullimore,1,28,3,D,1997
16291,12,26,Jassen Cullimore,5,78,17,D,1998
16292,1,27,Jassen Cullimore,1,46,2,D,1999
16293,6,28,Jassen Cullimore,1,74,7,D,2000
16294,9,29,Jassen Cullimore,4,78,13,D,2001
16295,3,30,Jassen Cullimore,1,28,4,D,2002
16296,5,31,Jassen Cullimore,2,79,7,D,2003
16297,6,33,Jassen Cullimore,1,54,7,D,2005
16298,6,34,Jassen Cullimore,1,65,7,D,2006
16299,10,35,Jassen Cullimore,3,65,13,D,2007
16300,8,36,Jassen Cullimore,2,68,10,D,2008
16301,8,38,Jassen Cullimore,0,36,8,D,2010
16302,0,23,Jay Beagle,0,3,0,C,2008
16303,1,24,Jay Beagle,1,7,2,C,2009
16304,1,25,Jay Beagle,2,31,3,C,2010
16305,1,26,Jay Beagle,4,41,5,C,2011
16306,6,27,Jay Beagle,2,48,8,C,2012
16307,5,28,Jay Beagle,4,62,9,C,2013
16308,10,29,Jay Beagle,10,62,20,RW,2014
16309,9,30,Jay Beagle,8,57,17,RW,2015
16310,17,31,Jay Beagle,13,81,30,RW,2016
16311,15,32,Jay Beagle,7,79,22,RW,2017
16312,12,19,Jay Bouwmeester,4,82,16,D,2002
16313,18,20,Jay Bouwmeester,2,61,20,D,2003
16314,41,22,Jay Bouwmeester,5,82,46,D,2005
16315,30,23,Jay Bouwmeester,12,82,42,D,2006
16316,22,24,Jay Bouwmeester,15,82,37,D,2007
16317,27,25,Jay Bouwmeester,15,82,42,D,2008
16318,26,26,Jay Bouwmeester,3,82,29,D,2009
16319,20,27,Jay Bouwmeester,4,82,24,D,2010
16320,24,28,Jay Bouwmeester,5,82,29,D,2011
16321,15,29,Jay Bouwmeester,7,47,22,D,2012
16322,33,30,Jay Bouwmeester,4,82,37,D,2013
16323,11,31,Jay Bouwmeester,2,72,13,D,2014
16324,16,32,Jay Bouwmeester,3,72,19,D,2015
16325,14,33,Jay Bouwmeester,1,81,15,D,2016
16326,5,34,Jay Bouwmeester,2,35,7,D,2017
16327,1,26,Jay Caufield,2,13,3,D,1986
16328,0,27,Jay Caufield,0,1,0,D,1987
16329,4,28,Jay Caufield,1,58,5,RW,1988
16330,2,29,Jay Caufield,1,37,3,RW,1989
16331,1,30,Jay Caufield,1,23,2,RW,1990
16332,0,31,Jay Caufield,0,50,0,RW,1991
16333,0,32,Jay Caufield,0,26,0,RW,1992
16334,1,23,Jay Harrison,0,8,1,D,2005
16335,0,24,Jay Harrison,0,5,0,D,2006
16336,1,26,Jay Harrison,0,7,1,D,2008
16337,5,27,Jay Harrison,1,38,6,D,2009
16338,7,28,Jay Harrison,3,72,10,D,2010
16339,14,29,Jay Harrison,9,72,23,D,2011
16340,7,30,Jay Harrison,3,47,10,D,2012
16341,11,31,Jay Harrison,4,68,15,D,2013
16342,6,32,Jay Harrison,3,55,9,D,2014
16343,0,20,Jay Henderson,0,4,0,LW,1998
16344,3,21,Jay Henderson,1,16,4,LW,1999
16345,0,22,Jay Henderson,0,13,0,LW,2000
16346,0,22,Jay Johnston,0,2,0,D,1980
16347,0,23,Jay Johnston,0,6,0,D,1981
16348,0,26,Jay Leach,0,2,0,D,2005
16349,0,28,Jay Leach,0,2,0,D,2007
16350,1,29,Jay Leach,0,24,1,D,2008
16351,1,30,Jay Leach,1,35,2,D,2009
16352,0,31,Jay Leach,0,7,0,D,2010
16353,0,24,Jay Mazur,0,1,0,C,1988
16354,0,25,Jay Mazur,0,5,0,C,1989
16355,7,26,Jay Mazur,11,36,18,C,1990
16356,0,27,Jay Mazur,0,5,0,C,1991
16357,21,22,Jay McClement,6,67,27,C,2005
16358,28,23,Jay McClement,8,81,36,C,2006
16359,13,24,Jay McClement,9,81,22,C,2007
16360,14,25,Jay McClement,12,82,26,C,2008
16361,18,26,Jay McClement,11,82,29,C,2009
16362,13,27,Jay McClement,7,80,20,C,2010
16363,7,28,Jay McClement,10,80,17,C,2011
16364,9,29,Jay McClement,8,48,17,C,2012
16365,6,30,Jay McClement,4,81,10,C,2013
16366,14,31,Jay McClement,7,82,21,C,2014
16367,8,32,Jay McClement,3,77,11,C,2015
16368,3,33,Jay McClement,5,65,8,C,2016
16369,1,18,Jay McKee,0,1,1,D,1995
16370,9,19,Jay McKee,1,43,10,D,1996
16371,13,20,Jay McKee,1,56,14,D,1997
16372,6,21,Jay McKee,0,72,6,D,1998
16373,12,22,Jay McKee,5,78,17,D,1999
16374,10,23,Jay McKee,1,74,11,D,2000
16375,11,24,Jay McKee,2,81,13,D,2001
16376,5,25,Jay McKee,0,59,5,D,2002
16377,3,26,Jay McKee,2,43,5,D,2003
16378,11,28,Jay McKee,5,75,16,D,2005
16379,0,29,Jay McKee,0,23,0,D,2006
16380,7,30,Jay McKee,2,66,9,D,2007
16381,7,31,Jay McKee,1,69,8,D,2008
16382,9,32,Jay McKee,1,62,10,D,2009
16383,0,25,Jay Miller,3,46,3,LW,1985
16384,4,26,Jay Miller,1,55,5,LW,1986
16385,12,27,Jay Miller,7,78,19,LW,1987
16386,7,28,Jay Miller,7,66,14,LW,1988
16387,2,29,Jay Miller,10,68,12,LW,1989
16388,12,30,Jay Miller,8,66,20,LW,1990
16389,7,31,Jay Miller,4,67,11,LW,1991
16390,0,20,Jay More,0,1,0,D,1988
16391,0,21,Jay More,0,5,0,D,1989
16392,13,23,Jay More,4,46,17,D,1991
16393,6,24,Jay More,5,73,11,D,1992
16394,6,25,Jay More,1,49,7,D,1993
16395,6,26,Jay More,0,45,6,D,1994
16396,7,27,Jay More,2,74,9,D,1995
16397,7,28,Jay More,1,37,8,D,1996
16398,7,29,Jay More,5,58,12,D,1997
16399,2,30,Jay More,0,18,2,D,1998
16400,8,22,Jay Pandolfo,6,46,14,LW,1996
16401,3,23,Jay Pandolfo,1,23,4,LW,1997
16402,13,24,Jay Pandolfo,14,70,27,LW,1998
16403,8,25,Jay Pandolfo,7,71,15,LW,1999
16404,12,26,Jay Pandolfo,4,63,16,LW,2000
16405,10,27,Jay Pandolfo,4,65,14,RW,2001
16406,11,28,Jay Pandolfo,6,68,17,LW,2002
16407,13,29,Jay Pandolfo,13,82,26,LW,2003
16408,10,31,Jay Pandolfo,10,82,20,RW,2005
16409,14,32,Jay Pandolfo,13,82,27,LW,2006
16410,12,33,Jay Pandolfo,12,54,24,LW,2007
16411,5,34,Jay Pandolfo,5,61,10,LW,2008
16412,5,35,Jay Pandolfo,4,52,9,LW,2009
16413,2,37,Jay Pandolfo,1,62,3,LW,2011
16414,0,38,Jay Pandolfo,0,18,0,LW,2012
16415,1,24,Jay Rosehill,1,15,2,D,2009
16416,2,25,Jay Rosehill,1,26,3,D,2010
16417,0,26,Jay Rosehill,0,31,0,D,2011
16418,0,27,Jay Rosehill,1,11,1,D,2012
16419,0,28,Jay Rosehill,2,34,2,LW,2013
16420,0,20,Jay Wells,0,43,0,D,1979
16421,13,21,Jay Wells,5,72,18,D,1980
16422,8,22,Jay Wells,1,60,9,D,1981
16423,12,23,Jay Wells,3,69,15,D,1982
16424,18,24,Jay Wells,3,69,21,D,1983
16425,9,25,Jay Wells,2,77,11,D,1984
16426,31,26,Jay Wells,11,79,42,D,1985
16427,29,27,Jay Wells,7,77,36,D,1986
16428,23,28,Jay Wells,2,58,25,D,1987
16429,19,29,Jay Wells,2,67,21,D,1988
16430,17,30,Jay Wells,3,60,20,D,1989
16431,2,31,Jay Wells,1,43,3,D,1990
16432,9,32,Jay Wells,2,52,11,D,1991
16433,9,33,Jay Wells,1,53,10,D,1992
16434,7,34,Jay Wells,2,79,9,D,1993
16435,7,35,Jay Wells,2,43,9,D,1994
16436,3,36,Jay Wells,0,76,3,D,1995
16437,0,37,Jay Wells,0,21,0,D,1996
16438,0,24,Jaycob Megna,0,1,0,D,2016
16439,1,25,Jaycob Megna,0,14,1,D,2017
16440,4,23,Jayson Megna,5,36,9,C,2013
16441,1,24,Jayson Megna,0,12,1,C,2014
16442,1,25,Jayson Megna,1,6,2,C,2015
16443,4,26,Jayson Megna,4,58,8,C,2016
16444,0,27,Jayson Megna,0,1,0,C,2017
16445,37,36,Jean Beliveau,31,59,68,C,1967
16446,49,37,Jean Beliveau,33,69,82,C,1968
16447,30,38,Jean Beliveau,19,63,49,C,1969
16448,51,39,Jean Beliveau,25,70,76,C,1970
16449,13,20,Jean Bernier,1,34,14,D,1974
16450,13,20,Jean Bernier,1,34,14,D,1974
16451,26,21,Jean Bernier,4,80,30,D,1975
16452,26,21,Jean Bernier,4,80,30,D,1975
16453,13,22,Jean Bernier,2,72,15,D,1976
16454,13,22,Jean Bernier,2,72,15,D,1976
16455,32,23,Jean Bernier,10,74,42,D,1977
16456,32,23,Jean Bernier,10,74,42,D,1977
16457,0,25,Jean Cusson,0,2,0,LW,1967
16458,7,30,Jean Gauthier,5,65,12,D,1967
16459,2,31,Jean Gauthier,0,11,2,D,1968
16460,1,32,Jean Gauthier,0,4,1,D,1969
16461,1,35,Jean Gauthier,2,31,3,D,1972
16462,1,35,Jean Gauthier,2,31,3,D,1972
16463,7,20,Jean Hamel,2,55,9,D,1972
16464,4,21,Jean Hamel,1,45,5,D,1973
16465,19,22,Jean Hamel,5,80,24,D,1974
16466,9,23,Jean Hamel,3,77,12,D,1975
16467,10,24,Jean Hamel,1,71,11,D,1976
16468,6,25,Jean Hamel,2,32,8,D,1977
16469,4,26,Jean Hamel,2,52,6,D,1978
16470,4,27,Jean Hamel,1,49,5,D,1979
16471,7,28,Jean Hamel,5,68,12,D,1980
16472,6,29,Jean Hamel,1,40,7,D,1981
16473,7,30,Jean Hamel,2,51,9,D,1982
16474,12,31,Jean Hamel,1,79,13,D,1983
16475,5,21,Jean Lemieux,3,32,8,D,1973
16476,24,22,Jean Lemieux,3,75,27,D,1974
16477,23,23,Jean Lemieux,10,66,33,D,1975
16478,4,24,Jean Lemieux,4,15,8,D,1976
16479,7,25,Jean Lemieux,3,16,10,D,1977
16480,29,26,Jean Payette,15,71,44,C,1972
16481,29,26,Jean Payette,15,71,44,C,1972
16482,11,27,Jean Payette,4,41,15,C,1973
16483,11,27,Jean Payette,4,41,15,C,1973
16484,3,21,Jean Potvin,1,4,4,D,1970
16485,15,22,Jean Potvin,5,68,20,D,1971
16486,12,23,Jean Potvin,3,45,15,D,1972
16487,23,24,Jean Potvin,5,78,28,D,1973
16488,24,25,Jean Potvin,9,73,33,D,1974
16489,55,26,Jean Potvin,17,78,72,D,1975
16490,36,27,Jean Potvin,10,79,46,D,1976
16491,24,28,Jean Potvin,4,74,28,D,1977
16492,16,29,Jean Potvin,5,64,21,D,1978
16493,13,30,Jean Potvin,2,32,15,D,1979
16494,3,31,Jean Potvin,2,18,5,D,1980
16495,25,23,Jean Pronovost,16,76,41,RW,1968
16496,21,24,Jean Pronovost,20,72,41,RW,1969
16497,24,25,Jean Pronovost,21,78,45,RW,1970
16498,23,26,Jean Pronovost,30,68,53,RW,1971
16499,22,27,Jean Pronovost,21,66,43,RW,1972
16500,32,28,Jean Pronovost,40,77,72,RW,1973
16501,32,29,Jean Pronovost,43,78,75,RW,1974
16502,52,30,Jean Pronovost,52,80,104,RW,1975
16503,31,31,Jean Pronovost,33,79,64,RW,1976
16504,25,32,Jean Pronovost,40,79,65,RW,1977
16505,39,33,Jean Pronovost,28,75,67,RW,1978
16506,19,34,Jean Pronovost,24,80,43,RW,1979
16507,36,35,Jean Pronovost,22,80,58,RW,1980
16508,2,36,Jean Pronovost,1,10,3,RW,1981
16509,46,27,Jean Ratelle,32,74,78,C,1967
16510,46,28,Jean Ratelle,32,75,78,C,1968
16511,42,29,Jean Ratelle,32,75,74,C,1969
16512,46,30,Jean Ratelle,26,78,72,C,1970
16513,63,31,Jean Ratelle,46,63,109,C,1971
16514,53,32,Jean Ratelle,41,78,94,C,1972
16515,39,33,Jean Ratelle,28,68,67,C,1973
16516,55,34,Jean Ratelle,36,79,91,C,1974
16517,69,35,Jean Ratelle,36,80,105,C,1975
16518,61,36,Jean Ratelle,33,78,94,C,1976
16519,59,37,Jean Ratelle,25,80,84,C,1977
16520,45,38,Jean Ratelle,27,80,72,C,1978
16521,45,39,Jean Ratelle,28,67,73,C,1979
16522,26,40,Jean Ratelle,11,47,37,C,1980
16523,11,20,Jean Savard,7,31,18,C,1977
16524,1,21,Jean Savard,0,11,1,C,1978
16525,0,22,Jean Savard,0,1,0,C,1979
16526,1,21,Jean Tetreault,1,6,2,LW,1973
16527,0,23,Jean Tetreault,0,3,0,LW,1975
16528,0,23,Jean Tetreault,0,3,0,LW,1975
16529,5,31,Jean-Claude Garneau,0,17,5,LW,1974
16530,3,22,Jean-Francois Fortin,1,36,4,D,2001
16531,1,23,Jean-Francois Fortin,0,33,1,D,2002
16532,0,24,Jean-Francois Fortin,0,2,0,D,2003
16533,0,20,Jean-Francois Jacques,0,7,0,LW,2005
16534,0,21,Jean-Francois Jacques,0,37,0,LW,2006
16535,0,22,Jean-Francois Jacques,0,9,0,LW,2007
16536,0,23,Jean-Francois Jacques,1,7,1,LW,2008
16537,7,24,Jean-Francois Jacques,4,49,11,LW,2009
16538,1,25,Jean-Francois Jacques,4,51,5,LW,2010
16539,0,26,Jean-Francois Jacques,0,6,0,LW,2011
16540,12,23,Jean-Francois Jomphe,2,31,14,RW,1995
16541,14,24,Jean-Francois Jomphe,7,64,21,C,1996
16542,3,25,Jean-Francois Jomphe,1,9,4,C,1997
16543,0,26,Jean-Francois Jomphe,0,7,0,C,1998
16544,0,22,Jean-Francois Quintin,3,8,3,C,1991
16545,5,23,Jean-Francois Quintin,2,14,7,C,1992
16546,9,21,Jean-Francois Sauve,5,20,14,C,1980
16547,36,22,Jean-Francois Sauve,19,69,55,C,1981
16548,4,23,Jean-Francois Sauve,0,9,4,C,1982
16549,17,24,Jean-Francois Sauve,10,39,27,C,1983
16550,29,25,Jean-Francois Sauve,13,64,42,RW,1984
16551,40,26,Jean-Francois Sauve,16,75,56,C,1985
16552,3,27,Jean-Francois Sauve,2,14,5,C,1986
16553,2,20,Jean-Gabriel Pageau,2,9,4,C,2012
16554,0,21,Jean-Gabriel Pageau,2,28,2,C,2013
16555,9,22,Jean-Gabriel Pageau,10,50,19,C,2014
16556,24,23,Jean-Gabriel Pageau,19,82,43,C,2015
16557,21,24,Jean-Gabriel Pageau,12,82,33,C,2016
16558,15,25,Jean-Gabriel Pageau,14,78,29,C,2017
16559,1,33,Jean-Guy Gendron,0,1,1,LW,1967
16560,35,34,Jean-Guy Gendron,20,74,55,LW,1968
16561,21,35,Jean-Guy Gendron,23,71,44,LW,1969
16562,16,36,Jean-Guy Gendron,20,76,36,LW,1970
16563,13,37,Jean-Guy Gendron,6,56,19,LW,1971
16564,33,38,Jean-Guy Gendron,17,63,50,LW,1972
16565,33,38,Jean-Guy Gendron,17,63,50,LW,1972
16566,8,39,Jean-Guy Gendron,11,64,19,LW,1973
16567,8,39,Jean-Guy Gendron,11,64,19,LW,1973
16568,12,25,Jean-Guy Gratton,15,71,27,RW,1972
16569,12,25,Jean-Guy Gratton,15,71,27,RW,1972
16570,21,26,Jean-Guy Gratton,12,68,33,RW,1973
16571,21,26,Jean-Guy Gratton,12,68,33,RW,1973
16572,8,27,Jean-Guy Gratton,4,49,12,RW,1974
16573,8,27,Jean-Guy Gratton,4,49,12,RW,1974
16574,1,23,Jean-Guy Lagace,0,17,1,D,1968
16575,0,25,Jean-Guy Lagace,0,3,0,D,1970
16576,5,27,Jean-Guy Lagace,1,31,6,D,1972
16577,6,28,Jean-Guy Lagace,2,31,8,D,1973
16578,17,29,Jean-Guy Lagace,3,46,20,D,1974
16579,10,30,Jean-Guy Lagace,3,69,13,D,1975
16580,25,31,Jean-Guy Lagace,2,78,27,D,1976
16581,25,31,Jean-Guy Lagace,2,78,27,D,1976
16582,7,35,Jean-Guy Talbot,0,59,7,D,1967
16583,4,36,Jean-Guy Talbot,5,69,9,D,1968
16584,15,37,Jean-Guy Talbot,2,75,17,D,1969
16585,7,38,Jean-Guy Talbot,0,62,7,D,1970
16586,0,24,Jean-Guy Trudel,0,1,0,RW,1999
16587,0,26,Jean-Guy Trudel,0,3,0,RW,2001
16588,0,27,Jean-Guy Trudel,0,1,0,LW,2002
16589,1,21,Jean-Luc Grand-Pierre,0,16,1,D,1998
16590,0,22,Jean-Luc Grand-Pierre,0,11,0,D,1999
16591,4,23,Jean-Luc Grand-Pierre,1,64,5,D,2000
16592,6,24,Jean-Luc Grand-Pierre,2,81,8,D,2001
16593,0,25,Jean-Luc Grand-Pierre,1,41,1,D,2002
16594,2,26,Jean-Luc Grand-Pierre,3,56,5,D,2003
16595,8,20,Jean-Luc Phaneuf,8,48,16,RW,1975
16596,7,21,Jean-Luc Phaneuf,2,30,9,RW,1976
16597,0,20,Jean-Marc Gaulin,0,1,0,RW,1982
16598,0,21,Jean-Marc Gaulin,0,2,0,RW,1983
16599,3,22,Jean-Marc Gaulin,3,22,6,LW,1984
16600,0,23,Jean-Marc Gaulin,1,1,1,RW,1985
16601,1,20,Jean-Marc Lanthier,2,11,3,RW,1983
16602,4,21,Jean-Marc Lanthier,6,27,10,RW,1984
16603,10,22,Jean-Marc Lanthier,7,62,17,RW,1985
16604,1,24,Jean-Marc Lanthier,1,5,2,RW,1987
16605,1,21,Jean-Marc Richard,2,4,3,D,1987
16606,0,23,Jean-Marc Richard,0,1,0,D,1989
16607,0,21,Jean-Marc Routhier,0,8,0,RW,1989
16608,0,23,Jean-Philippe Cote,0,8,0,D,2005
16609,4,31,Jean-Philippe Cote,0,19,4,D,2013
16610,0,22,Jean-Sebastien Dea,0,1,0,C,2016
16611,0,23,Jean-Sebastien Dea,1,5,1,C,2017
16612,3,,Jean-Yves Cartier,0,15,3,D,1972
16613,3,,Jean-Yves Cartier,0,15,3,D,1972
16614,1,20,Jean-Yves Leroux,0,1,1,LW,1996
16615,7,21,Jean-Yves Leroux,6,66,13,LW,1997
16616,5,22,Jean-Yves Leroux,3,40,8,LW,1998
16617,5,23,Jean-Yves Leroux,3,54,8,LW,1999
16618,4,24,Jean-Yves Leroux,4,59,8,LW,2000
16619,0,25,Jean-Yves Roy,1,3,1,RW,1994
16620,1,26,Jean-Yves Roy,1,4,2,RW,1995
16621,15,27,Jean-Yves Roy,10,52,25,LW,1996
16622,0,28,Jean-Yves Roy,0,2,0,RW,1997
16623,39,33,Jeannot Gilbert,17,75,56,C,1973
16624,39,33,Jeannot Gilbert,17,75,56,C,1973
16625,21,34,Jeannot Gilbert,7,58,28,C,1974
16626,21,34,Jeannot Gilbert,7,58,28,C,1974
16627,4,25,Jed Ortmeyer,2,58,6,RW,2003
16628,2,27,Jed Ortmeyer,5,78,7,RW,2005
16629,9,28,Jed Ortmeyer,2,41,11,RW,2006
16630,4,29,Jed Ortmeyer,4,51,8,RW,2007
16631,0,30,Jed Ortmeyer,0,2,0,RW,2008
16632,11,31,Jed Ortmeyer,8,76,19,RW,2009
16633,0,32,Jed Ortmeyer,0,4,0,RW,2010
16634,1,33,Jed Ortmeyer,1,35,2,RW,2011
16635,0,20,Jeff Allan,0,4,0,D,1977
16636,0,20,Jeff Allan,0,2,0,D,1977
16637,0,20,Jeff Allan,0,2,0,D,1977
16638,1,23,Jeff Bandura,0,2,1,D,1980
16639,0,23,Jeff Batters,0,6,0,D,1993
16640,0,24,Jeff Batters,0,10,0,D,1994
16641,8,21,Jeff Beukeboom,3,44,11,D,1986
16642,20,22,Jeff Beukeboom,5,73,25,D,1987
16643,5,23,Jeff Beukeboom,0,36,5,D,1988
16644,12,24,Jeff Beukeboom,1,46,13,D,1989
16645,7,25,Jeff Beukeboom,3,67,10,D,1990
16646,15,26,Jeff Beukeboom,1,74,16,D,1991
16647,17,27,Jeff Beukeboom,2,82,19,D,1992
16648,8,28,Jeff Beukeboom,8,68,16,D,1993
16649,3,29,Jeff Beukeboom,1,44,4,D,1994
16650,11,30,Jeff Beukeboom,3,82,14,D,1995
16651,9,31,Jeff Beukeboom,3,80,12,D,1996
16652,5,32,Jeff Beukeboom,0,63,5,D,1997
16653,9,33,Jeff Beukeboom,0,45,9,D,1998
16654,0,21,Jeff Bloemberg,0,9,0,D,1988
16655,3,22,Jeff Bloemberg,3,28,6,D,1989
16656,2,23,Jeff Bloemberg,0,3,2,D,1990
16657,1,24,Jeff Bloemberg,0,3,1,D,1991
16658,2,19,Jeff Brown,3,8,5,D,1985
16659,22,20,Jeff Brown,7,44,29,D,1986
16660,36,21,Jeff Brown,16,78,52,D,1987
16661,47,22,Jeff Brown,21,78,68,D,1988
16662,38,23,Jeff Brown,16,77,54,D,1989
16663,47,24,Jeff Brown,12,67,59,D,1990
16664,39,25,Jeff Brown,20,80,59,D,1991
16665,53,26,Jeff Brown,25,71,78,D,1992
16666,52,27,Jeff Brown,14,74,66,D,1993
16667,23,28,Jeff Brown,8,33,31,D,1994
16668,47,29,Jeff Brown,8,76,55,D,1995
16669,0,30,Jeff Brown,0,1,0,D,1996
16670,24,31,Jeff Brown,4,60,28,D,1997
16671,1,22,Jeff Brownschidle,0,3,1,D,1981
16672,0,23,Jeff Brownschidle,0,4,0,D,1982
16673,0,20,Jeff Brubaker,0,12,0,LW,1978
16674,0,20,Jeff Brubaker,0,12,0,LW,1978
16675,1,21,Jeff Brubaker,0,3,1,LW,1979
16676,3,22,Jeff Brubaker,5,43,8,LW,1980
16677,1,23,Jeff Brubaker,0,3,1,LW,1981
16678,0,25,Jeff Brubaker,0,4,0,LW,1983
16679,4,26,Jeff Brubaker,8,68,12,LW,1984
16680,0,27,Jeff Brubaker,1,25,1,LW,1985
16681,0,29,Jeff Brubaker,2,31,2,LW,1987
16682,0,30,Jeff Brubaker,0,1,0,LW,1988
16683,0,27,Jeff Buchanan,0,6,0,D,1998
16684,1,22,Jeff Carlson,0,7,1,RW,1975
16685,1,22,Jeff Carlson,0,7,1,RW,1975
16686,19,21,Jeff Carter,23,81,42,C,2005
16687,23,22,Jeff Carter,14,62,37,C,2006
16688,24,23,Jeff Carter,29,82,53,C,2007
16689,38,24,Jeff Carter,46,82,84,C,2008
16690,28,25,Jeff Carter,33,74,61,C,2009
16691,30,26,Jeff Carter,36,80,66,C,2010
16692,13,27,Jeff Carter,21,55,34,C,2011
16693,7,28,Jeff Carter,26,48,33,C,2012
16694,23,29,Jeff Carter,27,72,50,C,2013
16695,34,30,Jeff Carter,28,82,62,C,2014
16696,38,31,Jeff Carter,24,77,62,C,2015
16697,34,32,Jeff Carter,32,82,66,C,2016
16698,9,33,Jeff Carter,13,27,22,C,2017
16699,0,21,Jeff Christian,0,2,0,LW,1991
16700,0,24,Jeff Christian,0,1,0,LW,1994
16701,0,25,Jeff Christian,0,3,0,LW,1995
16702,2,26,Jeff Christian,2,11,4,LW,1996
16703,0,27,Jeff Christian,0,1,0,LW,1997
16704,0,20,Jeff Chychrun,0,1,0,D,1986
16705,0,21,Jeff Chychrun,0,3,0,D,1987
16706,4,22,Jeff Chychrun,1,80,5,D,1988
16707,7,23,Jeff Chychrun,2,79,9,D,1989
16708,6,24,Jeff Chychrun,0,36,6,D,1990
16709,4,25,Jeff Chychrun,0,43,4,D,1991
16710,1,26,Jeff Chychrun,0,18,1,D,1992
16711,0,27,Jeff Chychrun,0,2,0,D,1993
16712,1,23,Jeff Cowan,4,13,5,LW,1999
16713,4,24,Jeff Cowan,9,51,13,LW,2000
16714,1,25,Jeff Cowan,5,57,6,RW,2001
16715,5,26,Jeff Cowan,3,66,8,LW,2002
16716,16,27,Jeff Cowan,11,71,27,LW,2003
16717,1,29,Jeff Cowan,8,46,9,RW,2005
16718,5,30,Jeff Cowan,7,63,12,LW,2006
16719,1,31,Jeff Cowan,0,46,1,LW,2007
16720,2,22,Jeff Daniels,0,11,2,LW,1990
16721,0,23,Jeff Daniels,0,2,0,LW,1991
16722,4,24,Jeff Daniels,5,58,9,LW,1992
16723,5,25,Jeff Daniels,3,70,8,RW,1993
16724,0,26,Jeff Daniels,0,3,0,LW,1994
16725,2,28,Jeff Daniels,0,10,2,LW,1996
16726,0,29,Jeff Daniels,0,2,0,LW,1997
16727,3,30,Jeff Daniels,1,9,4,LW,1998
16728,4,31,Jeff Daniels,3,69,7,LW,1999
16729,1,32,Jeff Daniels,1,67,2,RW,2000
16730,1,33,Jeff Daniels,4,65,5,C,2001
16731,4,34,Jeff Daniels,0,59,4,C,2002
16732,1,29,Jeff Daw,0,1,1,C,2001
16733,0,18,Jeff Eatough,0,1,0,RW,1981
16734,0,23,Jeff Farkas,0,2,0,C,2000
16735,2,24,Jeff Farkas,0,6,2,RW,2001
16736,0,25,Jeff Farkas,0,3,0,C,2002
16737,4,27,Jeff Finger,1,22,5,D,2006
16738,11,28,Jeff Finger,8,72,19,D,2007
16739,17,29,Jeff Finger,6,66,23,D,2008
16740,8,30,Jeff Finger,2,39,10,D,2009
16741,5,20,Jeff Finley,0,10,5,D,1987
16742,0,21,Jeff Finley,0,4,0,D,1988
16743,1,22,Jeff Finley,0,11,1,D,1989
16744,0,23,Jeff Finley,0,11,0,D,1990
16745,10,24,Jeff Finley,1,51,11,D,1991
16746,8,26,Jeff Finley,1,55,9,D,1993
16747,5,28,Jeff Finley,1,65,6,D,1995
16748,7,29,Jeff Finley,3,65,10,D,1996
16749,6,30,Jeff Finley,1,63,7,D,1997
16750,2,31,Jeff Finley,1,32,3,D,1998
16751,8,32,Jeff Finley,2,74,10,D,1999
16752,8,33,Jeff Finley,2,72,10,D,2000
16753,6,34,Jeff Finley,0,78,6,D,2001
16754,3,35,Jeff Finley,1,64,4,D,2002
16755,1,36,Jeff Finley,0,53,1,D,2003
16756,10,18,Jeff Friesen,15,48,25,C,1994
16757,31,19,Jeff Friesen,15,79,46,LW,1995
16758,34,20,Jeff Friesen,28,82,62,LW,1996
16759,32,21,Jeff Friesen,31,79,63,LW,1997
16760,35,22,Jeff Friesen,22,78,57,LW,1998
16761,35,23,Jeff Friesen,26,82,61,LW,1999
16762,34,24,Jeff Friesen,14,79,48,LW,2000
16763,26,25,Jeff Friesen,17,81,43,RW,2001
16764,28,26,Jeff Friesen,23,81,51,RW,2002
16765,20,27,Jeff Friesen,17,81,37,LW,2003
16766,7,29,Jeff Friesen,4,51,11,LW,2005
16767,6,30,Jeff Friesen,6,72,12,LW,2006
16768,4,26,Jeff Giuliano,3,48,7,LW,2005
16769,6,28,Jeff Giuliano,0,53,6,LW,2007
16770,3,18,Jeff Greenlaw,0,22,3,LW,1986
16771,0,22,Jeff Greenlaw,2,10,2,LW,1990
16772,1,23,Jeff Greenlaw,0,5,1,LW,1991
16773,1,24,Jeff Greenlaw,1,16,2,LW,1992
16774,1,25,Jeff Greenlaw,0,4,1,LW,1993
16775,11,23,Jeff Halpern,18,79,29,C,1999
16776,21,24,Jeff Halpern,21,80,42,C,2000
16777,14,25,Jeff Halpern,5,48,19,C,2001
16778,21,26,Jeff Halpern,13,82,34,C,2002
16779,27,27,Jeff Halpern,19,79,46,C,2003
16780,33,29,Jeff Halpern,11,70,44,C,2005
16781,17,30,Jeff Halpern,8,76,25,C,2006
16782,22,31,Jeff Halpern,20,83,42,C,2007
16783,9,32,Jeff Halpern,7,52,16,C,2008
16784,10,33,Jeff Halpern,9,71,19,C,2009
16785,15,34,Jeff Halpern,11,72,26,C,2010
16786,12,35,Jeff Halpern,4,69,16,C,2011
16787,2,36,Jeff Halpern,1,46,3,C,2012
16788,7,37,Jeff Halpern,5,69,12,C,2013
16789,0,26,Jeff Hamilton,0,1,0,C,2003
16790,6,28,Jeff Hamilton,2,13,8,C,2005
16791,21,29,Jeff Hamilton,18,70,39,C,2006
16792,15,30,Jeff Hamilton,9,58,24,RW,2007
16793,3,31,Jeff Hamilton,3,15,6,RW,2008
16794,0,19,Jeff Harding,0,6,0,RW,1988
16795,0,20,Jeff Harding,0,9,0,RW,1989
16796,0,23,Jeff Heerema,3,10,3,RW,2002
16797,2,24,Jeff Heerema,1,22,3,RW,2003
16798,6,27,Jeff Hoggan,2,52,8,LW,2005
16799,2,28,Jeff Hoggan,0,46,2,RW,2006
16800,0,29,Jeff Hoggan,0,1,0,RW,2007
16801,1,30,Jeff Hoggan,0,4,1,RW,2008
16802,0,31,Jeff Hoggan,0,4,0,RW,2009
16803,1,19,Jeff Jackson,0,17,1,LW,1984
16804,2,20,Jeff Jackson,1,5,3,LW,1985
16805,8,21,Jeff Jackson,13,64,21,LW,1986
16806,18,22,Jeff Jackson,9,68,27,LW,1987
16807,6,23,Jeff Jackson,4,33,10,LW,1988
16808,12,24,Jeff Jackson,8,65,20,LW,1989
16809,1,25,Jeff Jackson,3,10,4,LW,1990
16810,0,26,Jeff Jackson,0,1,0,LW,1991
16811,8,21,Jeff Jacques,12,41,20,RW,1974
16812,8,21,Jeff Jacques,12,41,20,RW,1974
16813,33,22,Jeff Jacques,17,81,50,RW,1975
16814,33,22,Jeff Jacques,17,81,50,RW,1975
16815,27,23,Jeff Jacques,21,79,48,RW,1976
16816,27,23,Jeff Jacques,21,79,48,RW,1976
16817,13,21,Jeff Jillson,5,48,18,D,2001
16818,6,22,Jeff Jillson,0,26,6,D,2002
16819,13,23,Jeff Jillson,4,64,17,D,2003
16820,0,25,Jeff Jillson,0,2,0,D,2005
16821,0,24,Jeff Lank,0,2,0,D,1999
16822,1,19,Jeff Larmer,1,8,2,LW,1981
16823,24,20,Jeff Larmer,21,65,45,LW,1982
16824,26,21,Jeff Larmer,15,76,41,LW,1983
16825,0,22,Jeff Larmer,0,7,0,LW,1984
16826,0,23,Jeff Larmer,0,2,0,LW,1985
16827,13,22,Jeff Lazaro,5,49,18,LW,1990
16828,6,23,Jeff Lazaro,3,27,9,LW,1991
16829,4,24,Jeff Lazaro,6,26,10,LW,1992
16830,0,23,Jeff Libby,0,1,0,D,1997
16831,0,24,Jeff MacMillan,0,4,0,D,2003
16832,0,25,Jeff Madill,4,14,4,RW,1990
16833,0,20,Jeff McDill,0,1,0,RW,1976
16834,0,24,Jeff McLean,1,6,1,C,1993
16835,0,22,Jeff Mitchell,0,7,0,RW,1997
16836,0,22,Jeff Nelson,1,10,1,C,1994
16837,7,23,Jeff Nelson,0,33,7,C,1995
16838,1,26,Jeff Nelson,2,9,3,C,1998
16839,0,25,Jeff Nielsen,0,2,0,RW,1996
16840,5,26,Jeff Nielsen,4,32,9,RW,1997
16841,4,27,Jeff Nielsen,5,80,9,RW,1998
16842,10,28,Jeff Nielsen,8,79,18,RW,1999
16843,8,29,Jeff Nielsen,3,59,11,RW,2000
16844,6,22,Jeff Norton,1,15,7,D,1987
16845,30,23,Jeff Norton,1,69,31,D,1988
16846,49,24,Jeff Norton,4,60,53,D,1989
16847,25,25,Jeff Norton,3,44,28,D,1990
16848,18,26,Jeff Norton,1,28,19,D,1991
16849,38,27,Jeff Norton,12,66,50,D,1992
16850,33,28,Jeff Norton,7,64,40,D,1993
16851,27,29,Jeff Norton,3,48,30,D,1994
16852,23,30,Jeff Norton,8,66,31,D,1995
16853,16,31,Jeff Norton,2,75,18,D,1996
16854,13,32,Jeff Norton,4,56,17,D,1997
16855,18,33,Jeff Norton,4,72,22,D,1998
16856,20,34,Jeff Norton,0,62,20,D,1999
16857,11,35,Jeff Norton,2,42,13,D,2000
16858,5,36,Jeff Norton,0,32,5,D,2001
16859,19,19,Jeff O'Neill,8,65,27,C,1995
16860,16,20,Jeff O'Neill,14,72,30,C,1996
16861,20,21,Jeff O'Neill,19,74,39,C,1997
16862,15,22,Jeff O'Neill,16,75,31,C,1998
16863,38,23,Jeff O'Neill,25,80,63,C,1999
16864,26,24,Jeff O'Neill,41,82,67,RW,2000
16865,33,25,Jeff O'Neill,31,76,64,LW,2001
16866,31,26,Jeff O'Neill,30,82,61,LW,2002
16867,20,27,Jeff O'Neill,14,67,34,RW,2003
16868,19,29,Jeff O'Neill,19,74,38,RW,2005
16869,22,30,Jeff O'Neill,20,74,42,C,2006
16870,4,22,Jeff Odgers,7,61,11,RW,1991
16871,15,23,Jeff Odgers,12,66,27,RW,1992
16872,8,24,Jeff Odgers,13,81,21,LW,1993
16873,3,25,Jeff Odgers,4,48,7,RW,1994
16874,4,26,Jeff Odgers,12,78,16,LW,1995
16875,8,27,Jeff Odgers,7,80,15,RW,1996
16876,8,28,Jeff Odgers,5,68,13,RW,1997
16877,3,29,Jeff Odgers,2,75,5,RW,1998
16878,2,30,Jeff Odgers,1,62,3,RW,1999
16879,7,31,Jeff Odgers,6,82,13,RW,2000
16880,4,32,Jeff Odgers,4,46,8,RW,2001
16881,4,33,Jeff Odgers,2,74,6,RW,2002
16882,3,22,Jeff Parker,3,15,6,C,1986
16883,2,23,Jeff Parker,0,4,2,C,1987
16884,9,24,Jeff Parker,9,57,18,RW,1988
16885,5,25,Jeff Parker,4,61,9,RW,1989
16886,0,26,Jeff Parker,0,4,0,RW,1990
16887,0,24,Jeff Paul,0,2,0,D,2002
16888,0,22,Jeff Penner,0,2,0,D,2009
16889,4,23,Jeff Petry,1,35,5,C,2010
16890,23,24,Jeff Petry,2,73,25,C,2011
16891,9,25,Jeff Petry,3,48,12,C,2012
16892,10,26,Jeff Petry,7,80,17,D,2013
16893,15,27,Jeff Petry,7,78,22,D,2014
16894,11,28,Jeff Petry,5,51,16,D,2015
16895,20,29,Jeff Petry,8,80,28,D,2016
16896,30,30,Jeff Petry,11,82,41,D,2017
16897,0,22,Jeff Rohlicek,0,7,0,LW,1987
16898,0,23,Jeff Rohlicek,0,2,0,C,1988
16899,3,20,Jeff Schultz,0,38,3,D,2006
16900,13,21,Jeff Schultz,5,72,18,D,2007
16901,11,22,Jeff Schultz,1,64,12,D,2008
16902,20,23,Jeff Schultz,3,73,23,D,2009
16903,9,24,Jeff Schultz,1,72,10,D,2010
16904,5,25,Jeff Schultz,1,54,6,D,2011
16905,3,26,Jeff Schultz,0,26,3,D,2012
16906,1,28,Jeff Schultz,0,9,1,D,2014
16907,0,29,Jeff Schultz,0,1,0,D,2015
16908,0,24,Jeff Serowik,0,1,0,D,1990
16909,0,28,Jeff Serowik,0,1,0,D,1994
16910,6,32,Jeff Serowik,0,26,6,D,1998
16911,13,20,Jeff Shantz,3,52,16,C,1993
16912,12,21,Jeff Shantz,6,45,18,LW,1994
16913,14,22,Jeff Shantz,6,78,20,C,1995
16914,21,23,Jeff Shantz,9,69,30,C,1996
16915,20,24,Jeff Shantz,11,61,31,C,1997
16916,17,25,Jeff Shantz,13,76,30,C,1998
16917,18,26,Jeff Shantz,13,74,31,C,1999
16918,15,27,Jeff Shantz,5,73,20,C,2000
16919,3,28,Jeff Shantz,3,40,6,C,2001
16920,6,29,Jeff Shantz,3,74,9,C,2002
16921,1,19,Jeff Sharples,0,3,1,D,1986
16922,25,20,Jeff Sharples,10,56,35,D,1987
16923,9,21,Jeff Sharples,4,46,13,D,1988
16924,0,20,Jeff Shevalier,1,1,1,LW,1994
16925,9,22,Jeff Shevalier,4,26,13,LW,1996
16926,0,25,Jeff Shevalier,0,5,0,LW,1999
16927,32,18,Jeff Skinner,31,82,63,RW,2010
16928,24,19,Jeff Skinner,20,64,44,RW,2011
16929,11,20,Jeff Skinner,13,42,24,RW,2012
16930,21,21,Jeff Skinner,33,71,54,LW,2013
16931,13,22,Jeff Skinner,18,77,31,LW,2014
16932,23,23,Jeff Skinner,28,82,51,LW,2015
16933,26,24,Jeff Skinner,37,79,63,LW,2016
16934,25,25,Jeff Skinner,24,82,49,LW,2017
16935,1,21,Jeff Taffe,3,20,4,C,2002
16936,10,22,Jeff Taffe,8,59,18,RW,2003
16937,0,24,Jeff Taffe,0,4,0,C,2005
16938,2,25,Jeff Taffe,4,17,6,LW,2006
16939,7,26,Jeff Taffe,5,45,12,LW,2007
16940,2,27,Jeff Taffe,0,8,2,LW,2008
16941,1,28,Jeff Taffe,1,21,2,C,2009
16942,0,29,Jeff Taffe,0,1,0,C,2010
16943,2,30,Jeff Taffe,0,5,2,C,2011
16944,3,21,Jeff Tambellini,1,25,4,LW,2005
16945,7,22,Jeff Tambellini,2,23,9,LW,2006
16946,3,23,Jeff Tambellini,1,31,4,LW,2007
16947,8,24,Jeff Tambellini,7,65,15,LW,2008
16948,7,25,Jeff Tambellini,7,36,14,LW,2009
16949,8,26,Jeff Tambellini,9,62,17,LW,2010
16950,1,24,Jeff Teal,0,6,1,RW,1984
16951,0,21,Jeff Toms,0,1,0,LW,1995
16952,8,22,Jeff Toms,2,34,10,LW,1996
16953,6,23,Jeff Toms,4,46,10,C,1997
16954,5,24,Jeff Toms,1,21,6,LW,1998
16955,2,25,Jeff Toms,1,20,3,LW,1999
16956,5,26,Jeff Toms,3,54,8,LW,2000
16957,5,27,Jeff Toms,9,52,14,C,2001
16958,2,28,Jeff Toms,2,8,4,C,2002
16959,0,23,Jeff Ulmer,3,21,3,RW,2000
16960,0,19,Jeff Ware,0,13,0,D,1996
16961,0,20,Jeff Ware,0,2,0,D,1997
16962,1,21,Jeff Ware,0,6,1,D,1998
16963,2,22,Jeff Woywitka,0,26,2,D,2005
16964,6,23,Jeff Woywitka,1,34,7,D,2006
16965,6,24,Jeff Woywitka,2,27,8,D,2007
16966,15,25,Jeff Woywitka,3,65,18,D,2008
16967,3,26,Jeff Woywitka,0,36,3,D,2009
16968,9,27,Jeff Woywitka,2,63,11,D,2010
16969,5,28,Jeff Woywitka,1,27,6,D,2011
16970,0,21,Jeff Zehr,0,4,0,LW,1999
16971,18,21,Jere Gillis,23,79,41,LW,1977
16972,12,22,Jere Gillis,13,78,25,LW,1978
16973,17,23,Jere Gillis,13,67,30,LW,1979
16974,14,24,Jere Gillis,10,46,24,LW,1980
16975,10,25,Jere Gillis,5,38,15,LW,1981
16976,0,26,Jere Gillis,0,3,0,LW,1982
16977,13,27,Jere Gillis,9,37,22,LW,1983
16978,11,28,Jere Gillis,5,37,16,LW,1984
16979,0,30,Jere Gillis,0,1,0,LW,1986
16980,10,24,Jere Karalahti,6,48,16,D,1999
16981,7,25,Jere Karalahti,2,56,9,D,2000
16982,2,26,Jere Karalahti,0,45,2,D,2001
16983,22,22,Jere Lehtinen,6,57,28,RW,1995
16984,27,23,Jere Lehtinen,16,63,43,RW,1996
16985,19,24,Jere Lehtinen,23,72,42,RW,1997
16986,32,25,Jere Lehtinen,20,74,52,RW,1998
16987,5,26,Jere Lehtinen,3,17,8,LW,1999
16988,25,27,Jere Lehtinen,20,74,45,LW,2000
16989,24,28,Jere Lehtinen,25,73,49,RW,2001
16990,17,29,Jere Lehtinen,31,80,48,RW,2002
16991,13,30,Jere Lehtinen,13,58,26,RW,2003
16992,19,32,Jere Lehtinen,33,80,52,RW,2005
16993,17,33,Jere Lehtinen,26,73,43,RW,2006
16994,22,34,Jere Lehtinen,15,48,37,RW,2007
16995,16,35,Jere Lehtinen,8,48,24,RW,2008
16996,13,36,Jere Lehtinen,4,58,17,RW,2009
16997,1,21,Jeremy Colliton,1,19,2,C,2005
16998,0,22,Jeremy Colliton,0,1,0,C,2006
16999,0,23,Jeremy Colliton,0,16,0,C,2007
17000,1,24,Jeremy Colliton,0,6,1,C,2008
17001,1,26,Jeremy Colliton,2,15,3,C,2010
17002,1,19,Jeremy Morin,2,9,3,LW,2010
17003,0,20,Jeremy Morin,0,3,0,LW,2011
17004,1,21,Jeremy Morin,1,3,2,LW,2012
17005,6,22,Jeremy Morin,5,24,11,LW,2013
17006,4,23,Jeremy Morin,2,43,6,LW,2014
17007,1,24,Jeremy Reich,0,9,1,LW,2003
17008,1,27,Jeremy Reich,0,32,1,C,2006
17009,2,28,Jeremy Reich,2,58,4,LW,2007
17010,9,19,Jeremy Roenick,9,20,18,C,1988
17011,40,20,Jeremy Roenick,26,78,66,C,1989
17012,53,21,Jeremy Roenick,41,79,94,C,1990
17013,50,22,Jeremy Roenick,53,80,103,C,1991
17014,57,23,Jeremy Roenick,50,84,107,C,1992
17015,61,24,Jeremy Roenick,46,84,107,C,1993
17016,24,25,Jeremy Roenick,10,33,34,C,1994
17017,35,26,Jeremy Roenick,32,66,67,LW,1995
17018,40,27,Jeremy Roenick,29,72,69,RW,1996
17019,32,28,Jeremy Roenick,24,79,56,LW,1997
17020,48,29,Jeremy Roenick,24,78,72,C,1998
17021,44,30,Jeremy Roenick,34,75,78,C,1999
17022,46,31,Jeremy Roenick,30,80,76,C,2000
17023,46,32,Jeremy Roenick,21,75,67,C,2001
17024,32,33,Jeremy Roenick,27,79,59,C,2002
17025,28,34,Jeremy Roenick,19,62,47,C,2003
17026,13,36,Jeremy Roenick,9,58,22,C,2005
17027,17,37,Jeremy Roenick,11,70,28,C,2006
17028,19,38,Jeremy Roenick,14,69,33,C,2007
17029,9,39,Jeremy Roenick,4,42,13,C,2008
17030,1,21,Jeremy Stevenson,0,3,1,LW,1995
17031,0,22,Jeremy Stevenson,0,5,0,LW,1996
17032,5,23,Jeremy Stevenson,3,45,8,LW,1997
17033,0,25,Jeremy Stevenson,0,3,0,LW,1999
17034,0,26,Jeremy Stevenson,1,8,1,LW,2000
17035,0,27,Jeremy Stevenson,0,4,0,LW,2001
17036,6,28,Jeremy Stevenson,5,32,11,LW,2002
17037,4,29,Jeremy Stevenson,5,56,9,RW,2003
17038,3,31,Jeremy Stevenson,5,51,8,LW,2005
17039,0,23,Jeremy Welsh,0,1,0,LW,2011
17040,1,24,Jeremy Welsh,0,5,1,LW,2012
17041,0,25,Jeremy Welsh,1,19,1,C,2013
17042,0,27,Jeremy Welsh,0,2,0,C,2015
17043,0,22,Jeremy Williams,1,1,1,C,2005
17044,0,23,Jeremy Williams,1,1,1,RW,2006
17045,0,24,Jeremy Williams,2,18,2,RW,2007
17046,2,25,Jeremy Williams,5,11,7,RW,2008
17047,0,27,Jeremy Williams,0,1,0,RW,2010
17048,0,23,Jeremy Yablonski,0,1,0,RW,2003
17049,2,26,Jergus Baca,0,9,2,D,1990
17050,0,27,Jergus Baca,0,1,0,D,1991
17051,4,19,Jerome Dupont,0,34,4,D,1981
17052,0,20,Jerome Dupont,0,1,0,D,1982
17053,2,21,Jerome Dupont,2,36,4,D,1983
17054,10,22,Jerome Dupont,3,55,13,D,1984
17055,13,23,Jerome Dupont,2,75,15,D,1985
17056,0,24,Jerome Dupont,0,13,0,D,1986
17057,2,22,Jerome Samson,0,7,2,RW,2009
17058,2,23,Jerome Samson,0,23,2,RW,2010
17059,3,24,Jerome Samson,2,16,5,RW,2011
17060,2,23,Jerred Smithson,0,22,2,C,2002
17061,1,24,Jerred Smithson,0,8,1,C,2003
17062,9,26,Jerred Smithson,5,66,14,C,2005
17063,7,27,Jerred Smithson,5,64,12,C,2006
17064,9,28,Jerred Smithson,7,81,16,C,2007
17065,9,29,Jerred Smithson,4,82,13,RW,2008
17066,4,30,Jerred Smithson,9,69,13,C,2009
17067,8,31,Jerred Smithson,5,82,13,C,2010
17068,5,32,Jerred Smithson,1,69,6,C,2011
17069,3,33,Jerred Smithson,3,45,6,C,2012
17070,0,34,Jerred Smithson,0,18,0,C,2013
17071,0,21,Jerry Butler,1,8,1,RW,1972
17072,10,22,Jerry Butler,6,26,16,RW,1973
17073,16,23,Jerry Butler,17,78,33,RW,1974
17074,24,24,Jerry Butler,17,66,41,RW,1975
17075,20,25,Jerry Butler,12,80,32,RW,1976
17076,9,26,Jerry Butler,9,82,18,LW,1977
17077,7,27,Jerry Butler,8,76,15,LW,1978
17078,12,28,Jerry Butler,11,78,23,LW,1979
17079,15,29,Jerry Butler,12,80,27,RW,1980
17080,1,30,Jerry Butler,3,25,4,RW,1981
17081,6,31,Jerry Butler,3,42,9,RW,1982
17082,2,20,Jerry Byers,0,14,2,LW,1972
17083,0,21,Jerry Byers,0,10,0,D,1973
17084,1,22,Jerry Byers,1,12,2,LW,1974
17085,1,25,Jerry Byers,2,7,3,LW,1977
17086,2,22,Jerry D'Amigo,1,22,3,RW,2013
17087,0,23,Jerry D'Amigo,0,9,0,RW,2014
17088,1,25,Jerry Engele,0,17,1,D,1975
17089,7,26,Jerry Engele,1,31,8,D,1976
17090,5,27,Jerry Engele,1,52,6,D,1977
17091,0,20,Jerry Holland,1,1,1,RW,1974
17092,4,21,Jerry Holland,7,36,11,LW,1975
17093,1,23,Jerry Holland,2,22,3,LW,1977
17094,1,23,Jerry Holland,2,22,3,LW,1977
17095,14,22,Jerry Korab,4,46,18,D,1970
17096,5,23,Jerry Korab,9,73,14,D,1971
17097,15,24,Jerry Korab,12,77,27,D,1972
17098,19,25,Jerry Korab,10,76,29,D,1973
17099,44,26,Jerry Korab,12,79,56,D,1974
17100,28,27,Jerry Korab,13,65,41,D,1975
17101,33,28,Jerry Korab,14,77,47,D,1976
17102,34,29,Jerry Korab,7,77,41,D,1977
17103,40,30,Jerry Korab,11,78,51,D,1978
17104,12,31,Jerry Korab,2,54,14,D,1979
17105,43,32,Jerry Korab,9,78,52,D,1980
17106,13,33,Jerry Korab,5,50,18,D,1981
17107,26,34,Jerry Korab,3,72,29,D,1982
17108,9,35,Jerry Korab,2,48,11,D,1983
17109,6,36,Jerry Korab,1,25,7,D,1984
17110,7,20,Jerry Rollins,5,52,12,D,1975
17111,7,20,Jerry Rollins,5,52,12,D,1975
17112,10,21,Jerry Rollins,4,71,14,D,1976
17113,10,21,Jerry Rollins,4,63,14,D,1976
17114,0,21,Jerry Rollins,0,8,0,D,1976
17115,10,21,Jerry Rollins,4,71,14,D,1976
17116,10,21,Jerry Rollins,4,63,14,D,1976
17117,0,21,Jerry Rollins,0,8,0,D,1976
17118,1,23,Jerry Rollins,0,7,1,D,1978
17119,1,23,Jerry Rollins,0,7,1,D,1978
17120,0,25,Jerry Trooien,0,2,0,LW,1972
17121,0,25,Jerry Trooien,0,2,0,LW,1972
17122,0,24,Jerry Zrymiak,0,1,0,D,1972
17123,0,24,Jerry Zrymiak,0,1,0,D,1972
17124,8,25,Jerry Zrymiak,2,27,10,D,1973
17125,8,25,Jerry Zrymiak,2,27,10,D,1973
17126,9,26,Jerry Zrymiak,3,48,12,D,1974
17127,9,26,Jerry Zrymiak,3,48,12,D,1974
17128,13,27,Jerry Zrymiak,0,39,13,D,1975
17129,10,28,Jerry Zrymiak,2,40,12,D,1976
17130,22,19,Jesper Bratt,13,74,35,LW,2017
17131,0,22,Jesper Fast,0,11,0,RW,2013
17132,8,23,Jesper Fast,6,58,14,RW,2014
17133,20,24,Jesper Fast,10,79,30,RW,2015
17134,15,25,Jesper Fast,6,68,21,RW,2016
17135,20,26,Jesper Fast,13,71,33,RW,2017
17136,0,22,Jesse Belanger,0,4,0,C,1991
17137,2,23,Jesse Belanger,4,19,6,C,1992
17138,33,24,Jesse Belanger,17,70,50,C,1993
17139,14,25,Jesse Belanger,15,47,29,C,1994
17140,21,26,Jesse Belanger,20,72,41,C,1995
17141,0,27,Jesse Belanger,0,6,0,C,1996
17142,6,30,Jesse Belanger,3,16,9,C,1999
17143,0,31,Jesse Belanger,0,12,0,C,2000
17144,0,23,Jesse Blacker,0,1,0,D,2014
17145,0,23,Jesse Boulerice,0,3,0,RW,2001
17146,1,24,Jesse Boulerice,2,48,3,RW,2002
17147,1,25,Jesse Boulerice,6,76,7,RW,2003
17148,0,27,Jesse Boulerice,0,38,0,RW,2005
17149,0,29,Jesse Boulerice,0,5,0,RW,2007
17150,0,30,Jesse Boulerice,0,2,0,RW,2008
17151,0,24,Jesse Fibiger,0,16,0,D,2002
17152,2,21,Jesse Joensuu,1,7,3,LW,2008
17153,0,22,Jesse Joensuu,1,11,1,RW,2009
17154,3,23,Jesse Joensuu,6,42,9,RW,2010
17155,2,25,Jesse Joensuu,0,7,2,RW,2012
17156,2,26,Jesse Joensuu,3,42,5,LW,2013
17157,2,27,Jesse Joensuu,2,20,4,LW,2014
17158,7,18,Jesse Puljujarvi,1,28,8,RW,2016
17159,8,19,Jesse Puljujarvi,12,65,20,RW,2017
17160,0,24,Jesse Schultz,0,2,0,RW,2006
17161,0,21,Jesse Wallin,0,1,0,D,1999
17162,0,22,Jesse Wallin,0,1,0,D,2000
17163,1,23,Jesse Wallin,0,15,1,D,2001
17164,1,24,Jesse Wallin,0,32,1,D,2002
17165,0,24,Jesse Winchester,0,1,0,C,2007
17166,15,25,Jesse Winchester,3,76,18,RW,2008
17167,11,26,Jesse Winchester,2,52,13,C,2009
17168,9,27,Jesse Winchester,4,72,13,C,2010
17169,6,28,Jesse Winchester,2,32,8,C,2011
17170,9,30,Jesse Winchester,9,52,18,C,2013
17171,17,25,Jim Adair,12,70,29,C,1973
17172,17,25,Jim Adair,12,70,29,C,1973
17173,0,20,Jim Agnew,0,4,0,D,1986
17174,1,21,Jim Agnew,0,10,1,D,1987
17175,0,23,Jim Agnew,0,7,0,D,1989
17176,0,24,Jim Agnew,0,20,0,D,1990
17177,0,25,Jim Agnew,0,24,0,D,1991
17178,0,26,Jim Agnew,0,16,0,D,1992
17179,2,37,Jim Anderson,1,7,3,LW,1967
17180,2,23,Jim Archibald,1,4,3,RW,1984
17181,0,24,Jim Archibald,0,11,0,RW,1985
17182,0,25,Jim Archibald,0,1,0,RW,1986
17183,24,18,Jim Benning,7,74,31,D,1981
17184,17,19,Jim Benning,5,74,22,D,1982
17185,39,20,Jim Benning,12,79,51,D,1983
17186,35,21,Jim Benning,9,80,44,D,1984
17187,21,22,Jim Benning,4,52,25,D,1985
17188,11,23,Jim Benning,2,59,13,D,1986
17189,26,24,Jim Benning,7,77,33,D,1987
17190,9,25,Jim Benning,3,65,12,D,1988
17191,9,26,Jim Benning,3,45,12,D,1989
17192,13,25,Jim Benzelock,10,69,23,RW,1972
17193,12,25,Jim Benzelock,9,43,21,RW,1972
17194,1,25,Jim Benzelock,1,26,2,RW,1972
17195,12,25,Jim Benzelock,9,43,21,RW,1972
17196,7,26,Jim Benzelock,6,53,13,RW,1973
17197,2,27,Jim Benzelock,0,10,2,RW,1974
17198,2,27,Jim Benzelock,0,10,2,RW,1974
17199,5,28,Jim Benzelock,2,34,7,RW,1975
17200,5,28,Jim Benzelock,2,34,7,RW,1975
17201,0,23,Jim Boo,0,6,0,D,1977
17202,44,25,Jim Boyd,26,76,70,C,1974
17203,34,26,Jim Boyd,23,80,57,C,1975
17204,34,26,Jim Boyd,23,80,57,C,1975
17205,2,27,Jim Boyd,0,13,2,C,1976
17206,1,22,Jim Brown,0,3,1,D,1982
17207,3,22,Jim Campbell,2,16,5,C,1995
17208,20,23,Jim Campbell,23,68,43,RW,1996
17209,19,24,Jim Campbell,22,76,41,RW,1997
17210,21,25,Jim Campbell,4,55,25,RW,1998
17211,0,26,Jim Campbell,0,2,0,RW,1999
17212,11,27,Jim Campbell,9,57,20,RW,2000
17213,1,28,Jim Campbell,1,9,2,RW,2001
17214,0,29,Jim Campbell,0,1,0,RW,2002
17215,0,32,Jim Campbell,0,1,0,RW,2005
17216,24,28,Jim Cardiff,3,78,27,D,1972
17217,24,28,Jim Cardiff,3,78,27,D,1972
17218,21,29,Jim Cardiff,1,78,22,D,1973
17219,21,29,Jim Cardiff,1,78,22,D,1973
17220,2,30,Jim Cardiff,0,44,2,D,1974
17221,9,21,Jim Clarke,1,59,10,D,1975
17222,9,21,Jim Clarke,1,59,10,D,1975
17223,1,25,Jim Cole,0,2,1,LW,1976
17224,1,25,Jim Cole,0,2,1,LW,1976
17225,0,20,Jim Cross,0,2,0,D,1977
17226,0,20,Jim Cross,0,2,0,D,1977
17227,1,24,Jim Culhane,0,6,1,D,1989
17228,0,21,Jim Cummins,0,1,0,RW,1991
17229,1,22,Jim Cummins,1,7,2,RW,1992
17230,2,23,Jim Cummins,1,26,3,RW,1993
17231,1,24,Jim Cummins,4,37,5,RW,1994
17232,4,25,Jim Cummins,2,52,6,RW,1995
17233,6,26,Jim Cummins,6,65,12,RW,1996
17234,2,27,Jim Cummins,0,75,2,RW,1997
17235,7,28,Jim Cummins,1,55,8,RW,1998
17236,5,29,Jim Cummins,3,47,8,RW,1999
17237,6,30,Jim Cummins,5,79,11,RW,2000
17238,0,31,Jim Cummins,0,12,0,RW,2001
17239,2,33,Jim Cummins,1,55,3,RW,2003
17240,0,21,Jim Cunningham,0,1,0,LW,1977
17241,0,19,Jim Dobson,0,1,0,RW,1979
17242,0,20,Jim Dobson,0,1,0,RW,1980
17243,0,21,Jim Dobson,0,9,0,RW,1981
17244,0,23,Jim Dobson,0,1,0,RW,1983
17245,22,21,Jim Dorey,8,61,30,D,1968
17246,11,22,Jim Dorey,6,46,17,D,1969
17247,22,23,Jim Dorey,7,74,29,D,1970
17248,19,24,Jim Dorey,4,51,23,D,1971
17249,56,25,Jim Dorey,7,75,63,D,1972
17250,40,26,Jim Dorey,6,77,46,D,1973
17251,40,27,Jim Dorey,16,74,56,D,1974
17252,23,27,Jim Dorey,11,43,34,D,1974
17253,17,27,Jim Dorey,5,31,22,D,1974
17254,17,27,Jim Dorey,5,31,22,D,1974
17255,51,28,Jim Dorey,9,74,60,D,1975
17256,51,28,Jim Dorey,9,74,60,D,1975
17257,34,29,Jim Dorey,13,73,47,D,1976
17258,34,29,Jim Dorey,13,73,47,D,1976
17259,9,30,Jim Dorey,1,26,10,D,1977
17260,9,30,Jim Dorey,1,26,10,D,1977
17261,2,31,Jim Dorey,0,32,2,D,1978
17262,2,31,Jim Dorey,0,32,2,D,1978
17263,0,23,Jim Dowd,0,1,0,RW,1991
17264,0,24,Jim Dowd,0,1,0,RW,1992
17265,10,25,Jim Dowd,5,15,15,C,1993
17266,4,26,Jim Dowd,1,10,5,C,1994
17267,15,27,Jim Dowd,5,66,20,C,1995
17268,0,28,Jim Dowd,0,3,0,C,1996
17269,8,29,Jim Dowd,6,48,14,C,1997
17270,0,30,Jim Dowd,0,1,0,C,1998
17271,18,31,Jim Dowd,5,69,23,C,1999
17272,22,32,Jim Dowd,7,68,29,C,2000
17273,30,33,Jim Dowd,13,82,43,C,2001
17274,17,34,Jim Dowd,8,78,25,C,2002
17275,22,35,Jim Dowd,7,69,29,C,2003
17276,13,37,Jim Dowd,5,78,18,C,2005
17277,4,38,Jim Dowd,4,66,8,C,2006
17278,5,39,Jim Dowd,5,73,10,C,2007
17279,26,23,Jim E Johnson,3,80,29,D,1985
17280,25,24,Jim E Johnson,5,80,30,D,1986
17281,12,25,Jim E Johnson,1,55,13,D,1987
17282,14,26,Jim E Johnson,2,76,16,D,1988
17283,13,27,Jim E Johnson,3,75,16,D,1989
17284,14,28,Jim E Johnson,1,68,15,D,1990
17285,10,29,Jim E Johnson,4,71,14,D,1991
17286,20,30,Jim E Johnson,3,79,23,D,1992
17287,7,31,Jim E Johnson,0,61,7,D,1993
17288,13,32,Jim E Johnson,0,47,13,D,1994
17289,4,33,Jim E Johnson,2,66,6,D,1995
17290,7,34,Jim E Johnson,3,55,10,D,1996
17291,1,35,Jim E Johnson,2,16,3,D,1997
17292,0,20,Jim Ennis,1,5,1,D,1987
17293,19,23,Jim Fahey,1,43,20,D,2002
17294,2,24,Jim Fahey,0,15,2,D,2003
17295,2,26,Jim Fahey,0,21,2,D,2005
17296,1,27,Jim Fahey,0,13,1,D,2006
17297,25,20,Jim Fox,18,71,43,RW,1980
17298,38,21,Jim Fox,30,77,68,RW,1981
17299,40,22,Jim Fox,28,77,68,RW,1982
17300,42,23,Jim Fox,30,80,72,RW,1983
17301,53,24,Jim Fox,30,79,83,RW,1984
17302,17,25,Jim Fox,14,39,31,RW,1985
17303,42,26,Jim Fox,19,76,61,RW,1986
17304,35,27,Jim Fox,16,68,51,RW,1987
17305,1,29,Jim Fox,1,11,2,RW,1989
17306,4,21,Jim Hamilton,2,25,6,RW,1977
17307,0,22,Jim Hamilton,0,2,0,LW,1978
17308,0,23,Jim Hamilton,2,10,2,RW,1979
17309,6,24,Jim Hamilton,1,20,7,RW,1980
17310,3,25,Jim Hamilton,5,11,8,RW,1981
17311,2,26,Jim Hamilton,0,5,2,RW,1982
17312,2,27,Jim Hamilton,2,11,4,RW,1983
17313,1,28,Jim Hamilton,2,11,3,RW,1984
17314,1,20,Jim Hargreaves,0,7,1,D,1970
17315,6,22,Jim Hargreaves,1,59,7,D,1972
17316,4,23,Jim Hargreaves,1,53,5,D,1973
17317,4,23,Jim Hargreaves,1,53,5,D,1973
17318,15,24,Jim Hargreaves,10,78,25,D,1974
17319,10,24,Jim Hargreaves,8,41,18,D,1974
17320,5,24,Jim Hargreaves,2,37,7,D,1974
17321,15,24,Jim Hargreaves,10,78,25,D,1974
17322,10,24,Jim Hargreaves,8,41,18,D,1974
17323,5,24,Jim Hargreaves,2,37,7,D,1974
17324,1,25,Jim Hargreaves,1,43,2,D,1975
17325,1,25,Jim Hargreaves,1,43,2,D,1975
17326,2,21,Jim Harrison,1,16,3,C,1968
17327,11,22,Jim Harrison,10,54,21,C,1969
17328,20,23,Jim Harrison,13,78,33,C,1970
17329,17,24,Jim Harrison,19,66,36,C,1971
17330,47,25,Jim Harrison,39,66,86,C,1972
17331,47,25,Jim Harrison,39,66,86,C,1972
17332,45,26,Jim Harrison,24,47,69,C,1973
17333,45,26,Jim Harrison,24,47,69,C,1973
17334,22,27,Jim Harrison,20,60,42,C,1974
17335,22,27,Jim Harrison,20,60,42,C,1974
17336,38,28,Jim Harrison,34,59,72,C,1975
17337,38,28,Jim Harrison,34,59,72,C,1975
17338,23,29,Jim Harrison,18,60,41,C,1976
17339,8,30,Jim Harrison,2,26,10,C,1977
17340,5,31,Jim Harrison,4,21,9,C,1978
17341,0,32,Jim Harrison,0,3,0,C,1979
17342,12,23,Jim Hiller,8,61,20,RW,1992
17343,0,24,Jim Hiller,0,2,0,RW,1993
17344,0,21,Jim Hofford,0,5,0,D,1985
17345,0,22,Jim Hofford,0,12,0,D,1986
17346,0,24,Jim Hofford,0,1,0,D,1988
17347,5,25,Jim Hrycuik,5,21,10,C,1974
17348,12,22,Jim Jackson,8,48,20,LW,1982
17349,14,23,Jim Jackson,6,49,20,LW,1983
17350,4,24,Jim Jackson,1,10,5,LW,1984
17351,0,27,Jim Jackson,2,5,2,LW,1987
17352,0,22,Jim Jones,0,2,0,C,1971
17353,0,24,Jim Jones,0,1,0,D,1973
17354,0,24,Jim Jones,0,1,0,D,1973
17355,13,22,Jim Korn,5,63,18,D,1979
17356,15,23,Jim Korn,5,63,20,D,1980
17357,10,24,Jim Korn,2,70,12,D,1981
17358,21,25,Jim Korn,8,80,29,D,1982
17359,14,26,Jim Korn,12,65,26,D,1983
17360,5,27,Jim Korn,5,41,10,RW,1984
17361,10,29,Jim Korn,4,52,14,D,1986
17362,13,30,Jim Korn,8,52,21,LW,1987
17363,16,31,Jim Korn,15,65,31,LW,1988
17364,5,32,Jim Korn,2,46,7,LW,1989
17365,3,22,Jim Krulicki,0,41,3,LW,1970
17366,0,18,Jim Kyte,0,2,0,D,1982
17367,2,19,Jim Kyte,1,58,3,D,1983
17368,3,20,Jim Kyte,0,71,3,D,1984
17369,3,21,Jim Kyte,1,71,4,D,1985
17370,5,22,Jim Kyte,5,72,10,D,1986
17371,3,23,Jim Kyte,1,51,4,D,1987
17372,9,24,Jim Kyte,3,74,12,D,1988
17373,1,25,Jim Kyte,3,56,4,D,1989
17374,9,26,Jim Kyte,0,43,9,D,1990
17375,1,27,Jim Kyte,0,21,1,D,1991
17376,1,28,Jim Kyte,0,4,1,D,1992
17377,5,30,Jim Kyte,2,18,7,D,1994
17378,7,31,Jim Kyte,1,57,8,D,1995
17379,11,25,Jim Leavins,2,37,13,D,1985
17380,1,26,Jim Leavins,0,4,1,D,1986
17381,3,21,Jim Lorentz,1,11,4,C,1968
17382,16,22,Jim Lorentz,7,68,23,C,1969
17383,21,23,Jim Lorentz,19,76,40,RW,1970
17384,15,24,Jim Lorentz,10,52,25,C,1971
17385,35,25,Jim Lorentz,27,78,62,RW,1972
17386,31,26,Jim Lorentz,23,78,54,RW,1973
17387,45,27,Jim Lorentz,25,72,70,RW,1974
17388,24,28,Jim Lorentz,17,75,41,RW,1975
17389,33,29,Jim Lorentz,23,79,56,RW,1976
17390,15,30,Jim Lorentz,9,70,24,C,1977
17391,0,24,Jim Mair,0,2,0,D,1970
17392,0,25,Jim Mair,0,2,0,D,1971
17393,11,26,Jim Mair,3,64,14,D,1972
17394,3,27,Jim Mair,1,6,4,D,1973
17395,1,28,Jim Mair,0,2,1,D,1974
17396,0,25,Jim Marsh,0,1,0,D,1976
17397,0,25,Jim Marsh,0,1,0,D,1976
17398,0,20,Jim Mathieson,0,2,0,D,1989
17399,3,22,Jim Mayer,2,21,5,D,1976
17400,3,22,Jim Mayer,2,21,5,D,1976
17401,9,23,Jim Mayer,11,51,20,D,1977
17402,9,23,Jim Mayer,11,51,20,D,1977
17403,0,24,Jim Mayer,0,2,0,D,1978
17404,0,24,Jim Mayer,0,2,0,D,1978
17405,0,25,Jim Mayer,0,4,0,RW,1979
17406,3,20,Jim McCrimmon,2,75,5,D,1973
17407,0,21,Jim McCrimmon,0,2,0,D,1974
17408,5,21,Jim McCrimmon,1,34,6,D,1974
17409,0,22,Jim McCrimmon,0,5,0,D,1975
17410,1,23,Jim McElmury,0,7,1,D,1972
17411,17,25,Jim McElmury,5,78,22,D,1974
17412,6,26,Jim McElmury,2,38,8,D,1975
17413,23,27,Jim McElmury,7,55,30,D,1976
17414,0,28,Jim McElmury,0,2,0,D,1977
17415,0,18,Jim McGeough,0,4,0,C,1981
17416,4,21,Jim McGeough,3,25,7,C,1984
17417,2,22,Jim McGeough,3,17,5,C,1985
17418,4,23,Jim McGeough,1,11,5,C,1986
17419,0,21,Jim McKenny,1,5,1,D,1967
17420,0,22,Jim McKenny,0,7,0,D,1968
17421,33,23,Jim McKenny,11,73,44,D,1969
17422,26,24,Jim McKenny,4,68,30,D,1970
17423,31,25,Jim McKenny,5,76,36,D,1971
17424,41,26,Jim McKenny,11,77,52,D,1972
17425,28,27,Jim McKenny,14,77,42,D,1973
17426,35,28,Jim McKenny,8,66,43,D,1974
17427,19,29,Jim McKenny,10,46,29,D,1975
17428,31,30,Jim McKenny,14,76,45,D,1976
17429,2,31,Jim McKenny,2,15,4,D,1977
17430,1,32,Jim McKenny,1,10,2,RW,1978
17431,0,20,Jim McKenzie,0,5,0,LW,1989
17432,3,21,Jim McKenzie,4,41,7,LW,1990
17433,1,22,Jim McKenzie,5,67,6,LW,1991
17434,6,23,Jim McKenzie,3,64,9,LW,1992
17435,5,24,Jim McKenzie,3,71,8,LW,1993
17436,1,25,Jim McKenzie,2,39,3,LW,1994
17437,2,26,Jim McKenzie,4,73,6,LW,1995
17438,3,27,Jim McKenzie,5,65,8,LW,1996
17439,4,28,Jim McKenzie,3,64,7,LW,1997
17440,4,29,Jim McKenzie,5,73,9,LW,1998
17441,5,30,Jim McKenzie,4,61,9,LW,1999
17442,2,31,Jim McKenzie,2,53,4,LW,2000
17443,5,32,Jim McKenzie,3,67,8,LW,2001
17444,8,33,Jim McKenzie,4,76,12,LW,2002
17445,3,34,Jim McKenzie,1,61,4,LW,2003
17446,7,20,Jim McMasters,1,74,8,D,1972
17447,7,20,Jim McMasters,1,74,8,D,1972
17448,0,21,Jim McMasters,0,9,0,D,1973
17449,0,21,Jim McMasters,0,9,0,D,1973
17450,6,20,Jim McTaggart,1,52,7,D,1980
17451,4,21,Jim McTaggart,2,19,6,D,1981
17452,14,24,Jim Montgomery,6,67,20,C,1993
17453,1,25,Jim Montgomery,1,13,2,C,1994
17454,2,26,Jim Montgomery,1,5,3,C,1995
17455,6,31,Jim Montgomery,1,28,7,C,2000
17456,2,32,Jim Montgomery,0,8,2,C,2001
17457,0,33,Jim Montgomery,0,1,0,C,2002
17458,15,38,Jim Morrison,5,59,20,D,1969
17459,10,39,Jim Morrison,0,73,10,D,1970
17460,4,21,Jim Moxey,5,47,9,RW,1974
17461,16,22,Jim Moxey,10,44,26,RW,1975
17462,7,23,Jim Moxey,7,36,14,RW,1976
17463,2,24,Jim Murray,0,30,2,D,1967
17464,0,23,Jim Nahrgang,0,1,0,D,1974
17465,1,24,Jim Nahrgang,0,3,1,D,1975
17466,11,25,Jim Nahrgang,5,53,16,D,1976
17467,29,27,Jim Neilson,6,67,35,D,1967
17468,34,28,Jim Neilson,10,76,44,D,1968
17469,20,29,Jim Neilson,3,62,23,D,1969
17470,24,30,Jim Neilson,8,77,32,D,1970
17471,30,31,Jim Neilson,7,78,37,D,1971
17472,16,32,Jim Neilson,4,52,20,D,1972
17473,7,33,Jim Neilson,4,72,11,D,1973
17474,17,34,Jim Neilson,3,72,20,D,1974
17475,6,35,Jim Neilson,1,26,7,D,1975
17476,17,36,Jim Neilson,3,47,20,D,1976
17477,21,37,Jim Neilson,2,68,23,D,1977
17478,5,38,Jim Neilson,0,35,5,D,1978
17479,2,24,Jim Niekamp,0,24,2,D,1970
17480,0,25,Jim Niekamp,0,5,0,D,1971
17481,22,26,Jim Niekamp,7,78,29,D,1972
17482,22,26,Jim Niekamp,7,78,29,D,1972
17483,19,27,Jim Niekamp,2,76,21,D,1973
17484,19,27,Jim Niekamp,2,76,21,D,1973
17485,26,28,Jim Niekamp,2,71,28,D,1974
17486,26,28,Jim Niekamp,2,71,28,D,1974
17487,14,29,Jim Niekamp,4,79,18,D,1975
17488,14,29,Jim Niekamp,4,79,18,D,1975
17489,15,30,Jim Niekamp,1,79,16,D,1976
17490,14,23,Jim Nill,10,69,24,RW,1981
17491,15,24,Jim Nill,7,65,22,RW,1982
17492,8,25,Jim Nill,12,78,20,LW,1983
17493,17,26,Jim Nill,9,69,26,RW,1984
17494,8,27,Jim Nill,6,61,14,RW,1985
17495,4,28,Jim Nill,3,36,7,RW,1986
17496,12,29,Jim Nill,3,60,15,RW,1987
17497,7,30,Jim Nill,8,71,15,RW,1988
17498,2,31,Jim Nill,0,15,2,RW,1989
17499,0,22,Jim O'Brien,0,6,0,C,2010
17500,3,23,Jim O'Brien,3,28,6,C,2011
17501,1,24,Jim O'Brien,5,29,6,C,2012
17502,0,27,Jim O'Brien,0,4,0,C,2015
17503,1,29,Jim O'Brien,0,10,1,C,2017
17504,0,23,Jim Paek,0,3,0,D,1990
17505,7,24,Jim Paek,1,49,8,D,1991
17506,15,25,Jim Paek,3,77,18,D,1992
17507,5,26,Jim Paek,1,59,6,D,1993
17508,2,27,Jim Paek,0,29,2,D,1994
17509,15,28,Jim Pappin,13,58,28,RW,1967
17510,40,29,Jim Pappin,30,75,70,RW,1968
17511,25,30,Jim Pappin,28,66,53,RW,1969
17512,23,31,Jim Pappin,22,58,45,RW,1970
17513,21,32,Jim Pappin,27,64,48,RW,1971
17514,51,33,Jim Pappin,41,76,92,RW,1972
17515,41,34,Jim Pappin,32,78,73,RW,1973
17516,27,35,Jim Pappin,36,71,63,RW,1974
17517,13,36,Jim Pappin,6,32,19,RW,1975
17518,8,37,Jim Pappin,2,24,10,RW,1976
17519,9,19,Jim Pavese,2,42,11,D,1981
17520,2,20,Jim Pavese,0,24,2,D,1982
17521,1,21,Jim Pavese,0,4,1,D,1983
17522,5,22,Jim Pavese,2,51,7,D,1984
17523,7,23,Jim Pavese,4,69,11,D,1985
17524,9,24,Jim Pavese,2,69,11,D,1986
17525,5,25,Jim Pavese,0,25,5,D,1987
17526,6,26,Jim Pavese,3,44,9,D,1988
17527,25,20,Jim Peplinski,13,80,38,C,1980
17528,37,21,Jim Peplinski,30,74,67,C,1981
17529,26,22,Jim Peplinski,15,80,41,RW,1982
17530,22,23,Jim Peplinski,11,74,33,RW,1983
17531,29,24,Jim Peplinski,16,80,45,LW,1984
17532,35,25,Jim Peplinski,24,77,59,LW,1985
17533,32,26,Jim Peplinski,18,80,50,LW,1986
17534,31,27,Jim Peplinski,20,75,51,LW,1987
17535,25,28,Jim Peplinski,13,79,38,LW,1988
17536,0,29,Jim Peplinski,1,6,1,LW,1989
17537,1,34,Jim Peplinski,0,6,1,LW,1994
17538,1,19,Jim Playfair,1,2,2,D,1983
17539,3,23,Jim Playfair,1,12,4,D,1987
17540,0,24,Jim Playfair,0,7,0,D,1988
17541,0,26,Jim Pritchard,0,2,0,D,1974
17542,0,26,Jim Pritchard,0,2,0,D,1974
17543,8,20,Jim Roberts,11,53,19,LW,1976
17544,14,21,Jim Roberts,4,42,18,LW,1977
17545,1,22,Jim Roberts,2,11,3,LW,1978
17546,3,19,Jim Sandlak,1,23,4,RW,1985
17547,21,20,Jim Sandlak,15,78,36,RW,1986
17548,15,21,Jim Sandlak,16,49,31,RW,1987
17549,20,22,Jim Sandlak,20,72,40,RW,1988
17550,8,23,Jim Sandlak,15,70,23,RW,1989
17551,6,24,Jim Sandlak,7,59,13,RW,1990
17552,24,25,Jim Sandlak,16,66,40,RW,1991
17553,18,26,Jim Sandlak,10,59,28,RW,1992
17554,2,27,Jim Sandlak,6,27,8,RW,1993
17555,0,28,Jim Sandlak,0,13,0,RW,1994
17556,2,29,Jim Sandlak,4,33,6,RW,1995
17557,15,20,Jim Schoenfeld,4,66,19,D,1972
17558,8,21,Jim Schoenfeld,1,28,9,D,1973
17559,19,22,Jim Schoenfeld,1,68,20,D,1974
17560,22,23,Jim Schoenfeld,2,56,24,D,1975
17561,25,24,Jim Schoenfeld,7,65,32,D,1976
17562,20,25,Jim Schoenfeld,2,60,22,D,1977
17563,17,26,Jim Schoenfeld,8,46,25,D,1978
17564,27,27,Jim Schoenfeld,9,77,36,D,1979
17565,25,28,Jim Schoenfeld,8,71,33,D,1980
17566,11,29,Jim Schoenfeld,8,52,19,D,1981
17567,10,30,Jim Schoenfeld,1,57,11,D,1982
17568,2,31,Jim Schoenfeld,0,39,2,D,1983
17569,3,32,Jim Schoenfeld,0,34,3,D,1984
17570,1,25,Jim Schraefel,1,34,2,C,1973
17571,1,25,Jim Schraefel,1,34,2,C,1973
17572,28,25,Jim Sherrit,30,76,58,C,1973
17573,28,25,Jim Sherrit,30,76,58,C,1973
17574,25,26,Jim Sherrit,22,77,47,C,1974
17575,25,26,Jim Sherrit,22,77,47,C,1974
17576,19,27,Jim Sherrit,11,40,30,C,1975
17577,19,27,Jim Sherrit,11,40,30,C,1975
17578,1,25,Jim Shires,2,20,3,LW,1970
17579,3,26,Jim Shires,0,18,3,LW,1971
17580,2,27,Jim Shires,1,18,3,LW,1972
17581,10,23,Jim Slater,10,71,20,C,2005
17582,14,24,Jim Slater,5,74,19,C,2006
17583,5,25,Jim Slater,8,69,13,C,2007
17584,10,26,Jim Slater,8,60,18,C,2008
17585,7,27,Jim Slater,11,61,18,C,2009
17586,7,28,Jim Slater,5,36,12,C,2010
17587,8,29,Jim Slater,13,78,21,C,2011
17588,1,30,Jim Slater,1,26,2,C,2012
17589,1,31,Jim Slater,1,27,2,C,2013
17590,8,32,Jim Slater,5,82,13,C,2014
17591,0,23,Jim Stanfield,0,1,0,C,1969
17592,0,24,Jim Stanfield,0,2,0,C,1970
17593,1,25,Jim Stanfield,0,4,1,C,1971
17594,10,22,Jim Storm,6,68,16,LW,1993
17595,3,23,Jim Storm,0,6,3,LW,1994
17596,2,24,Jim Storm,1,10,3,LW,1995
17597,0,21,Jim Thomson,0,10,0,RW,1986
17598,0,23,Jim Thomson,2,19,2,RW,1988
17599,0,24,Jim Thomson,0,3,0,RW,1989
17600,0,25,Jim Thomson,1,8,1,RW,1990
17601,2,26,Jim Thomson,1,45,3,RW,1991
17602,1,27,Jim Thomson,0,24,1,RW,1992
17603,0,28,Jim Thomson,0,6,0,RW,1993
17604,0,23,Jim Troy,0,14,0,RW,1975
17605,0,23,Jim Troy,0,14,0,RW,1975
17606,0,24,Jim Troy,0,7,0,RW,1976
17607,0,24,Jim Troy,0,7,0,RW,1976
17608,0,25,Jim Troy,2,47,2,RW,1977
17609,0,25,Jim Troy,2,47,2,RW,1977
17610,27,19,Jim Turkiewicz,3,78,30,D,1974
17611,27,19,Jim Turkiewicz,3,78,30,D,1974
17612,29,20,Jim Turkiewicz,10,77,39,D,1975
17613,29,20,Jim Turkiewicz,10,77,39,D,1975
17614,25,21,Jim Turkiewicz,6,80,31,D,1976
17615,25,21,Jim Turkiewicz,6,80,31,D,1976
17616,21,22,Jim Turkiewicz,3,78,24,D,1977
17617,21,22,Jim Turkiewicz,3,78,24,D,1977
17618,17,23,Jim Turkiewicz,3,79,20,D,1978
17619,17,23,Jim Turkiewicz,3,79,20,D,1978
17620,1,22,Jim Vandermeer,2,24,3,D,2002
17621,12,23,Jim Vandermeer,5,46,17,D,2003
17622,18,25,Jim Vandermeer,6,76,24,D,2005
17623,6,26,Jim Vandermeer,1,46,7,D,2006
17624,14,27,Jim Vandermeer,3,75,17,D,2007
17625,6,28,Jim Vandermeer,1,45,7,D,2008
17626,8,29,Jim Vandermeer,4,62,12,D,2009
17627,12,30,Jim Vandermeer,2,62,14,D,2010
17628,3,31,Jim Vandermeer,1,25,4,D,2011
17629,1,23,Jim Vesey,1,5,2,C,1988
17630,1,24,Jim Vesey,0,6,1,C,1989
17631,0,26,Jim Vesey,0,4,0,C,1991
17632,1,25,Jim Walsh,0,4,1,D,1981
17633,9,24,Jim Warner,6,41,15,RW,1978
17634,9,24,Jim Warner,6,41,15,RW,1978
17635,3,25,Jim Warner,0,32,3,RW,1979
17636,3,24,Jim Watson,0,61,3,D,1967
17637,1,25,Jim Watson,0,8,1,D,1968
17638,0,26,Jim Watson,0,4,0,D,1969
17639,9,27,Jim Watson,2,78,11,D,1970
17640,6,28,Jim Watson,2,66,8,D,1971
17641,15,29,Jim Watson,5,75,20,D,1972
17642,15,29,Jim Watson,5,75,20,D,1972
17643,11,30,Jim Watson,0,71,11,D,1973
17644,6,30,Jim Watson,0,48,6,D,1973
17645,5,30,Jim Watson,0,23,5,D,1973
17646,11,30,Jim Watson,0,71,11,D,1973
17647,6,30,Jim Watson,0,48,6,D,1973
17648,5,30,Jim Watson,0,23,5,D,1973
17649,6,31,Jim Watson,2,57,8,D,1974
17650,6,31,Jim Watson,2,57,8,D,1974
17651,1,32,Jim Watson,0,28,1,D,1975
17652,1,32,Jim Watson,0,28,1,D,1975
17653,15,23,Jim Wiemer,5,64,20,D,1983
17654,5,24,Jim Wiemer,7,32,12,D,1984
17655,0,25,Jim Wiemer,3,7,3,D,1985
17656,2,27,Jim Wiemer,1,12,3,D,1987
17657,3,28,Jim Wiemer,2,9,5,D,1988
17658,14,29,Jim Wiemer,5,61,19,D,1989
17659,19,30,Jim Wiemer,4,61,23,D,1990
17660,8,31,Jim Wiemer,1,47,9,D,1991
17661,6,32,Jim Wiemer,1,28,7,D,1992
17662,0,33,Jim Wiemer,0,4,0,D,1993
17663,1,22,Jim Wiley,0,4,1,C,1972
17664,3,23,Jim Wiley,0,22,3,C,1973
17665,0,24,Jim Wiley,0,1,0,C,1974
17666,0,25,Jim Wiley,0,2,0,C,1975
17667,6,26,Jim Wiley,4,34,10,C,1976
17668,0,22,Jim Wiste,0,3,0,C,1968
17669,8,23,Jim Wiste,0,26,8,LW,1969
17670,2,24,Jim Wiste,1,23,3,C,1970
17671,43,26,Jim Wiste,28,70,71,C,1972
17672,35,27,Jim Wiste,23,76,58,C,1973
17673,35,27,Jim Wiste,23,76,58,C,1973
17674,28,28,Jim Wiste,13,75,41,C,1974
17675,28,28,Jim Wiste,13,75,41,C,1974
17676,2,29,Jim Wiste,0,7,2,C,1975
17677,2,29,Jim Wiste,0,7,2,C,1975
17678,0,24,Jim Witherspoon,0,2,0,D,1975
17679,11,21,Jimmie Olvestad,3,74,14,RW,2001
17680,3,22,Jimmie Olvestad,0,37,3,LW,2002
17681,42,18,Jimmy Carson,37,80,79,C,1986
17682,52,19,Jimmy Carson,55,80,107,C,1987
17683,51,20,Jimmy Carson,49,80,100,C,1988
17684,18,21,Jimmy Carson,21,48,39,RW,1989
17685,25,22,Jimmy Carson,21,64,46,C,1990
17686,35,23,Jimmy Carson,34,80,69,C,1991
17687,36,24,Jimmy Carson,37,86,73,C,1992
17688,17,25,Jimmy Carson,11,59,28,C,1993
17689,10,26,Jimmy Carson,9,38,19,C,1994
17690,0,27,Jimmy Carson,1,11,1,C,1995
17691,4,22,Jimmy Hayes,5,31,9,RW,2011
17692,3,23,Jimmy Hayes,1,10,4,RW,2012
17693,7,24,Jimmy Hayes,11,55,18,RW,2013
17694,16,25,Jimmy Hayes,19,72,35,RW,2014
17695,16,26,Jimmy Hayes,13,75,29,RW,2015
17696,3,27,Jimmy Hayes,2,58,5,RW,2016
17697,6,28,Jimmy Hayes,3,33,9,RW,2017
17698,2,21,Jimmy Jones,3,18,5,C,1973
17699,2,21,Jimmy Jones,3,18,5,C,1973
17700,7,22,Jimmy Jones,11,63,18,C,1974
17701,9,25,Jimmy Jones,4,78,13,C,1977
17702,9,26,Jimmy Jones,9,69,18,C,1978
17703,0,27,Jimmy Jones,0,1,0,C,1979
17704,5,20,Jimmy Mann,3,72,8,RW,1979
17705,3,21,Jimmy Mann,3,37,6,RW,1980
17706,2,22,Jimmy Mann,3,37,5,RW,1981
17707,1,23,Jimmy Mann,0,40,1,RW,1982
17708,2,24,Jimmy Mann,1,38,3,RW,1983
17709,4,25,Jimmy Mann,0,25,4,RW,1984
17710,3,26,Jimmy Mann,0,35,3,RW,1985
17711,0,28,Jimmy Mann,0,9,0,RW,1987
17712,6,23,Jimmy Peters,5,45,11,C,1967
17713,15,24,Jimmy Peters,10,76,25,C,1968
17714,9,25,Jimmy Peters,15,74,24,C,1969
17715,5,28,Jimmy Peters,4,77,9,C,1972
17716,0,29,Jimmy Peters,2,25,2,C,1973
17717,0,30,Jimmy Peters,0,3,0,C,1974
17718,23,27,Jimmy Roberts,14,74,37,RW,1967
17719,19,28,Jimmy Roberts,14,72,33,RW,1968
17720,17,29,Jimmy Roberts,13,76,30,D,1969
17721,18,30,Jimmy Roberts,13,72,31,D,1970
17722,22,31,Jimmy Roberts,12,77,34,D,1971
17723,18,32,Jimmy Roberts,14,77,32,RW,1972
17724,16,33,Jimmy Roberts,8,67,24,D,1973
17725,13,34,Jimmy Roberts,5,79,18,D,1974
17726,8,35,Jimmy Roberts,13,74,21,RW,1975
17727,14,36,Jimmy Roberts,5,45,19,RW,1976
17728,10,37,Jimmy Roberts,4,75,14,D,1977
17729,11,23,Jimmy Vesey,16,80,27,LW,2016
17730,11,24,Jimmy Vesey,17,79,28,LW,2017
17731,1,20,Jimmy Watson,0,4,1,D,1972
17732,18,21,Jimmy Watson,2,78,20,D,1973
17733,18,22,Jimmy Watson,7,68,25,D,1974
17734,34,23,Jimmy Watson,2,79,36,D,1975
17735,23,24,Jimmy Watson,3,71,26,D,1976
17736,12,25,Jimmy Watson,5,71,17,D,1977
17737,13,26,Jimmy Watson,9,77,22,D,1978
17738,18,27,Jimmy Watson,5,71,23,D,1979
17739,2,28,Jimmy Watson,2,18,4,D,1980
17740,9,29,Jimmy Watson,3,76,12,D,1981
17741,2,,Jindrich Kokrment,1,6,3,C,1977
17742,2,,Jindrich Kokrment,1,6,3,C,1977
17743,1,28,Jindrich Kokrment,0,5,1,RW,1978
17744,1,28,Jindrich Kokrment,0,5,1,RW,1978
17745,1,28,Jindrich Micka,0,5,1,RW,1978
17746,1,28,Jindrich Micka,0,5,1,RW,1978
17747,0,22,Jiri Bicek,1,5,1,LW,2000
17748,0,23,Jiri Bicek,0,1,0,RW,2001
17749,6,24,Jiri Bicek,5,44,11,RW,2002
17750,1,25,Jiri Bicek,0,12,1,RW,2003
17751,1,32,Jiri Bubla,1,23,2,D,1981
17752,28,33,Jiri Bubla,2,72,30,D,1982
17753,33,34,Jiri Bubla,6,62,39,D,1983
17754,15,35,Jiri Bubla,2,56,17,D,1984
17755,24,36,Jiri Bubla,6,43,30,D,1985
17756,16,33,Jiri Dopita,11,52,27,C,2001
17757,5,34,Jiri Dopita,1,21,6,C,2002
17758,8,19,Jiri Fischer,0,52,8,D,1999
17759,8,20,Jiri Fischer,1,55,9,D,2000
17760,8,21,Jiri Fischer,2,80,10,D,2001
17761,5,22,Jiri Fischer,1,15,6,D,2002
17762,15,23,Jiri Fischer,4,81,19,D,2003
17763,5,25,Jiri Fischer,3,22,8,D,2005
17764,5,30,Jiri Hrdina,2,9,7,C,1987
17765,32,31,Jiri Hrdina,22,70,54,C,1988
17766,18,32,Jiri Hrdina,12,64,30,C,1989
17767,17,33,Jiri Hrdina,6,51,23,C,1990
17768,13,34,Jiri Hrdina,3,56,16,C,1991
17769,2,20,Jiri Hudler,1,12,3,C,2003
17770,0,22,Jiri Hudler,0,4,0,C,2005
17771,10,23,Jiri Hudler,15,76,25,C,2006
17772,29,24,Jiri Hudler,13,81,42,RW,2007
17773,34,25,Jiri Hudler,23,82,57,RW,2008
17774,27,27,Jiri Hudler,10,73,37,C,2010
17775,25,28,Jiri Hudler,25,81,50,C,2011
17776,17,29,Jiri Hudler,10,42,27,C,2012
17777,37,30,Jiri Hudler,17,75,54,C,2013
17778,45,31,Jiri Hudler,31,78,76,C,2014
17779,30,32,Jiri Hudler,16,72,46,C,2015
17780,8,33,Jiri Hudler,3,32,11,RW,2016
17781,2,,Jiri Kolar,1,6,3,C,1977
17782,2,,Jiri Kolar,1,6,3,C,1977
17783,13,22,Jiri Latal,6,32,19,D,1989
17784,21,23,Jiri Latal,5,50,26,D,1990
17785,2,24,Jiri Latal,1,10,3,D,1991
17786,1,22,Jiri Novotny,2,14,3,C,2005
17787,13,23,Jiri Novotny,6,68,19,C,2006
17788,14,24,Jiri Novotny,8,65,22,C,2007
17789,3,25,Jiri Novotny,4,42,7,C,2008
17790,2,28,Jiri Sejba,0,11,2,LW,1990
17791,14,22,Jiri Sekac,9,69,23,LW,2014
17792,5,23,Jiri Sekac,1,39,6,LW,2015
17793,22,21,Jiri Slegr,4,41,26,D,1992
17794,33,22,Jiri Slegr,5,78,38,D,1993
17795,10,23,Jiri Slegr,2,31,12,D,1994
17796,13,24,Jiri Slegr,4,57,17,D,1995
17797,12,26,Jiri Slegr,5,73,17,D,1997
17798,20,27,Jiri Slegr,3,63,23,D,1998
17799,20,28,Jiri Slegr,11,74,31,D,1999
17800,26,29,Jiri Slegr,8,75,34,D,2000
17801,6,30,Jiri Slegr,3,46,9,D,2001
17802,20,32,Jiri Slegr,6,52,26,D,2003
17803,11,34,Jiri Slegr,5,32,16,D,2005
17804,6,19,Jiri Tlusty,10,58,16,C,2007
17805,4,20,Jiri Tlusty,0,14,4,C,2008
17806,5,21,Jiri Tlusty,1,20,6,C,2009
17807,6,22,Jiri Tlusty,6,57,12,C,2010
17808,19,23,Jiri Tlusty,17,79,36,C,2011
17809,15,24,Jiri Tlusty,23,48,38,C,2012
17810,14,25,Jiri Tlusty,16,68,30,LW,2013
17811,17,26,Jiri Tlusty,14,72,31,LW,2014
17812,2,27,Jiri Tlusty,2,30,4,LW,2015
17813,0,22,Joakim Andersson,0,5,0,C,2011
17814,5,23,Joakim Andersson,3,38,8,C,2012
17815,9,24,Joakim Andersson,8,65,17,C,2013
17816,5,25,Joakim Andersson,3,68,8,C,2014
17817,2,26,Joakim Andersson,1,29,3,C,2015
17818,0,22,Joakim Lindstrom,0,3,0,LW,2005
17819,0,23,Joakim Lindstrom,1,9,1,C,2006
17820,4,24,Joakim Lindstrom,3,25,7,C,2007
17821,11,25,Joakim Lindstrom,9,44,20,C,2008
17822,3,28,Joakim Lindstrom,2,16,5,LW,2011
17823,6,31,Joakim Lindstrom,4,53,10,C,2014
17824,2,21,Joakim Nordstrom,1,16,3,C,2013
17825,3,22,Joakim Nordstrom,0,38,3,LW,2014
17826,14,23,Joakim Nordstrom,10,71,24,LW,2015
17827,5,24,Joakim Nordstrom,7,82,12,LW,2016
17828,5,25,Joakim Nordstrom,2,75,7,LW,2017
17829,9,24,Joakim Ryan,3,62,12,D,2017
17830,0,22,Joby Messier,0,11,0,D,1992
17831,2,23,Joby Messier,0,4,2,D,1993
17832,2,24,Joby Messier,0,10,2,D,1994
17833,0,19,Jocelyn Gauvreau,0,2,0,D,1983
17834,38,20,Jocelyn Guevremont,13,75,51,D,1971
17835,26,21,Jocelyn Guevremont,16,78,42,D,1972
17836,24,22,Jocelyn Guevremont,15,72,39,D,1973
17837,25,23,Jocelyn Guevremont,7,66,32,D,1974
17838,40,24,Jocelyn Guevremont,12,80,52,D,1975
17839,29,25,Jocelyn Guevremont,9,80,38,D,1976
17840,28,26,Jocelyn Guevremont,7,66,35,D,1977
17841,8,27,Jocelyn Guevremont,3,34,11,D,1978
17842,5,28,Jocelyn Guevremont,2,20,7,D,1979
17843,8,19,Jocelyn Lemieux,10,53,18,LW,1986
17844,0,20,Jocelyn Lemieux,1,23,1,RW,1987
17845,1,21,Jocelyn Lemieux,0,1,1,RW,1988
17846,13,22,Jocelyn Lemieux,14,73,27,RW,1989
17847,7,23,Jocelyn Lemieux,6,67,13,RW,1990
17848,10,24,Jocelyn Lemieux,6,78,16,RW,1991
17849,21,25,Jocelyn Lemieux,10,81,31,RW,1992
17850,9,26,Jocelyn Lemieux,18,82,27,RW,1993
17851,5,27,Jocelyn Lemieux,6,41,11,RW,1994
17852,7,28,Jocelyn Lemieux,5,67,12,RW,1995
17853,0,29,Jocelyn Lemieux,1,2,1,RW,1996
17854,3,30,Jocelyn Lemieux,3,30,6,RW,1997
17855,0,21,Jochen Hecht,0,3,0,C,1998
17856,21,22,Jochen Hecht,13,63,34,RW,1999
17857,25,23,Jochen Hecht,19,72,44,LW,2000
17858,24,24,Jochen Hecht,16,82,40,LW,2001
17859,16,25,Jochen Hecht,10,49,26,LW,2002
17860,37,26,Jochen Hecht,15,64,52,LW,2003
17861,24,28,Jochen Hecht,18,64,42,LW,2005
17862,37,29,Jochen Hecht,19,76,56,C,2006
17863,27,30,Jochen Hecht,22,75,49,C,2007
17864,15,31,Jochen Hecht,12,70,27,C,2008
17865,21,32,Jochen Hecht,21,79,42,C,2009
17866,17,33,Jochen Hecht,12,67,29,C,2010
17867,4,34,Jochen Hecht,4,22,8,C,2011
17868,9,35,Jochen Hecht,5,47,14,C,2012
17869,16,26,Jock Callander,11,41,27,RW,1987
17870,5,27,Jock Callander,6,30,11,RW,1988
17871,7,28,Jock Callander,4,30,11,RW,1989
17872,1,31,Jock Callander,1,8,2,RW,1992
17873,2,21,Jody Gage,2,16,4,RW,1980
17874,10,22,Jody Gage,9,31,19,RW,1981
17875,0,24,Jody Gage,0,3,0,RW,1983
17876,2,26,Jody Gage,3,7,5,RW,1985
17877,0,28,Jody Gage,0,2,0,RW,1987
17878,1,32,Jody Gage,0,9,1,RW,1991
17879,18,19,Jody Hull,16,60,34,RW,1988
17880,10,20,Jody Hull,7,38,17,RW,1989
17881,8,21,Jody Hull,5,47,13,RW,1990
17882,0,22,Jody Hull,0,3,0,RW,1991
17883,21,23,Jody Hull,13,69,34,RW,1992
17884,13,24,Jody Hull,13,69,26,RW,1993
17885,8,25,Jody Hull,11,46,19,RW,1994
17886,17,26,Jody Hull,20,78,37,RW,1995
17887,6,27,Jody Hull,10,67,16,RW,1996
17888,4,28,Jody Hull,4,49,8,RW,1997
17889,11,29,Jody Hull,3,72,14,RW,1998
17890,3,30,Jody Hull,10,67,13,RW,1999
17891,8,31,Jody Hull,7,71,15,RW,2000
17892,2,32,Jody Hull,2,24,4,RW,2001
17893,8,33,Jody Hull,3,70,11,RW,2002
17894,0,34,Jody Hull,0,1,0,RW,2003
17895,0,24,Jody Shelley,0,1,0,LW,2000
17896,3,25,Jody Shelley,3,52,6,LW,2001
17897,4,26,Jody Shelley,1,68,5,LW,2002
17898,3,27,Jody Shelley,3,76,6,LW,2003
17899,7,29,Jody Shelley,3,80,10,LW,2005
17900,1,30,Jody Shelley,1,72,2,LW,2006
17901,6,31,Jody Shelley,1,62,7,LW,2007
17902,2,32,Jody Shelley,2,70,4,LW,2008
17903,7,33,Jody Shelley,2,57,9,LW,2009
17904,2,34,Jody Shelley,2,58,4,LW,2010
17905,1,35,Jody Shelley,0,30,1,LW,2011
17906,0,36,Jody Shelley,0,1,0,LW,2012
17907,2,26,Joe Callahan,0,18,2,D,2008
17908,1,27,Joe Callahan,0,1,1,D,2009
17909,1,28,Joe Callahan,0,27,1,D,2010
17910,12,18,Joe Cirella,7,65,19,D,1981
17911,1,19,Joe Cirella,0,2,1,D,1982
17912,33,20,Joe Cirella,11,79,44,D,1983
17913,18,21,Joe Cirella,6,66,24,D,1984
17914,23,22,Joe Cirella,6,66,29,D,1985
17915,22,23,Joe Cirella,9,65,31,D,1986
17916,31,24,Joe Cirella,8,80,39,D,1987
17917,19,25,Joe Cirella,3,80,22,D,1988
17918,14,26,Joe Cirella,4,56,18,D,1989
17919,10,27,Joe Cirella,3,58,13,D,1990
17920,12,28,Joe Cirella,3,67,15,D,1991
17921,6,29,Joe Cirella,3,55,9,D,1992
17922,9,30,Joe Cirella,1,63,10,D,1993
17923,1,31,Joe Cirella,0,20,1,D,1994
17924,0,32,Joe Cirella,0,6,0,D,1995
17925,1,21,Joe Colborne,0,1,1,C,2010
17926,4,22,Joe Colborne,1,10,5,C,2011
17927,0,23,Joe Colborne,0,5,0,C,2012
17928,18,24,Joe Colborne,10,80,28,C,2013
17929,20,25,Joe Colborne,8,64,28,C,2014
17930,25,26,Joe Colborne,19,73,44,C,2015
17931,4,27,Joe Colborne,4,62,8,C,2016
17932,9,21,Joe Contini,12,37,21,C,1977
17933,12,22,Joe Contini,5,30,17,C,1978
17934,0,24,Joe Contini,0,1,0,C,1980
17935,7,25,Joe Corvo,5,50,12,D,2002
17936,17,26,Joe Corvo,8,72,25,D,2003
17937,26,28,Joe Corvo,14,81,40,D,2005
17938,29,29,Joe Corvo,8,76,37,D,2006
17939,35,30,Joe Corvo,13,74,48,D,2007
17940,24,31,Joe Corvo,14,81,38,D,2008
17941,12,32,Joe Corvo,6,52,18,D,2009
17942,29,33,Joe Corvo,11,82,40,D,2010
17943,21,34,Joe Corvo,4,75,25,D,2011
17944,11,35,Joe Corvo,6,40,17,D,2012
17945,7,36,Joe Corvo,3,25,10,D,2013
17946,3,23,Joe Day,0,24,3,LW,1991
17947,7,24,Joe Day,1,24,8,LW,1992
17948,0,25,Joe Day,0,24,0,C,1993
17949,1,23,Joe DiPenta,1,3,2,D,2002
17950,6,26,Joe DiPenta,2,72,8,D,2005
17951,6,27,Joe DiPenta,2,76,8,D,2006
17952,4,28,Joe DiPenta,1,23,5,D,2007
17953,5,24,Joe Dziedzic,5,69,10,LW,1995
17954,9,25,Joe Dziedzic,9,59,18,LW,1996
17955,0,27,Joe Dziedzic,0,2,0,LW,1998
17956,0,24,Joe Finley,0,5,0,D,2011
17957,1,25,Joe Finley,0,16,1,D,2012
17958,0,22,Joe Fortunato,0,1,0,LW,1976
17959,0,22,Joe Fortunato,0,1,0,LW,1976
17960,4,24,Joe Hardy,5,23,9,C,1969
17961,10,25,Joe Hardy,4,40,14,C,1970
17962,33,27,Joe Hardy,17,72,50,C,1972
17963,33,27,Joe Hardy,17,72,50,C,1972
17964,35,28,Joe Hardy,24,77,59,C,1973
17965,35,28,Joe Hardy,24,77,59,C,1973
17966,26,29,Joe Hardy,5,61,31,C,1974
17967,17,29,Joe Hardy,2,32,19,C,1974
17968,6,29,Joe Hardy,1,17,7,C,1974
17969,3,29,Joe Hardy,2,12,5,C,1974
17970,26,29,Joe Hardy,5,61,31,C,1974
17971,17,29,Joe Hardy,2,32,19,C,1974
17972,6,29,Joe Hardy,1,17,7,C,1974
17973,3,29,Joe Hardy,2,12,5,C,1974
17974,3,21,Joe Hicketts,0,5,3,D,2017
17975,0,23,Joe Hulbig,0,6,0,LW,1996
17976,2,24,Joe Hulbig,2,17,4,LW,1997
17977,0,25,Joe Hulbig,0,1,0,LW,1998
17978,2,26,Joe Hulbig,2,24,4,LW,1999
17979,0,27,Joe Hulbig,0,7,0,RW,2000
17980,0,24,Joe Jensen,1,6,1,C,2007
17981,14,24,Joe Juneau,5,14,19,C,1991
17982,70,25,Joe Juneau,32,84,102,LW,1992
17983,66,26,Joe Juneau,19,74,85,C,1993
17984,38,27,Joe Juneau,5,44,43,C,1994
17985,50,28,Joe Juneau,14,80,64,C,1995
17986,27,29,Joe Juneau,15,58,42,LW,1996
17987,22,30,Joe Juneau,9,56,31,C,1997
17988,28,31,Joe Juneau,15,72,43,C,1998
17989,24,32,Joe Juneau,13,65,37,C,1999
17990,23,33,Joe Juneau,10,69,33,LW,2000
17991,28,34,Joe Juneau,8,70,36,C,2001
17992,16,35,Joe Juneau,6,72,22,C,2002
17993,10,36,Joe Juneau,5,70,15,C,2003
17994,0,20,Joe Kocur,1,17,1,RW,1984
17995,6,21,Joe Kocur,9,59,15,RW,1985
17996,9,22,Joe Kocur,9,77,18,RW,1986
17997,7,23,Joe Kocur,7,63,14,RW,1987
17998,9,24,Joe Kocur,9,60,18,RW,1988
17999,20,25,Joe Kocur,16,71,36,RW,1989
18000,4,26,Joe Kocur,5,57,9,RW,1990
18001,4,27,Joe Kocur,7,51,11,RW,1991
18002,6,28,Joe Kocur,3,65,9,RW,1992
18003,1,29,Joe Kocur,2,71,3,RW,1993
18004,2,30,Joe Kocur,1,48,3,RW,1994
18005,3,31,Joe Kocur,1,45,4,RW,1995
18006,1,32,Joe Kocur,2,34,3,RW,1996
18007,5,33,Joe Kocur,6,63,11,RW,1997
18008,5,34,Joe Kocur,2,39,7,RW,1998
18009,5,20,Joe Kowal,0,16,5,LW,1976
18010,0,21,Joe Kowal,0,6,0,LW,1977
18011,8,24,Joe Lundrigan,2,49,10,D,1972
18012,0,26,Joe Lundrigan,0,3,0,D,1974
18013,1,20,Joe McDonnell,0,7,1,D,1981
18014,9,23,Joe McDonnell,2,40,11,D,1984
18015,0,24,Joe McDonnell,0,3,0,D,1985
18016,3,22,Joe Micheletti,3,14,6,D,1976
18017,3,22,Joe Micheletti,3,14,6,D,1976
18018,34,23,Joe Micheletti,14,56,48,D,1977
18019,34,23,Joe Micheletti,14,56,48,D,1977
18020,33,24,Joe Micheletti,14,72,47,D,1978
18021,33,24,Joe Micheletti,14,72,47,D,1978
18022,16,25,Joe Micheletti,2,54,18,D,1979
18023,27,26,Joe Micheletti,4,63,31,D,1980
18024,17,27,Joe Micheletti,5,41,22,D,1981
18025,0,22,Joe Morrow,1,15,1,D,2014
18026,0,23,Joe Motzko,0,2,0,RW,2003
18027,0,25,Joe Motzko,0,2,0,LW,2005
18028,0,26,Joe Motzko,1,7,1,RW,2006
18029,2,27,Joe Motzko,2,8,4,RW,2007
18030,0,28,Joe Motzko,1,6,1,RW,2008
18031,34,24,Joe Mullen,25,45,59,RW,1981
18032,30,25,Joe Mullen,17,49,47,RW,1982
18033,44,26,Joe Mullen,41,80,85,RW,1983
18034,52,27,Joe Mullen,40,79,92,RW,1984
18035,46,28,Joe Mullen,44,77,90,RW,1985
18036,40,29,Joe Mullen,47,79,87,RW,1986
18037,44,30,Joe Mullen,40,80,84,RW,1987
18038,59,31,Joe Mullen,51,79,110,RW,1988
18039,33,32,Joe Mullen,36,78,69,RW,1989
18040,22,33,Joe Mullen,17,47,39,RW,1990
18041,45,34,Joe Mullen,42,77,87,RW,1991
18042,37,35,Joe Mullen,33,72,70,RW,1992
18043,32,36,Joe Mullen,38,84,70,LW,1993
18044,21,37,Joe Mullen,16,45,37,RW,1994
18045,7,38,Joe Mullen,8,37,15,RW,1995
18046,15,39,Joe Mullen,7,54,22,RW,1996
18047,1,19,Joe Murphy,0,5,1,C,1986
18048,9,20,Joe Murphy,10,50,19,RW,1987
18049,7,21,Joe Murphy,1,26,8,RW,1988
18050,19,22,Joe Murphy,10,71,29,RW,1989
18051,35,23,Joe Murphy,27,80,62,RW,1990
18052,47,24,Joe Murphy,35,80,82,RW,1991
18053,10,25,Joe Murphy,7,19,17,RW,1992
18054,39,26,Joe Murphy,31,81,70,LW,1993
18055,18,27,Joe Murphy,23,40,41,RW,1994
18056,29,28,Joe Murphy,22,70,51,RW,1995
18057,25,29,Joe Murphy,20,75,45,RW,1996
18058,13,30,Joe Murphy,9,37,22,RW,1997
18059,23,31,Joe Murphy,25,76,48,RW,1998
18060,15,32,Joe Murphy,12,55,27,RW,1999
18061,5,33,Joe Murphy,1,14,6,RW,2000
18062,1,20,Joe Nieuwendyk,5,9,6,C,1986
18063,41,21,Joe Nieuwendyk,51,75,92,C,1987
18064,31,22,Joe Nieuwendyk,51,77,82,C,1988
18065,50,23,Joe Nieuwendyk,45,79,95,C,1989
18066,40,24,Joe Nieuwendyk,45,79,85,C,1990
18067,34,25,Joe Nieuwendyk,22,69,56,C,1991
18068,37,26,Joe Nieuwendyk,38,79,75,C,1992
18069,39,27,Joe Nieuwendyk,36,64,75,C,1993
18070,29,28,Joe Nieuwendyk,21,46,50,C,1994
18071,18,29,Joe Nieuwendyk,14,52,32,C,1995
18072,21,30,Joe Nieuwendyk,30,66,51,C,1996
18073,30,31,Joe Nieuwendyk,39,73,69,C,1997
18074,27,32,Joe Nieuwendyk,28,67,55,C,1998
18075,19,33,Joe Nieuwendyk,15,48,34,C,1999
18076,23,34,Joe Nieuwendyk,29,69,52,C,2000
18077,33,35,Joe Nieuwendyk,25,81,58,C,2001
18078,28,36,Joe Nieuwendyk,17,80,45,C,2002
18079,28,37,Joe Nieuwendyk,22,64,50,C,2003
18080,30,39,Joe Nieuwendyk,26,65,56,C,2005
18081,3,40,Joe Nieuwendyk,5,15,8,C,2006
18082,5,20,Joe Noris,2,35,7,C,1971
18083,0,21,Joe Noris,0,2,0,C,1972
18084,0,22,Joe Noris,0,18,0,C,1973
18085,40,24,Joe Noris,28,80,68,RW,1975
18086,40,24,Joe Noris,28,80,68,RW,1975
18087,57,25,Joe Noris,35,73,92,RW,1976
18088,57,25,Joe Noris,35,73,92,RW,1976
18089,19,26,Joe Noris,9,45,28,C,1977
18090,19,26,Joe Noris,9,45,28,C,1977
18091,5,20,Joe Paterson,2,38,7,LW,1980
18092,0,21,Joe Paterson,0,3,0,LW,1981
18093,1,22,Joe Paterson,2,33,3,LW,1982
18094,5,23,Joe Paterson,2,41,7,LW,1983
18095,0,24,Joe Paterson,0,6,0,LW,1984
18096,18,25,Joe Paterson,9,52,27,LW,1985
18097,1,26,Joe Paterson,2,45,3,LW,1986
18098,6,27,Joe Paterson,2,53,8,LW,1987
18099,1,28,Joe Paterson,0,20,1,LW,1988
18100,14,22,Joe Pavelski,14,46,28,C,2006
18101,21,23,Joe Pavelski,19,82,40,C,2007
18102,34,24,Joe Pavelski,25,80,59,C,2008
18103,26,25,Joe Pavelski,25,67,51,C,2009
18104,46,26,Joe Pavelski,20,74,66,C,2010
18105,30,27,Joe Pavelski,31,82,61,C,2011
18106,15,28,Joe Pavelski,16,48,31,C,2012
18107,38,29,Joe Pavelski,41,82,79,C,2013
18108,33,30,Joe Pavelski,37,82,70,C,2014
18109,40,31,Joe Pavelski,38,82,78,C,2015
18110,39,32,Joe Pavelski,29,81,68,C,2016
18111,44,33,Joe Pavelski,22,82,66,C,2017
18112,0,22,Joe Piskula,0,5,0,D,2006
18113,0,27,Joe Piskula,0,5,0,D,2011
18114,0,29,Joe Piskula,0,2,0,D,2013
18115,0,30,Joe Piskula,0,1,0,D,2014
18116,0,20,Joe Reekie,0,3,0,D,1985
18117,8,21,Joe Reekie,1,56,9,D,1986
18118,4,22,Joe Reekie,1,30,5,D,1987
18119,3,23,Joe Reekie,1,15,4,D,1988
18120,8,24,Joe Reekie,1,31,9,D,1989
18121,16,25,Joe Reekie,3,66,19,D,1990
18122,12,26,Joe Reekie,4,54,16,D,1991
18123,11,27,Joe Reekie,2,42,13,D,1992
18124,16,28,Joe Reekie,1,85,17,D,1993
18125,6,29,Joe Reekie,1,48,7,D,1994
18126,7,30,Joe Reekie,3,78,10,D,1995
18127,8,31,Joe Reekie,1,65,9,D,1996
18128,8,32,Joe Reekie,2,68,10,D,1997
18129,10,33,Joe Reekie,0,73,10,D,1998
18130,7,34,Joe Reekie,0,59,7,D,1999
18131,9,35,Joe Reekie,2,74,11,D,2000
18132,6,36,Joe Reekie,2,55,8,D,2001
18133,8,26,Joe Robertson,5,29,13,C,1974
18134,4,26,Joe Robertson,4,18,8,C,1974
18135,4,26,Joe Robertson,1,11,5,C,1974
18136,8,26,Joe Robertson,5,29,13,C,1974
18137,5,21,Joe Sacco,0,20,5,LW,1990
18138,4,22,Joe Sacco,7,17,11,LW,1991
18139,4,23,Joe Sacco,4,23,8,LW,1992
18140,18,24,Joe Sacco,19,84,37,RW,1993
18141,8,25,Joe Sacco,10,41,18,RW,1994
18142,14,26,Joe Sacco,13,76,27,RW,1995
18143,17,27,Joe Sacco,12,77,29,RW,1996
18144,14,28,Joe Sacco,11,80,25,LW,1997
18145,0,29,Joe Sacco,3,73,3,RW,1998
18146,16,30,Joe Sacco,7,79,23,LW,1999
18147,7,31,Joe Sacco,7,69,14,RW,2000
18148,7,32,Joe Sacco,0,65,7,LW,2001
18149,5,33,Joe Sacco,1,34,6,RW,2002
18150,39,19,Joe Sakic,23,70,62,C,1988
18151,63,20,Joe Sakic,39,80,102,C,1989
18152,61,21,Joe Sakic,48,80,109,C,1990
18153,65,22,Joe Sakic,29,69,94,C,1991
18154,57,23,Joe Sakic,48,78,105,C,1992
18155,64,24,Joe Sakic,28,84,92,C,1993
18156,43,25,Joe Sakic,19,47,62,C,1994
18157,69,26,Joe Sakic,51,82,120,C,1995
18158,52,27,Joe Sakic,22,65,74,C,1996
18159,36,28,Joe Sakic,27,64,63,C,1997
18160,55,29,Joe Sakic,41,73,96,C,1998
18161,53,30,Joe Sakic,28,60,81,C,1999
18162,64,31,Joe Sakic,54,82,118,C,2000
18163,53,32,Joe Sakic,26,82,79,C,2001
18164,32,33,Joe Sakic,26,58,58,C,2002
18165,54,34,Joe Sakic,33,81,87,C,2003
18166,55,36,Joe Sakic,32,82,87,C,2005
18167,64,37,Joe Sakic,36,82,100,C,2006
18168,27,38,Joe Sakic,13,44,40,C,2007
18169,10,39,Joe Sakic,2,15,12,C,2008
18170,3,29,Joe Szura,1,20,4,C,1967
18171,12,30,Joe Szura,9,70,21,C,1968
18172,32,34,Joe Szura,13,73,45,C,1972
18173,32,34,Joe Szura,13,73,45,C,1972
18174,7,35,Joe Szura,8,42,15,C,1973
18175,7,35,Joe Szura,8,42,15,C,1973
18176,4,18,Joe Thornton,3,55,7,C,1997
18177,25,19,Joe Thornton,16,81,41,C,1998
18178,37,20,Joe Thornton,23,81,60,C,1999
18179,34,21,Joe Thornton,37,72,71,C,2000
18180,46,22,Joe Thornton,22,66,68,C,2001
18181,65,23,Joe Thornton,36,77,101,C,2002
18182,50,24,Joe Thornton,23,77,73,C,2003
18183,96,26,Joe Thornton,29,81,125,C,2005
18184,92,27,Joe Thornton,22,82,114,C,2006
18185,67,28,Joe Thornton,29,82,96,C,2007
18186,61,29,Joe Thornton,25,82,86,C,2008
18187,69,30,Joe Thornton,20,79,89,C,2009
18188,49,31,Joe Thornton,21,80,70,C,2010
18189,59,32,Joe Thornton,18,82,77,C,2011
18190,33,33,Joe Thornton,7,48,40,C,2012
18191,65,34,Joe Thornton,11,82,76,C,2013
18192,49,35,Joe Thornton,16,78,65,C,2014
18193,63,36,Joe Thornton,19,82,82,C,2015
18194,43,37,Joe Thornton,7,79,50,C,2016
18195,23,38,Joe Thornton,13,47,36,C,2017
18196,1,25,Joe Vitale,1,9,2,C,2010
18197,10,26,Joe Vitale,4,68,14,C,2011
18198,3,27,Joe Vitale,2,33,5,C,2012
18199,13,28,Joe Vitale,1,53,14,C,2013
18200,6,29,Joe Vitale,3,70,9,C,2014
18201,0,30,Joe Vitale,0,1,0,C,2015
18202,0,19,Joe Ward,0,4,0,C,1980
18203,14,24,Joe Watson,5,73,19,D,1967
18204,8,25,Joe Watson,2,60,10,D,1968
18205,11,26,Joe Watson,3,54,14,D,1969
18206,7,27,Joe Watson,3,57,10,D,1970
18207,7,28,Joe Watson,3,65,10,D,1971
18208,24,29,Joe Watson,2,63,26,D,1972
18209,17,30,Joe Watson,1,74,18,D,1973
18210,17,31,Joe Watson,6,80,23,D,1974
18211,22,32,Joe Watson,2,78,24,D,1975
18212,26,33,Joe Watson,4,77,30,D,1976
18213,9,34,Joe Watson,5,65,14,D,1977
18214,2,35,Joe Watson,0,16,2,D,1978
18215,0,25,Joe Whitney,0,1,0,RW,2013
18216,0,26,Joe Whitney,1,4,1,LW,2014
18217,21,25,Joe Zanussi,4,73,25,D,1972
18218,21,25,Joe Zanussi,4,73,25,D,1972
18219,22,26,Joe Zanussi,3,76,25,D,1973
18220,22,26,Joe Zanussi,3,76,25,D,1973
18221,2,27,Joe Zanussi,0,8,2,D,1974
18222,7,28,Joe Zanussi,1,60,8,D,1975
18223,4,29,Joe Zanussi,0,19,4,D,1976
18224,0,21,Joel Armia,0,1,0,RW,2014
18225,6,22,Joel Armia,4,43,10,RW,2015
18226,9,23,Joel Armia,10,57,19,RW,2016
18227,17,24,Joel Armia,12,79,29,RW,2017
18228,1,22,Joel Baillargeon,0,11,1,LW,1986
18229,1,23,Joel Baillargeon,0,4,1,LW,1987
18230,0,24,Joel Baillargeon,0,5,0,LW,1988
18231,0,21,Joel Bouchard,0,2,0,D,1994
18232,0,22,Joel Bouchard,0,4,0,D,1995
18233,5,23,Joel Bouchard,4,76,9,D,1996
18234,7,24,Joel Bouchard,5,44,12,D,1997
18235,11,25,Joel Bouchard,4,64,15,D,1998
18236,4,26,Joel Bouchard,1,54,5,D,1999
18237,2,27,Joel Bouchard,1,32,3,D,2000
18238,1,28,Joel Bouchard,0,1,1,D,2001
18239,8,29,Joel Bouchard,5,34,13,D,2002
18240,7,30,Joel Bouchard,1,28,8,D,2003
18241,8,32,Joel Bouchard,1,25,9,D,2005
18242,8,22,Joel Edmundson,1,67,9,D,2015
18243,12,23,Joel Edmundson,3,69,15,D,2016
18244,10,24,Joel Edmundson,7,69,17,D,2017
18245,4,20,Joel Eriksson Ek,3,15,7,LW,2016
18246,10,21,Joel Eriksson Ek,6,75,16,LW,2017
18247,6,24,Joel Hanley,0,10,6,D,2015
18248,0,25,Joel Hanley,0,7,0,D,2016
18249,0,26,Joel Hanley,0,5,0,D,2017
18250,0,23,Joel Kwiatkowski,1,4,1,D,2000
18251,0,24,Joel Kwiatkowski,0,11,0,D,2001
18252,5,25,Joel Kwiatkowski,0,54,5,D,2002
18253,6,26,Joel Kwiatkowski,6,80,12,D,2003
18254,8,28,Joel Kwiatkowski,4,73,12,D,2005
18255,5,29,Joel Kwiatkowski,5,42,10,D,2006
18256,5,30,Joel Kwiatkowski,0,18,5,D,2007
18257,3,24,Joel Lundqvist,3,36,6,C,2006
18258,11,25,Joel Lundqvist,3,55,14,C,2007
18259,5,26,Joel Lundqvist,1,43,6,C,2008
18260,8,23,Joel Otto,4,17,12,C,1984
18261,34,24,Joel Otto,25,79,59,C,1985
18262,31,25,Joel Otto,19,68,50,C,1986
18263,39,26,Joel Otto,13,62,52,C,1987
18264,30,27,Joel Otto,23,72,53,C,1988
18265,20,28,Joel Otto,13,75,33,C,1989
18266,20,29,Joel Otto,19,76,39,C,1990
18267,21,30,Joel Otto,13,78,34,C,1991
18268,33,31,Joel Otto,19,75,52,C,1992
18269,12,32,Joel Otto,11,81,23,C,1993
18270,13,33,Joel Otto,8,47,21,C,1994
18271,29,34,Joel Otto,12,67,41,C,1995
18272,19,35,Joel Otto,13,78,32,C,1996
18273,4,36,Joel Otto,3,68,7,C,1997
18274,1,22,Joel Perrault,1,5,2,C,2005
18275,2,23,Joel Perrault,1,26,3,C,2006
18276,10,24,Joel Perrault,7,49,17,C,2007
18277,1,25,Joel Perrault,2,7,3,C,2008
18278,0,26,Joel Perrault,1,2,1,C,2009
18279,0,27,Joel Perrault,0,7,0,C,2010
18280,0,23,Joel Prpic,0,1,0,C,1997
18281,3,25,Joel Prpic,0,14,3,C,1999
18282,0,26,Joel Prpic,0,3,0,C,2000
18283,9,20,Joel Quenneville,2,61,11,D,1978
18284,11,21,Joel Quenneville,6,67,17,D,1979
18285,24,22,Joel Quenneville,10,71,34,D,1980
18286,10,23,Joel Quenneville,5,64,15,D,1981
18287,12,24,Joel Quenneville,5,74,17,D,1982
18288,8,25,Joel Quenneville,5,80,13,D,1983
18289,16,26,Joel Quenneville,6,79,22,D,1984
18290,20,27,Joel Quenneville,5,71,25,D,1985
18291,7,28,Joel Quenneville,3,37,10,D,1986
18292,8,29,Joel Quenneville,1,77,9,D,1987
18293,7,30,Joel Quenneville,4,69,11,D,1988
18294,4,31,Joel Quenneville,1,44,5,D,1989
18295,0,32,Joel Quenneville,1,9,1,D,1990
18296,1,21,Joel Rechlicz,0,17,1,RW,2008
18297,0,22,Joel Rechlicz,0,6,0,RW,2009
18298,0,24,Joel Rechlicz,0,3,0,RW,2011
18299,1,21,Joel Savage,0,3,1,RW,1990
18300,1,23,Joel Vermin,0,6,1,RW,2015
18301,3,24,Joel Vermin,0,18,3,RW,2016
18302,1,26,Joel Ward,0,11,1,RW,2006
18303,18,28,Joel Ward,17,79,35,RW,2008
18304,21,29,Joel Ward,13,71,34,RW,2009
18305,19,30,Joel Ward,10,80,29,RW,2010
18306,12,31,Joel Ward,6,73,18,RW,2011
18307,12,32,Joel Ward,8,39,20,RW,2012
18308,25,33,Joel Ward,24,82,49,RW,2013
18309,15,34,Joel Ward,19,82,34,RW,2014
18310,22,35,Joel Ward,21,79,43,RW,2015
18311,19,36,Joel Ward,10,78,29,RW,2016
18312,7,37,Joel Ward,5,52,12,RW,2017
18313,5,25,Joey Crabb,4,29,9,RW,2008
18314,12,27,Joey Crabb,3,48,15,RW,2010
18315,15,28,Joey Crabb,11,67,26,RW,2011
18316,0,29,Joey Crabb,2,26,2,RW,2012
18317,1,30,Joey Crabb,0,9,1,RW,2013
18318,1,23,Joey Hishon,1,13,2,C,2014
18319,0,19,Joey Johnston,1,11,1,LW,1968
18320,17,22,Joey Johnston,15,77,32,LW,1971
18321,21,23,Joey Johnston,28,71,49,LW,1972
18322,40,24,Joey Johnston,27,78,67,LW,1973
18323,23,25,Joey Johnston,14,62,37,LW,1974
18324,5,26,Joey Johnston,0,32,5,LW,1975
18325,0,25,Joey Mormina,0,1,0,D,2007
18326,0,22,Joey Tenute,0,1,0,C,2005
18327,1,22,Joey Tetarenko,3,29,4,D,2000
18328,0,23,Joey Tetarenko,1,38,1,RW,2001
18329,0,24,Joey Tetarenko,0,4,0,RW,2002
18330,0,25,Joey Tetarenko,0,2,0,RW,2003
18331,21,20,Joffrey Lupul,13,75,34,RW,2003
18332,25,22,Joffrey Lupul,28,81,53,C,2005
18333,12,23,Joffrey Lupul,16,81,28,RW,2006
18334,26,24,Joffrey Lupul,20,56,46,RW,2007
18335,25,25,Joffrey Lupul,25,79,50,RW,2008
18336,4,26,Joffrey Lupul,10,23,14,C,2009
18337,17,27,Joffrey Lupul,14,54,31,C,2010
18338,42,28,Joffrey Lupul,25,66,67,C,2011
18339,7,29,Joffrey Lupul,11,16,18,C,2012
18340,22,30,Joffrey Lupul,22,69,44,LW,2013
18341,11,31,Joffrey Lupul,10,55,21,LW,2014
18342,3,32,Joffrey Lupul,11,46,14,LW,2015
18343,5,23,Johan Davidsson,3,64,8,C,1998
18344,4,24,Johan Davidsson,3,19,7,C,1999
18345,4,26,Johan Franzen,12,80,16,RW,2005
18346,20,27,Johan Franzen,10,69,30,RW,2006
18347,11,28,Johan Franzen,27,72,38,RW,2007
18348,25,29,Johan Franzen,34,71,59,RW,2008
18349,11,30,Johan Franzen,10,27,21,RW,2009
18350,27,31,Johan Franzen,28,76,55,RW,2010
18351,27,32,Johan Franzen,29,77,56,RW,2011
18352,17,33,Johan Franzen,14,41,31,RW,2012
18353,25,34,Johan Franzen,16,54,41,RW,2013
18354,15,35,Johan Franzen,7,33,22,RW,2014
18355,1,36,Johan Franzen,0,2,1,RW,2015
18356,22,22,Johan Garpenlov,18,71,40,LW,1990
18357,7,23,Johan Garpenlov,6,28,13,LW,1991
18358,44,24,Johan Garpenlov,22,79,66,LW,1992
18359,35,25,Johan Garpenlov,18,80,53,LW,1993
18360,10,26,Johan Garpenlov,4,40,14,RW,1994
18361,28,27,Johan Garpenlov,23,82,51,LW,1995
18362,25,28,Johan Garpenlov,11,53,36,LW,1996
18363,3,29,Johan Garpenlov,2,39,5,LW,1997
18364,9,30,Johan Garpenlov,8,64,17,LW,1998
18365,14,31,Johan Garpenlov,2,73,16,LW,1999
18366,2,24,Johan Harju,1,10,3,LW,2010
18367,0,20,Johan Larsson,0,1,0,LW,2012
18368,4,21,Johan Larsson,0,28,4,LW,2013
18369,10,22,Johan Larsson,6,39,16,LW,2014
18370,7,23,Johan Larsson,10,74,17,LW,2015
18371,5,24,Johan Larsson,6,36,11,C,2016
18372,13,25,Johan Larsson,4,80,17,C,2017
18373,3,26,Johan Lindbom,1,38,4,LW,1997
18374,0,20,Johan Motin,0,1,0,D,2009
18375,1,21,Johan Sundstrom,0,11,1,C,2013
18376,0,27,Johan Witehall,0,4,0,LW,1998
18377,1,28,Johan Witehall,1,9,2,LW,1999
18378,4,29,Johan Witehall,1,41,5,LW,2000
18379,1,20,John A Stewart,2,15,3,LW,1970
18380,8,21,John A Stewart,2,25,10,LW,1971
18381,17,22,John A Stewart,17,68,34,C,1972
18382,15,23,John A Stewart,18,74,33,LW,1973
18383,19,24,John A Stewart,19,76,38,LW,1974
18384,21,25,John A Stewart,12,79,33,LW,1975
18385,3,26,John A Stewart,3,16,6,LW,1976
18386,3,26,John A Stewart,3,15,6,LW,1976
18387,0,26,John A Stewart,0,1,0,LW,1976
18388,3,26,John A Stewart,3,16,6,LW,1976
18389,3,26,John A Stewart,3,15,6,LW,1976
18390,0,25,John Albert,1,9,1,C,2013
18391,2,20,John Anderson,1,17,3,RW,1977
18392,11,21,John Anderson,15,71,26,RW,1978
18393,28,22,John Anderson,25,74,53,RW,1979
18394,26,23,John Anderson,17,75,43,LW,1980
18395,26,24,John Anderson,31,69,57,LW,1981
18396,49,25,John Anderson,31,80,80,LW,1982
18397,31,26,John Anderson,37,73,68,LW,1983
18398,31,27,John Anderson,32,75,63,LW,1984
18399,45,28,John Anderson,29,79,74,LW,1985
18400,44,29,John Anderson,31,76,75,LW,1986
18401,32,30,John Anderson,17,63,49,LW,1987
18402,24,31,John Anderson,16,62,40,LW,1988
18403,1,22,John Arbour,0,4,1,D,1967
18404,2,23,John Arbour,0,17,2,D,1968
18405,6,25,John Arbour,1,66,7,D,1970
18406,0,26,John Arbour,0,17,0,D,1971
18407,27,27,John Arbour,6,76,33,D,1972
18408,43,28,John Arbour,6,77,49,D,1973
18409,43,28,John Arbour,6,77,49,D,1973
18410,43,29,John Arbour,12,70,55,D,1974
18411,43,29,John Arbour,12,70,55,D,1974
18412,17,30,John Arbour,2,42,19,D,1975
18413,17,30,John Arbour,2,42,19,D,1975
18414,34,31,John Arbour,4,70,38,D,1976
18415,15,31,John Arbour,1,37,16,D,1976
18416,19,31,John Arbour,3,33,22,D,1976
18417,34,31,John Arbour,4,70,38,D,1976
18418,15,31,John Arbour,1,37,16,D,1976
18419,19,31,John Arbour,3,33,22,D,1976
18420,7,20,John Baby,2,24,9,D,1977
18421,1,21,John Baby,0,2,1,D,1978
18422,10,22,John Barrett,3,56,13,D,1980
18423,12,23,John Barrett,1,69,13,D,1981
18424,10,24,John Barrett,4,79,14,D,1982
18425,8,25,John Barrett,2,78,10,D,1983
18426,19,26,John Barrett,6,71,25,D,1984
18427,15,27,John Barrett,2,79,17,D,1985
18428,2,28,John Barrett,2,55,4,D,1986
18429,1,29,John Barrett,0,1,1,D,1987
18430,10,22,John Bednarski,1,35,11,D,1974
18431,8,23,John Bednarski,1,59,9,D,1975
18432,0,24,John Bednarski,0,5,0,D,1976
18433,0,27,John Bednarski,0,1,0,D,1979
18434,6,23,John Bennett,4,34,10,LW,1972
18435,2,23,John Bethel,0,17,2,LW,1979
18436,3,23,John Blum,0,5,3,D,1982
18437,2,24,John Blum,1,16,3,D,1983
18438,13,25,John Blum,3,75,16,D,1984
18439,7,26,John Blum,1,61,8,D,1985
18440,8,27,John Blum,2,66,10,D,1986
18441,1,28,John Blum,0,19,1,D,1987
18442,0,29,John Blum,0,6,0,D,1988
18443,0,30,John Blum,0,2,0,D,1989
18444,10,25,John Brenneman,10,40,20,LW,1967
18445,2,26,John Brenneman,1,21,3,LW,1968
18446,39,32,John Bucyk,30,72,69,LW,1967
18447,42,33,John Bucyk,24,70,66,LW,1968
18448,38,34,John Bucyk,31,76,69,LW,1969
18449,65,35,John Bucyk,51,78,116,LW,1970
18450,51,36,John Bucyk,32,78,83,LW,1971
18451,53,37,John Bucyk,40,78,93,LW,1972
18452,44,38,John Bucyk,31,76,75,LW,1973
18453,52,39,John Bucyk,29,78,81,LW,1974
18454,47,40,John Bucyk,36,77,83,LW,1975
18455,23,41,John Bucyk,20,49,43,LW,1976
18456,13,42,John Bucyk,5,53,18,LW,1977
18457,3,23,John Byce,1,18,4,RW,1990
18458,0,24,John Byce,1,3,1,RW,1991
18459,7,21,John C Stewart,4,59,11,C,1974
18460,7,21,John C Stewart,4,59,11,C,1974
18461,9,22,John C Stewart,2,42,11,C,1975
18462,9,22,John C Stewart,2,42,11,C,1975
18463,24,23,John C Stewart,17,52,41,C,1976
18464,24,23,John C Stewart,17,52,41,C,1976
18465,26,24,John C Stewart,13,48,39,C,1977
18466,26,24,John C Stewart,13,48,39,C,1977
18467,26,25,John C Stewart,24,70,50,C,1978
18468,26,25,John C Stewart,24,70,50,C,1978
18469,0,26,John C Stewart,0,2,0,LW,1979
18470,5,20,John Carlson,1,22,6,D,2009
18471,30,21,John Carlson,7,82,37,D,2010
18472,23,22,John Carlson,9,82,32,D,2011
18473,16,23,John Carlson,6,48,22,D,2012
18474,27,24,John Carlson,10,82,37,D,2013
18475,43,25,John Carlson,12,82,55,D,2014
18476,31,26,John Carlson,8,56,39,D,2015
18477,28,27,John Carlson,9,72,37,D,2016
18478,53,28,John Carlson,15,82,68,D,2017
18479,0,22,John Carter,0,3,0,LW,1985
18480,1,23,John Carter,0,8,1,LW,1986
18481,1,24,John Carter,0,4,1,LW,1987
18482,10,25,John Carter,12,44,22,LW,1988
18483,22,26,John Carter,17,76,39,LW,1989
18484,7,27,John Carter,4,50,11,LW,1990
18485,0,28,John Carter,0,4,0,LW,1991
18486,9,29,John Carter,7,55,16,LW,1992
18487,25,21,John Chabot,18,56,43,C,1983
18488,51,22,John Chabot,9,77,60,C,1984
18489,31,23,John Chabot,14,77,45,C,1985
18490,22,24,John Chabot,14,72,36,C,1986
18491,44,25,John Chabot,13,78,57,C,1987
18492,10,26,John Chabot,2,52,12,C,1988
18493,40,27,John Chabot,9,69,49,C,1989
18494,5,28,John Chabot,5,27,10,C,1990
18495,0,25,John Craighead,0,5,0,RW,1996
18496,37,24,John Cullen,12,79,49,C,1988
18497,60,25,John Cullen,32,72,92,C,1989
18498,71,26,John Cullen,39,78,110,C,1990
18499,51,27,John Cullen,26,77,77,C,1991
18500,32,28,John Cullen,18,66,50,C,1992
18501,17,29,John Cullen,13,53,30,C,1993
18502,24,30,John Cullen,13,46,37,C,1994
18503,34,31,John Cullen,16,76,50,C,1995
18504,37,32,John Cullen,18,70,55,C,1996
18505,0,34,John Cullen,0,4,0,C,1998
18506,5,29,John Cunniff,3,33,8,LW,1972
18507,5,29,John Cunniff,3,33,8,LW,1972
18508,5,30,John Cunniff,7,30,12,LW,1973
18509,5,30,John Cunniff,7,30,12,LW,1973
18510,0,32,John Cunniff,0,2,0,LW,1975
18511,0,32,John Cunniff,0,2,0,LW,1975
18512,23,24,John Danby,14,77,37,C,1972
18513,2,25,John Danby,2,72,4,C,1973
18514,0,27,John Danby,0,1,0,C,1975
18515,0,27,John Danby,0,1,0,C,1975
18516,1,24,John Donnelly,1,15,2,D,1972
18517,1,24,John Donnelly,1,15,2,D,1972
18518,7,22,John Druce,8,48,15,RW,1988
18519,3,23,John Druce,8,45,11,RW,1989
18520,36,24,John Druce,22,80,58,RW,1990
18521,18,25,John Druce,19,67,37,RW,1991
18522,14,26,John Druce,6,50,20,RW,1992
18523,17,27,John Druce,14,55,31,RW,1993
18524,5,28,John Druce,15,43,20,RW,1994
18525,16,29,John Druce,13,77,29,RW,1995
18526,8,30,John Druce,7,43,15,RW,1996
18527,2,31,John Druce,1,23,3,RW,1997
18528,0,25,John Emmons,0,10,0,C,1999
18529,2,26,John Emmons,2,53,4,C,2000
18530,2,27,John Emmons,0,22,2,C,2001
18531,3,21,John English,1,3,4,D,1987
18532,1,21,John Erskine,0,33,1,D,2001
18533,0,22,John Erskine,2,16,2,D,2002
18534,1,23,John Erskine,0,32,1,D,2003
18535,0,25,John Erskine,1,60,1,D,2005
18536,6,26,John Erskine,1,29,7,D,2006
18537,7,27,John Erskine,2,51,9,D,2007
18538,4,28,John Erskine,0,52,4,D,2008
18539,5,29,John Erskine,1,50,6,D,2009
18540,7,30,John Erskine,4,73,11,D,2010
18541,2,31,John Erskine,0,28,2,D,2011
18542,3,32,John Erskine,3,30,6,D,2012
18543,3,33,John Erskine,1,37,4,D,2013
18544,18,29,John Ferguson,15,61,33,LW,1967
18545,23,30,John Ferguson,29,71,52,LW,1968
18546,13,31,John Ferguson,19,48,32,LW,1969
18547,14,32,John Ferguson,16,60,30,LW,1970
18548,5,25,John Fisher,0,40,5,C,1972
18549,5,25,John Fisher,0,40,5,C,1972
18550,15,21,John Flesch,8,57,23,LW,1974
18551,2,22,John Flesch,3,33,5,LW,1975
18552,5,24,John Flesch,7,29,12,LW,1977
18553,1,26,John Flesch,0,5,1,LW,1979
18554,35,22,John French,24,74,59,C,1972
18555,35,22,John French,24,74,59,C,1972
18556,48,23,John French,24,77,72,LW,1973
18557,48,23,John French,24,77,72,LW,1973
18558,41,24,John French,12,75,53,LW,1974
18559,41,24,John French,12,75,53,LW,1974
18560,39,25,John French,25,76,64,LW,1975
18561,39,25,John French,25,76,64,LW,1975
18562,21,26,John French,14,44,35,LW,1976
18563,21,26,John French,14,44,35,LW,1976
18564,8,27,John French,9,74,17,LW,1977
18565,8,27,John French,9,74,17,LW,1977
18566,0,20,John Gaudreau,1,1,1,LW,2013
18567,48,22,John Gaudreau,30,79,78,LW,2015
18568,1,19,John Gibson,0,9,1,LW,1978
18569,1,19,John Gibson,0,9,1,LW,1978
18570,0,21,John Gibson,0,4,0,D,1980
18571,2,22,John Gibson,0,33,2,D,1981
18572,0,24,John Gibson,0,11,0,D,1983
18573,3,24,John Gilmour,2,28,5,D,2017
18574,0,22,John Gould,1,2,1,LW,1971
18575,1,23,John Gould,0,8,1,LW,1972
18576,12,24,John Gould,13,75,25,RW,1973
18577,31,25,John Gould,34,78,65,RW,1974
18578,27,26,John Gould,32,70,59,RW,1975
18579,23,27,John Gould,15,79,38,RW,1976
18580,28,28,John Gould,19,79,47,LW,1977
18581,7,29,John Gould,8,61,15,LW,1978
18582,9,30,John Gould,9,52,18,LW,1979
18583,3,31,John Gravel,1,8,4,D,1972
18584,3,31,John Gravel,1,8,4,D,1972
18585,33,25,John Gray,35,75,68,RW,1974
18586,33,25,John Gray,35,75,68,RW,1974
18587,45,26,John Gray,35,79,80,RW,1975
18588,45,26,John Gray,35,79,80,RW,1975
18589,30,27,John Gray,31,75,61,RW,1976
18590,20,27,John Gray,21,47,41,RW,1976
18591,10,27,John Gray,10,28,20,RW,1976
18592,30,27,John Gray,31,75,61,RW,1976
18593,20,27,John Gray,21,47,41,RW,1976
18594,10,27,John Gray,10,28,20,RW,1976
18595,23,28,John Gray,35,77,58,RW,1977
18596,23,28,John Gray,35,77,58,RW,1977
18597,15,29,John Gray,10,57,25,RW,1978
18598,15,29,John Gray,10,57,25,RW,1978
18599,7,24,John Grisdale,1,49,8,D,1972
18600,12,26,John Grisdale,1,60,13,D,1974
18601,6,27,John Grisdale,2,38,8,D,1975
18602,2,28,John Grisdale,0,20,2,D,1976
18603,9,29,John Grisdale,0,42,9,D,1977
18604,3,30,John Grisdale,0,41,3,D,1978
18605,1,23,John Gruden,0,7,1,D,1993
18606,6,24,John Gruden,0,38,6,D,1994
18607,0,25,John Gruden,0,14,0,D,1995
18608,1,28,John Gruden,0,13,1,D,1998
18609,0,29,John Gruden,0,9,0,D,1999
18610,0,33,John Gruden,1,11,1,D,2003
18611,0,32,John Hanna,0,15,0,D,1967
18612,20,37,John Hanna,6,66,26,D,1972
18613,20,37,John Hanna,6,66,26,D,1972
18614,3,21,John Hayden,1,12,4,LW,2016
18615,9,22,John Hayden,4,47,13,RW,2017
18616,0,20,John Hilworth,0,5,0,D,1977
18617,1,21,John Hilworth,1,37,2,D,1978
18618,0,22,John Hilworth,0,15,0,D,1979
18619,25,20,John Hughes,4,72,29,D,1974
18620,25,20,John Hughes,4,72,29,D,1974
18621,34,21,John Hughes,3,79,37,D,1975
18622,34,21,John Hughes,3,79,37,D,1975
18623,27,22,John Hughes,3,79,30,D,1976
18624,27,22,John Hughes,3,79,30,D,1976
18625,25,23,John Hughes,3,79,28,D,1977
18626,25,23,John Hughes,3,79,28,D,1977
18627,19,24,John Hughes,5,63,24,D,1978
18628,19,24,John Hughes,5,63,24,D,1978
18629,11,25,John Hughes,2,52,13,D,1979
18630,3,26,John Hughes,0,18,3,D,1980
18631,0,22,John Jakopin,0,2,0,D,1997
18632,0,23,John Jakopin,0,3,0,D,1998
18633,0,24,John Jakopin,0,17,0,D,1999
18634,2,25,John Jakopin,1,60,3,D,2000
18635,4,26,John Jakopin,0,19,4,D,2001
18636,0,27,John Jakopin,0,12,0,D,2002
18637,0,22,John Johannson,0,5,0,C,1983
18638,29,22,John Klingberg,11,65,40,D,2014
18639,48,23,John Klingberg,10,76,58,D,2015
18640,36,24,John Klingberg,13,80,49,D,2016
18641,59,25,John Klingberg,8,82,67,D,2017
18642,1,20,John Kordic,0,5,1,D,1985
18643,3,21,John Kordic,5,44,8,RW,1986
18644,6,22,John Kordic,2,60,8,RW,1987
18645,2,23,John Kordic,1,52,3,RW,1988
18646,4,24,John Kordic,9,55,13,RW,1989
18647,0,25,John Kordic,0,10,0,RW,1990
18648,2,26,John Kordic,0,18,2,RW,1991
18649,0,23,John LeBlanc,1,2,1,LW,1986
18650,10,24,John LeBlanc,12,41,22,LW,1987
18651,0,25,John LeBlanc,1,2,1,LW,1988
18652,1,28,John LeBlanc,6,16,7,LW,1991
18653,0,29,John LeBlanc,0,3,0,LW,1992
18654,2,30,John LeBlanc,6,17,8,RW,1993
18655,0,31,John LeBlanc,0,2,0,RW,1994
18656,5,21,John LeClair,2,10,7,C,1990
18657,11,22,John LeClair,8,59,19,C,1991
18658,25,23,John LeClair,19,72,44,LW,1992
18659,24,24,John LeClair,19,74,43,LW,1993
18660,28,25,John LeClair,26,46,54,LW,1994
18661,46,26,John LeClair,51,82,97,LW,1995
18662,47,27,John LeClair,50,82,97,LW,1996
18663,36,28,John LeClair,51,82,87,LW,1997
18664,47,29,John LeClair,43,76,90,LW,1998
18665,37,30,John LeClair,40,82,77,LW,1999
18666,5,31,John LeClair,7,16,12,LW,2000
18667,26,32,John LeClair,25,82,51,LW,2001
18668,10,33,John LeClair,18,35,28,LW,2002
18669,32,34,John LeClair,23,75,55,LW,2003
18670,29,36,John LeClair,22,73,51,LW,2005
18671,5,37,John LeClair,2,21,7,LW,2006
18672,6,21,John Lilley,1,13,7,RW,1993
18673,2,22,John Lilley,2,9,4,C,1994
18674,0,23,John Lilley,0,1,0,C,1995
18675,0,19,John MacLean,1,23,1,RW,1983
18676,20,20,John MacLean,13,61,33,RW,1984
18677,36,21,John MacLean,21,74,57,RW,1985
18678,36,22,John MacLean,31,80,67,RW,1986
18679,16,23,John MacLean,23,76,39,RW,1987
18680,45,24,John MacLean,42,74,87,RW,1988
18681,38,25,John MacLean,41,80,79,RW,1989
18682,33,26,John MacLean,45,78,78,RW,1990
18683,24,28,John MacLean,24,80,48,RW,1992
18684,33,29,John MacLean,37,80,70,LW,1993
18685,12,30,John MacLean,17,46,29,RW,1994
18686,28,31,John MacLean,20,76,48,RW,1995
18687,25,32,John MacLean,29,80,54,RW,1996
18688,27,33,John MacLean,16,77,43,RW,1997
18689,27,34,John MacLean,28,82,55,RW,1998
18690,24,35,John MacLean,18,77,42,RW,1999
18691,2,36,John MacLean,4,30,6,RW,2000
18692,3,37,John MacLean,3,20,6,RW,2001
18693,1,25,John Madden,0,4,1,LW,1998
18694,9,26,John Madden,16,74,25,LW,1999
18695,15,27,John Madden,23,80,38,LW,2000
18696,8,28,John Madden,15,82,23,C,2001
18697,22,29,John Madden,19,80,41,C,2002
18698,23,30,John Madden,12,80,35,C,2003
18699,20,32,John Madden,16,82,36,C,2005
18700,20,33,John Madden,12,74,32,C,2006
18701,23,34,John Madden,20,80,43,C,2007
18702,16,35,John Madden,7,76,23,C,2008
18703,13,36,John Madden,10,79,23,C,2009
18704,13,37,John Madden,12,76,25,C,2010
18705,0,38,John Madden,3,31,3,C,2011
18706,7,23,John Markell,10,38,17,LW,1979
18707,3,24,John Markell,1,14,4,LW,1980
18708,0,27,John Markell,0,2,0,LW,1983
18709,0,28,John Markell,0,1,0,LW,1984
18710,10,24,John Marks,3,55,13,D,1972
18711,18,25,John Marks,13,76,31,LW,1973
18712,30,26,John Marks,17,80,47,LW,1974
18713,23,27,John Marks,21,80,44,LW,1975
18714,15,28,John Marks,7,80,22,D,1976
18715,22,29,John Marks,15,80,37,LW,1977
18716,24,30,John Marks,21,80,45,LW,1978
18717,15,31,John Marks,6,74,21,LW,1979
18718,6,32,John Marks,8,39,14,LW,1980
18719,0,33,John Marks,1,13,1,LW,1981
18720,0,23,John Mazur,0,1,0,LW,1977
18721,0,23,John Mazur,0,1,0,LW,1977
18722,0,22,John McCahill,0,1,0,D,1977
18723,0,23,John McCarthy,0,4,0,LW,2009
18724,2,24,John McCarthy,2,37,4,LW,2010
18725,0,25,John McCarthy,0,10,0,LW,2011
18726,1,27,John McCarthy,1,36,2,C,2013
18727,0,29,John McCarthy,0,1,0,LW,2015
18728,0,23,John McFarland,0,3,0,LW,2015
18729,12,20,John McIntyre,5,59,17,C,1989
18730,8,21,John McIntyre,8,69,16,C,1990
18731,19,22,John McIntyre,5,73,24,C,1991
18732,5,23,John McIntyre,3,60,8,C,1992
18733,6,24,John McIntyre,3,62,9,C,1993
18734,4,25,John McIntyre,0,28,4,C,1994
18735,38,30,John McKenzie,28,74,66,RW,1967
18736,27,31,John McKenzie,29,60,56,RW,1968
18737,41,32,John McKenzie,29,72,70,RW,1969
18738,46,33,John McKenzie,31,65,77,RW,1970
18739,47,34,John McKenzie,22,77,69,RW,1971
18740,50,35,John McKenzie,28,60,78,RW,1972
18741,50,35,John McKenzie,28,60,78,RW,1972
18742,38,36,John McKenzie,14,45,52,RW,1973
18743,38,36,John McKenzie,14,45,52,RW,1973
18744,37,37,John McKenzie,23,74,60,RW,1974
18745,37,37,John McKenzie,23,74,60,RW,1974
18746,36,38,John McKenzie,24,69,60,RW,1975
18747,36,38,John McKenzie,24,69,60,RW,1975
18748,32,39,John McKenzie,28,74,60,RW,1976
18749,13,39,John McKenzie,17,40,30,RW,1976
18750,19,39,John McKenzie,11,34,30,RW,1976
18751,13,39,John McKenzie,17,40,30,RW,1976
18752,19,39,John McKenzie,11,34,30,RW,1976
18753,29,40,John McKenzie,27,79,56,RW,1977
18754,28,41,John McKenzie,19,76,47,RW,1978
18755,8,23,John Migneault,10,55,18,D,1972
18756,8,23,John Migneault,10,55,18,D,1972
18757,26,24,John Migneault,21,74,47,LW,1973
18758,26,24,John Migneault,21,74,47,LW,1973
18759,15,25,John Migneault,10,61,25,LW,1974
18760,13,25,John Migneault,6,47,19,LW,1974
18761,2,25,John Migneault,4,14,6,LW,1974
18762,2,25,John Migneault,4,14,6,LW,1974
18763,12,26,John Migneault,8,68,20,LW,1975
18764,12,26,John Migneault,8,68,20,LW,1975
18765,3,22,John Miner,2,14,5,D,1987
18766,17,27,John Miszuk,5,74,22,D,1967
18767,13,28,John Miszuk,1,66,14,D,1968
18768,6,29,John Miszuk,0,50,6,D,1969
18769,19,34,John Miszuk,2,66,21,D,1974
18770,19,34,John Miszuk,2,66,21,D,1974
18771,21,35,John Miszuk,2,69,23,D,1975
18772,21,35,John Miszuk,2,69,23,D,1975
18773,26,36,John Miszuk,2,79,28,D,1976
18774,26,36,John Miszuk,2,79,28,D,1976
18775,17,24,John Mitchell,12,76,29,C,2008
18776,17,25,John Mitchell,6,60,23,C,2009
18777,1,26,John Mitchell,2,23,3,C,2010
18778,11,27,John Mitchell,5,63,16,C,2011
18779,10,28,John Mitchell,10,47,20,C,2012
18780,21,29,John Mitchell,11,75,32,C,2013
18781,15,30,John Mitchell,11,68,26,C,2014
18782,11,31,John Mitchell,10,71,21,C,2015
18783,4,32,John Mitchell,3,65,7,C,2016
18784,1,25,John Mokosak,0,8,1,D,1988
18785,1,26,John Mokosak,0,33,1,D,1989
18786,0,20,John Moore,0,2,0,D,2010
18787,5,21,John Moore,2,67,7,D,2011
18788,6,22,John Moore,1,30,7,D,2012
18789,11,23,John Moore,4,74,15,D,2013
18790,9,24,John Moore,2,57,11,D,2014
18791,15,25,John Moore,4,73,19,D,2015
18792,10,26,John Moore,12,63,22,D,2016
18793,11,27,John Moore,7,81,18,D,2017
18794,5,22,John Namestnikov,0,17,5,D,1993
18795,3,23,John Namestnikov,0,16,3,D,1994
18796,0,25,John Namestnikov,0,2,0,D,1996
18797,1,26,John Namestnikov,0,6,1,D,1997
18798,0,28,John Namestnikov,0,2,0,D,1999
18799,1,19,John Negrin,0,3,1,D,2008
18800,0,21,John Newberry,0,3,0,C,1983
18801,4,22,John Newberry,0,16,4,C,1984
18802,0,23,John Newberry,0,3,0,C,1985
18803,24,20,John Ogrodnick,8,41,32,LW,1979
18804,35,21,John Ogrodnick,35,80,70,LW,1980
18805,26,22,John Ogrodnick,28,80,54,LW,1981
18806,44,23,John Ogrodnick,41,80,85,LW,1982
18807,36,24,John Ogrodnick,42,64,78,LW,1983
18808,50,25,John Ogrodnick,55,79,105,LW,1984
18809,32,26,John Ogrodnick,38,76,70,LW,1985
18810,44,27,John Ogrodnick,23,71,67,LW,1986
18811,32,28,John Ogrodnick,22,64,54,LW,1987
18812,29,29,John Ogrodnick,13,60,42,LW,1988
18813,31,30,John Ogrodnick,43,80,74,LW,1989
18814,23,31,John Ogrodnick,31,79,54,LW,1990
18815,13,32,John Ogrodnick,17,55,30,LW,1991
18816,6,33,John Ogrodnick,6,19,12,LW,1992
18817,1,21,John Paddock,1,8,2,RW,1975
18818,0,22,John Paddock,0,5,0,RW,1976
18819,7,25,John Paddock,3,32,10,LW,1979
18820,5,26,John Paddock,2,32,7,RW,1980
18821,1,28,John Paddock,2,10,3,RW,1982
18822,5,24,John Paul Evans,6,44,11,C,1978
18823,0,26,John Paul Evans,0,1,0,C,1980
18824,20,28,John Paul Evans,8,58,28,C,1982
18825,5,20,John Paul Kelly,2,40,7,LW,1979
18826,6,21,John Paul Kelly,3,19,9,LW,1980
18827,11,22,John Paul Kelly,12,70,23,LW,1981
18828,15,23,John Paul Kelly,16,65,31,LW,1982
18829,14,24,John Paul Kelly,7,72,21,LW,1983
18830,10,25,John Paul Kelly,8,73,18,C,1984
18831,9,26,John Paul Kelly,6,61,15,LW,1985
18832,0,21,John Persson,1,10,1,LW,2013
18833,0,24,John Pohl,0,1,0,C,2003
18834,1,26,John Pohl,3,7,4,RW,2005
18835,16,27,John Pohl,13,74,29,C,2006
18836,4,28,John Pohl,1,33,5,C,2007
18837,0,22,John Purves,1,7,1,RW,1990
18838,3,20,John Quenneville,1,12,4,C,2016
18839,0,21,John Quenneville,0,2,0,C,2017
18840,0,23,John Ramage,0,1,0,D,2014
18841,0,24,John Ramage,0,1,0,D,2015
18842,18,27,John Robert Kelly,16,67,34,LW,1973
18843,24,28,John Robert Kelly,27,69,51,LW,1974
18844,30,29,John Robert Kelly,25,77,55,LW,1975
18845,21,30,John Robert Kelly,10,74,31,LW,1976
18846,11,31,John Robert Kelly,7,75,18,LW,1977
18847,5,32,John Robert Kelly,2,63,7,LW,1978
18848,4,20,John Rogers,2,10,6,RW,1973
18849,0,21,John Rogers,0,4,0,RW,1974
18850,8,22,John Rogers,9,44,17,RW,1975
18851,8,22,John Rogers,9,44,17,RW,1975
18852,5,23,John Schella,0,38,5,D,1970
18853,13,24,John Schella,2,77,15,D,1971
18854,24,25,John Schella,2,77,26,D,1972
18855,24,25,John Schella,2,77,26,D,1972
18856,19,26,John Schella,12,73,31,D,1973
18857,19,26,John Schella,12,73,31,D,1973
18858,42,27,John Schella,10,78,52,D,1974
18859,42,27,John Schella,10,78,52,D,1974
18860,32,28,John Schella,6,74,38,D,1975
18861,32,28,John Schella,6,74,38,D,1975
18862,6,29,John Schella,0,20,6,D,1976
18863,6,29,John Schella,0,20,6,D,1976
18864,20,30,John Schella,9,63,29,D,1977
18865,20,30,John Schella,9,63,29,D,1977
18866,1,26,John Scott,0,20,1,D,2008
18867,1,27,John Scott,1,51,2,D,2009
18868,1,28,John Scott,0,40,1,D,2010
18869,1,29,John Scott,0,35,1,D,2011
18870,0,30,John Scott,0,34,0,D,2012
18871,0,31,John Scott,1,56,1,LW,2013
18872,1,32,John Scott,3,38,4,LW,2014
18873,1,33,John Scott,0,12,1,LW,2015
18874,11,20,John Sheridan,17,58,28,C,1974
18875,11,20,John Sheridan,17,58,28,C,1974
18876,2,21,John Sheridan,1,11,3,C,1975
18877,2,21,John Sheridan,1,11,3,C,1975
18878,0,28,John Shmyr,0,7,0,D,1972
18879,3,29,John Shmyr,1,43,4,D,1973
18880,5,30,John Shmyr,1,39,6,D,1974
18881,5,30,John Shmyr,1,39,6,D,1974
18882,9,21,John Slaney,7,47,16,D,1993
18883,3,22,John Slaney,0,16,3,D,1994
18884,14,23,John Slaney,6,38,20,D,1995
18885,11,24,John Slaney,3,32,14,D,1996
18886,14,25,John Slaney,3,55,17,D,1997
18887,12,26,John Slaney,2,46,14,D,1998
18888,4,27,John Slaney,1,29,5,D,1999
18889,0,29,John Slaney,0,1,0,D,2001
18890,2,31,John Slaney,0,4,2,D,2003
18891,4,21,John Smrke,2,18,6,LW,1977
18892,8,22,John Smrke,6,55,14,LW,1978
18893,5,23,John Smrke,3,30,8,LW,1979
18894,2,20,John Stevens,0,6,2,D,1986
18895,0,21,John Stevens,0,3,0,D,1987
18896,1,24,John Stevens,0,14,1,D,1990
18897,4,25,John Stevens,0,21,4,D,1991
18898,3,27,John Stevens,0,9,3,D,1993
18899,2,24,John Taft,0,15,2,D,1978
18900,30,19,John Tavares,24,82,54,C,2009
18901,38,20,John Tavares,29,79,67,C,2010
18902,50,21,John Tavares,31,82,81,C,2011
18903,19,22,John Tavares,28,48,47,C,2012
18904,42,23,John Tavares,24,59,66,C,2013
18905,48,24,John Tavares,38,82,86,C,2014
18906,37,25,John Tavares,33,78,70,C,2015
18907,38,26,John Tavares,28,77,66,C,2016
18908,47,27,John Tavares,37,82,84,C,2017
18909,14,18,John Tonelli,17,79,31,C,1975
18910,14,18,John Tonelli,17,79,31,C,1975
18911,31,19,John Tonelli,24,80,55,C,1976
18912,31,19,John Tonelli,24,80,55,C,1976
18913,41,20,John Tonelli,23,65,64,C,1977
18914,41,20,John Tonelli,23,65,64,C,1977
18915,39,21,John Tonelli,17,73,56,LW,1978
18916,30,22,John Tonelli,14,77,44,LW,1979
18917,32,23,John Tonelli,20,70,52,LW,1980
18918,58,24,John Tonelli,35,80,93,LW,1981
18919,40,25,John Tonelli,31,76,71,LW,1982
18920,40,26,John Tonelli,27,73,67,LW,1983
18921,58,27,John Tonelli,42,80,100,LW,1984
18922,45,28,John Tonelli,23,74,68,LW,1985
18923,31,29,John Tonelli,20,78,51,LW,1986
18924,41,30,John Tonelli,17,74,58,LW,1987
18925,33,31,John Tonelli,31,77,64,LW,1988
18926,37,32,John Tonelli,31,73,68,LW,1989
18927,16,33,John Tonelli,14,71,30,LW,1990
18928,11,34,John Tonelli,3,52,14,LW,1991
18929,2,25,John Tripp,1,9,3,RW,2002
18930,5,26,John Tripp,1,34,6,RW,2003
18931,4,19,John Tucker,12,21,16,C,1983
18932,27,20,John Tucker,22,64,49,C,1984
18933,34,21,John Tucker,31,75,65,C,1985
18934,34,22,John Tucker,17,54,51,C,1986
18935,19,23,John Tucker,19,45,38,C,1987
18936,31,24,John Tucker,13,60,44,C,1988
18937,21,25,John Tucker,10,46,31,RW,1989
18938,7,26,John Tucker,4,38,11,C,1990
18939,39,28,John Tucker,17,78,56,LW,1992
18940,23,29,John Tucker,17,66,40,LW,1993
18941,13,30,John Tucker,12,46,25,RW,1994
18942,7,31,John Tucker,3,63,10,RW,1995
18943,4,21,John Van Boxmeer,1,20,5,D,1973
18944,2,22,John Van Boxmeer,0,9,2,D,1974
18945,11,23,John Van Boxmeer,6,46,17,D,1975
18946,12,24,John Van Boxmeer,2,45,14,D,1976
18947,42,25,John Van Boxmeer,12,80,54,D,1977
18948,34,26,John Van Boxmeer,9,76,43,D,1978
18949,40,27,John Van Boxmeer,11,80,51,D,1979
18950,51,28,John Van Boxmeer,18,80,69,D,1980
18951,54,29,John Van Boxmeer,14,69,68,D,1981
18952,21,30,John Van Boxmeer,6,65,27,D,1982
18953,3,31,John Van Boxmeer,5,18,8,D,1983
18954,0,26,John Van Horlick,0,2,0,D,1975
18955,0,26,John Van Horlick,0,2,0,D,1975
18956,0,20,John Wensink,0,3,0,LW,1973
18957,6,23,John Wensink,4,23,10,LW,1976
18958,20,24,John Wensink,16,80,36,LW,1977
18959,18,25,John Wensink,28,76,46,LW,1978
18960,11,26,John Wensink,9,69,20,LW,1979
18961,3,27,John Wensink,6,53,9,LW,1980
18962,3,28,John Wensink,5,57,8,LW,1981
18963,7,29,John Wensink,2,42,9,LW,1982
18964,27,24,John Wright,10,71,37,C,1972
18965,9,25,John Wright,6,52,15,C,1973
18966,0,26,John Wright,0,4,0,C,1974
18967,2,24,John Zeiler,1,23,3,RW,2006
18968,1,25,John Zeiler,0,36,1,RW,2007
18969,1,26,John Zeiler,0,27,1,RW,2008
18970,0,28,John Zeiler,0,4,0,RW,2010
18971,24,23,John-Michael Liles,10,79,34,D,2003
18972,35,25,John-Michael Liles,14,82,49,D,2005
18973,30,26,John-Michael Liles,14,71,44,D,2006
18974,26,27,John-Michael Liles,6,81,32,D,2007
18975,27,28,John-Michael Liles,12,75,39,D,2008
18976,25,29,John-Michael Liles,6,59,31,D,2009
18977,40,30,John-Michael Liles,6,76,46,D,2010
18978,20,31,John-Michael Liles,7,66,27,D,2011
18979,9,32,John-Michael Liles,2,32,11,D,2012
18980,7,33,John-Michael Liles,2,41,9,D,2013
18981,20,34,John-Michael Liles,2,57,22,D,2014
18982,15,35,John-Michael Liles,6,81,21,D,2015
18983,5,36,John-Michael Liles,0,36,5,D,2016
18984,0,21,Johnathan Aitken,0,3,0,D,1999
18985,1,25,Johnathan Aitken,0,41,1,D,2003
18986,0,24,Johnny Boychuk,0,4,0,D,2007
18987,0,25,Johnny Boychuk,0,1,0,D,2008
18988,10,26,Johnny Boychuk,5,51,15,D,2009
18989,13,27,Johnny Boychuk,3,69,16,D,2010
18990,10,28,Johnny Boychuk,5,77,15,D,2011
18991,5,29,Johnny Boychuk,1,44,6,D,2012
18992,18,30,Johnny Boychuk,5,75,23,D,2013
18993,26,31,Johnny Boychuk,9,72,35,D,2014
18994,16,32,Johnny Boychuk,9,70,25,D,2015
18995,17,33,Johnny Boychuk,6,66,23,D,2016
18996,12,34,Johnny Boychuk,6,58,18,D,2017
18997,40,21,Johnny Gaudreau,24,80,64,LW,2014
18998,43,23,Johnny Gaudreau,18,72,61,LW,2016
18999,60,24,Johnny Gaudreau,24,80,84,LW,2017
19000,9,25,Johnny Oduya,2,76,11,D,2006
19001,20,26,Johnny Oduya,6,75,26,D,2007
19002,22,27,Johnny Oduya,7,82,29,D,2008
19003,10,28,Johnny Oduya,3,67,13,D,2009
19004,15,29,Johnny Oduya,2,82,17,D,2010
19005,15,30,Johnny Oduya,3,81,18,D,2011
19006,9,31,Johnny Oduya,3,48,12,D,2012
19007,13,32,Johnny Oduya,3,77,16,D,2013
19008,8,33,Johnny Oduya,2,76,10,D,2014
19009,17,34,Johnny Oduya,4,82,21,D,2015
19010,1,35,Johnny Oduya,1,15,2,D,2016
19011,0,36,Johnny Oduya,0,1,0,D,2017
19012,0,22,Jon Audy-Marchessault,0,2,0,C,2012
19013,0,24,Jon DiSalvatore,0,5,0,RW,2005
19014,0,30,Jon DiSalvatore,0,1,0,LW,2011
19015,0,24,Jon Fontas,0,1,0,C,1979
19016,0,25,Jon Fontas,0,1,0,C,1980
19017,2,21,Jon Kalinski,1,12,3,C,2008
19018,2,22,Jon Kalinski,0,10,2,C,2009
19019,1,22,Jon Klemm,0,4,1,D,1991
19020,0,24,Jon Klemm,0,7,0,D,1993
19021,0,25,Jon Klemm,1,4,1,D,1994
19022,12,26,Jon Klemm,3,56,15,D,1995
19023,15,27,Jon Klemm,9,80,24,D,1996
19024,8,28,Jon Klemm,6,67,14,D,1997
19025,2,29,Jon Klemm,1,39,3,D,1998
19026,7,30,Jon Klemm,5,73,12,D,1999
19027,11,31,Jon Klemm,4,78,15,D,2000
19028,16,32,Jon Klemm,4,82,20,D,2001
19029,14,33,Jon Klemm,2,70,16,D,2002
19030,5,34,Jon Klemm,2,77,7,D,2003
19031,7,36,Jon Klemm,4,76,11,D,2005
19032,2,37,Jon Klemm,1,38,3,D,2006
19033,0,38,Jon Klemm,0,22,0,D,2007
19034,11,25,Jon Marchessault,7,45,18,C,2015
19035,21,26,Jon Marchessault,30,75,51,C,2016
19036,48,27,Jon Marchessault,27,77,75,C,2017
19037,0,24,Jon Matsumoto,2,13,2,C,2010
19038,0,25,Jon Matsumoto,0,1,0,C,2011
19039,12,22,Jon Merrill,2,66,14,D,2014
19040,2,22,Jon Morris,0,4,2,C,1988
19041,7,23,Jon Morris,6,20,13,C,1989
19042,19,24,Jon Morris,9,53,28,C,1990
19043,2,25,Jon Morris,1,7,3,C,1991
19044,3,26,Jon Morris,0,15,3,C,1992
19045,0,27,Jon Morris,0,4,0,C,1993
19046,0,26,Jon Rheault,0,5,0,RW,2012
19047,8,25,Jon Rohloff,3,34,11,D,1994
19048,12,26,Jon Rohloff,1,79,13,D,1995
19049,5,27,Jon Rohloff,3,37,8,D,1996
19050,0,21,Jon Sim,1,7,1,C,1998
19051,3,22,Jon Sim,5,25,8,C,1999
19052,3,23,Jon Sim,0,15,3,LW,2000
19053,0,24,Jon Sim,3,26,3,RW,2001
19054,2,25,Jon Sim,1,22,3,RW,2002
19055,10,26,Jon Sim,8,63,18,LW,2003
19056,15,28,Jon Sim,17,72,32,RW,2005
19057,12,29,Jon Sim,17,77,29,LW,2006
19058,1,30,Jon Sim,0,2,1,LW,2007
19059,6,31,Jon Sim,9,49,15,LW,2008
19060,9,32,Jon Sim,13,77,22,LW,2009
19061,3,33,Jon Sim,1,34,4,LW,2010
19062,0,20,Jonas Andersson,0,5,0,RW,2001
19063,0,29,Jonas Andersson,0,4,0,RW,2010
19064,5,27,Jonas Bergqvist,2,22,7,RW,1989
19065,9,19,Jonas Brodin,2,45,11,D,2012
19066,11,20,Jonas Brodin,8,79,19,D,2013
19067,14,21,Jonas Brodin,3,71,17,D,2014
19068,5,22,Jonas Brodin,2,68,7,D,2015
19069,22,23,Jonas Brodin,3,68,25,D,2016
19070,15,24,Jonas Brodin,6,73,21,D,2017
19071,6,28,Jonas Frogren,1,41,7,D,2008
19072,16,24,Jonas Hoglund,19,68,35,LW,1996
19073,13,25,Jonas Hoglund,12,78,25,LW,1997
19074,10,26,Jonas Hoglund,8,74,18,RW,1998
19075,27,27,Jonas Hoglund,29,82,56,LW,1999
19076,26,28,Jonas Hoglund,23,82,49,LW,2000
19077,34,29,Jonas Hoglund,13,82,47,LW,2001
19078,19,30,Jonas Hoglund,13,79,32,LW,2002
19079,6,23,Jonas Holos,0,39,6,D,2010
19080,0,21,Jonas Johansson,0,1,0,RW,2005
19081,0,21,Jonas Junland,0,1,0,D,2008
19082,2,22,Jonas Junland,0,3,2,D,2009
19083,2,24,Jonas Nordqvist,0,3,2,C,2006
19084,4,27,Jonas Ronnqvist,0,38,4,RW,2000
19085,7,22,Jonathan Cheechoo,9,66,16,RW,2002
19086,19,23,Jonathan Cheechoo,28,81,47,RW,2003
19087,37,25,Jonathan Cheechoo,56,82,93,RW,2005
19088,32,26,Jonathan Cheechoo,37,76,69,RW,2006
19089,14,27,Jonathan Cheechoo,23,69,37,RW,2007
19090,17,28,Jonathan Cheechoo,12,66,29,RW,2008
19091,9,29,Jonathan Cheechoo,5,61,14,RW,2009
19092,0,21,Jonathan Delisle,0,1,0,RW,1998
19093,28,19,Jonathan Drouin,4,70,32,LW,2014
19094,6,20,Jonathan Drouin,4,21,10,LW,2015
19095,32,21,Jonathan Drouin,21,73,53,LW,2016
19096,33,22,Jonathan Drouin,13,77,46,LW,2017
19097,0,23,Jonathan Ericsson,1,8,1,D,2007
19098,3,24,Jonathan Ericsson,1,19,4,D,2008
19099,9,25,Jonathan Ericsson,4,62,13,D,2009
19100,12,26,Jonathan Ericsson,3,74,15,D,2010
19101,10,27,Jonathan Ericsson,1,69,11,D,2011
19102,10,28,Jonathan Ericsson,3,45,13,D,2012
19103,10,29,Jonathan Ericsson,1,48,11,D,2013
19104,12,30,Jonathan Ericsson,3,82,15,D,2014
19105,12,31,Jonathan Ericsson,3,71,15,D,2015
19106,8,32,Jonathan Ericsson,1,51,9,D,2016
19107,10,33,Jonathan Ericsson,3,81,13,D,2017
19108,0,22,Jonathan Ferland,1,7,1,RW,2005
19109,0,23,Jonathan Filewich,0,5,0,RW,2007
19110,0,18,Jonathan Girard,0,3,0,D,1998
19111,2,19,Jonathan Girard,1,23,3,D,1999
19112,13,20,Jonathan Girard,3,31,16,D,2000
19113,3,21,Jonathan Girard,0,20,3,D,2001
19114,16,22,Jonathan Girard,6,73,22,D,2002
19115,0,25,Jonathan Hedstrom,0,4,0,RW,2002
19116,14,28,Jonathan Hedstrom,13,79,27,RW,2005
19117,17,19,Jonathan Huberdeau,14,48,31,C,2012
19118,19,20,Jonathan Huberdeau,9,69,28,LW,2013
19119,39,21,Jonathan Huberdeau,15,79,54,LW,2014
19120,39,22,Jonathan Huberdeau,20,76,59,LW,2015
19121,16,23,Jonathan Huberdeau,10,31,26,LW,2016
19122,42,24,Jonathan Huberdeau,27,82,69,LW,2017
19123,0,24,Jonathan Marchessault,1,2,1,C,2014
19124,0,20,Jonathan Racine,0,1,0,D,2013
19125,0,20,Jonathan Sigalet,0,1,0,D,2006
19126,30,19,Jonathan Toews,24,64,54,C,2007
19127,35,20,Jonathan Toews,34,82,69,C,2008
19128,43,21,Jonathan Toews,25,76,68,C,2009
19129,44,22,Jonathan Toews,32,80,76,C,2010
19130,28,23,Jonathan Toews,29,59,57,C,2011
19131,25,24,Jonathan Toews,23,47,48,C,2012
19132,40,25,Jonathan Toews,28,76,68,C,2013
19133,38,26,Jonathan Toews,28,81,66,C,2014
19134,30,27,Jonathan Toews,28,80,58,C,2015
19135,37,28,Jonathan Toews,21,72,58,C,2016
19136,32,29,Jonathan Toews,20,74,52,C,2017
19137,5,22,Jonathon Blum,3,23,8,D,2010
19138,4,23,Jonathon Blum,3,33,7,D,2011
19139,6,24,Jonathon Blum,1,35,7,D,2012
19140,1,25,Jonathon Blum,0,15,1,D,2013
19141,1,26,Jonathon Blum,0,4,1,D,2014
19142,9,21,Jonathon Merrill,2,52,11,D,2013
19143,4,23,Jonathon Merrill,1,47,5,D,2015
19144,5,24,Jonathon Merrill,1,51,6,D,2016
19145,2,25,Jonathon Merrill,1,34,3,D,2017
19146,19,20,Joni Pitkanen,8,71,27,D,2003
19147,33,22,Joni Pitkanen,13,58,46,D,2005
19148,39,23,Joni Pitkanen,4,77,43,D,2006
19149,18,24,Joni Pitkanen,8,63,26,D,2007
19150,26,25,Joni Pitkanen,7,71,33,D,2008
19151,40,26,Joni Pitkanen,6,71,46,D,2009
19152,30,27,Joni Pitkanen,5,72,35,D,2010
19153,12,28,Joni Pitkanen,5,30,17,D,2011
19154,8,29,Joni Pitkanen,1,22,9,D,2012
19155,2,23,Jonny Brodzinski,0,6,2,C,2016
19156,2,24,Jonny Brodzinski,4,35,6,C,2017
19157,25,23,Joonas Donskoi,11,76,36,RW,2015
19158,11,24,Joonas Donskoi,6,61,17,RW,2016
19159,18,25,Joonas Donskoi,14,66,32,RW,2017
19160,3,27,Joonas Kemppainen,2,44,5,C,2015
19161,0,23,Joonas Nattinen,0,1,0,C,2013
19162,1,22,Joonas Rask,0,2,1,C,2012
19163,4,20,Jordan Caron,3,23,7,RW,2010
19164,8,21,Jordan Caron,7,48,15,RW,2011
19165,2,22,Jordan Caron,1,17,3,RW,2012
19166,2,23,Jordan Caron,1,35,3,RW,2013
19167,0,24,Jordan Caron,0,30,0,RW,2014
19168,0,25,Jordan Caron,0,4,0,RW,2015
19169,25,20,Jordan Eberle,18,69,43,C,2010
19170,42,21,Jordan Eberle,34,78,76,C,2011
19171,21,22,Jordan Eberle,16,48,37,C,2012
19172,37,23,Jordan Eberle,28,80,65,RW,2013
19173,39,24,Jordan Eberle,24,81,63,RW,2014
19174,22,25,Jordan Eberle,25,69,47,RW,2015
19175,31,26,Jordan Eberle,20,82,51,RW,2016
19176,34,27,Jordan Eberle,25,81,59,RW,2017
19177,1,20,Jordan Greenway,0,6,1,LW,2017
19178,3,23,Jordan Hendry,1,40,4,D,2007
19179,0,24,Jordan Hendry,0,9,0,D,2008
19180,6,25,Jordan Hendry,2,43,8,D,2009
19181,0,26,Jordan Hendry,1,37,1,D,2010
19182,0,28,Jordan Hendry,0,2,0,D,2012
19183,2,20,Jordan Krestanovich,0,8,2,LW,2001
19184,0,22,Jordan Krestanovich,0,14,0,LW,2003
19185,10,22,Jordan Leopold,4,58,14,D,2002
19186,24,23,Jordan Leopold,9,82,33,D,2003
19187,18,25,Jordan Leopold,2,74,20,D,2005
19188,3,26,Jordan Leopold,2,15,5,D,2006
19189,8,27,Jordan Leopold,5,43,13,D,2007
19190,17,28,Jordan Leopold,7,83,24,D,2008
19191,15,29,Jordan Leopold,11,81,26,D,2009
19192,22,30,Jordan Leopold,13,71,35,D,2010
19193,14,31,Jordan Leopold,10,79,24,D,2011
19194,8,32,Jordan Leopold,2,39,10,D,2012
19195,5,33,Jordan Leopold,1,27,6,D,2013
19196,3,34,Jordan Leopold,1,43,4,D,2014
19197,1,22,Jordan Martinook,0,8,1,LW,2014
19198,15,23,Jordan Martinook,9,81,24,LW,2015
19199,14,24,Jordan Martinook,11,77,25,LW,2016
19200,9,25,Jordan Martinook,6,81,15,LW,2017
19201,2,22,Jordan Nolan,2,26,4,C,2011
19202,4,23,Jordan Nolan,2,44,6,C,2012
19203,4,24,Jordan Nolan,6,64,10,C,2013
19204,3,25,Jordan Nolan,6,60,9,C,2014
19205,5,26,Jordan Nolan,0,52,5,C,2015
19206,4,27,Jordan Nolan,4,46,8,C,2016
19207,4,28,Jordan Nolan,4,69,8,LW,2017
19208,1,22,Jordan Oesterle,0,6,1,D,2014
19209,5,23,Jordan Oesterle,0,17,5,D,2015
19210,0,24,Jordan Oesterle,0,2,0,D,2016
19211,10,25,Jordan Oesterle,5,55,15,D,2017
19212,2,23,Jordan Schmaltz,0,9,2,D,2016
19213,1,24,Jordan Schmaltz,0,13,1,D,2017
19214,6,22,Jordan Schroeder,3,31,9,C,2012
19215,3,23,Jordan Schroeder,3,25,6,C,2013
19216,5,24,Jordan Schroeder,3,25,8,C,2014
19217,2,25,Jordan Schroeder,2,26,4,C,2015
19218,7,26,Jordan Schroeder,6,37,13,C,2016
19219,1,27,Jordan Schroeder,1,21,2,LW,2017
19220,1,21,Jordan Smotherman,1,2,2,LW,2007
19221,0,22,Jordan Smotherman,0,2,0,LW,2008
19222,13,18,Jordan Staal,29,81,42,C,2006
19223,16,19,Jordan Staal,12,82,28,C,2007
19224,27,20,Jordan Staal,22,82,49,C,2008
19225,28,21,Jordan Staal,21,82,49,C,2009
19226,19,22,Jordan Staal,11,42,30,C,2010
19227,25,23,Jordan Staal,25,62,50,C,2011
19228,21,24,Jordan Staal,10,48,31,C,2012
19229,25,25,Jordan Staal,15,82,40,C,2013
19230,18,26,Jordan Staal,6,46,24,C,2014
19231,28,27,Jordan Staal,20,82,48,C,2015
19232,29,28,Jordan Staal,16,75,45,C,2016
19233,27,29,Jordan Staal,19,79,46,C,2017
19234,0,22,Jordan Szwarz,3,26,3,RW,2013
19235,0,23,Jordan Szwarz,1,9,1,RW,2014
19236,3,26,Jordan Szwarz,0,12,3,RW,2017
19237,0,23,Jordan Weal,0,14,0,C,2015
19238,4,24,Jordan Weal,8,23,12,C,2016
19239,13,25,Jordan Weal,8,69,21,C,2017
19240,2,24,Jordie Benn,0,3,2,D,2011
19241,5,25,Jordie Benn,1,26,6,D,2012
19242,17,26,Jordie Benn,3,78,20,D,2013
19243,14,27,Jordie Benn,2,73,16,D,2014
19244,9,28,Jordie Benn,3,64,12,D,2015
19245,0,29,Jordie Benn,2,13,2,D,2016
19246,11,30,Jordie Benn,4,77,15,D,2017
19247,4,20,Jordin Tootoo,4,70,8,RW,2003
19248,6,22,Jordin Tootoo,4,34,10,RW,2005
19249,6,23,Jordin Tootoo,3,65,9,RW,2006
19250,7,24,Jordin Tootoo,11,63,18,RW,2007
19251,12,25,Jordin Tootoo,4,72,16,RW,2008
19252,10,26,Jordin Tootoo,6,51,16,RW,2009
19253,10,27,Jordin Tootoo,8,54,18,RW,2010
19254,24,28,Jordin Tootoo,6,77,30,RW,2011
19255,5,29,Jordin Tootoo,3,42,8,RW,2012
19256,1,30,Jordin Tootoo,0,11,1,RW,2013
19257,5,31,Jordin Tootoo,10,68,15,RW,2014
19258,5,32,Jordin Tootoo,4,66,9,RW,2015
19259,1,33,Jordin Tootoo,2,50,3,RW,2016
19260,10,21,Jordy Douglas,6,51,16,C,1978
19261,10,21,Jordy Douglas,6,51,16,C,1978
19262,24,22,Jordy Douglas,33,77,57,LW,1979
19263,9,23,Jordy Douglas,13,55,22,LW,1980
19264,7,24,Jordy Douglas,10,30,17,LW,1981
19265,14,25,Jordy Douglas,13,68,27,LW,1982
19266,6,26,Jordy Douglas,7,31,13,LW,1983
19267,2,27,Jordy Douglas,0,7,2,LW,1984
19268,19,27,Jorgen Jonsson,12,81,31,LW,1999
19269,36,24,Jorgen Pettersson,37,62,73,LW,1980
19270,31,25,Jorgen Pettersson,38,77,69,LW,1981
19271,38,26,Jorgen Pettersson,35,74,73,LW,1982
19272,34,27,Jorgen Pettersson,28,77,62,LW,1983
19273,32,28,Jorgen Pettersson,23,75,55,LW,1984
19274,21,29,Jorgen Pettersson,13,70,34,LW,1985
19275,30,27,Jori Lehtera,14,75,44,C,2014
19276,25,28,Jori Lehtera,9,79,34,C,2015
19277,15,29,Jori Lehtera,7,64,22,C,2016
19278,5,30,Jori Lehtera,3,62,8,C,2017
19279,2,21,Jose Charbonneau,0,16,2,RW,1987
19280,4,22,Jose Charbonneau,1,22,5,RW,1988
19281,7,27,Jose Charbonneau,7,30,14,RW,1993
19282,0,28,Jose Charbonneau,1,3,1,RW,1994
19283,16,22,Josef Beranek,12,58,28,C,1991
19284,18,23,Josef Beranek,15,66,33,RW,1992
19285,21,24,Josef Beranek,28,80,49,LW,1993
19286,18,25,Josef Beranek,13,51,31,C,1994
19287,14,26,Josef Beranek,6,61,20,LW,1995
19288,1,27,Josef Beranek,3,8,4,LW,1996
19289,30,29,Josef Beranek,19,66,49,LW,1998
19290,12,30,Josef Beranek,13,71,25,C,1999
19291,14,31,Josef Beranek,9,70,23,LW,2000
19292,0,24,Josef Boumedienne,1,4,1,D,2001
19293,0,25,Josef Boumedienne,1,6,1,D,2002
19294,12,26,Josef Boumedienne,2,37,14,RW,2003
19295,1,,Josef Kveton,0,6,1,D,1977
19296,1,,Josef Kveton,0,6,1,D,1977
19297,1,28,Josef Lukac,0,3,1,RW,1978
19298,1,28,Josef Lukac,0,3,1,RW,1978
19299,1,19,Josef Marha,0,2,1,C,1995
19300,1,20,Josef Marha,0,6,1,C,1996
19301,9,21,Josef Marha,9,23,18,LW,1997
19302,6,22,Josef Marha,2,32,8,C,1998
19303,12,23,Josef Marha,10,81,22,C,1999
19304,3,24,Josef Marha,0,15,3,C,2000
19305,2,22,Josef Melichar,0,18,2,D,2000
19306,3,23,Josef Melichar,0,60,3,D,2001
19307,0,24,Josef Melichar,0,8,0,D,2002
19308,5,25,Josef Melichar,3,82,8,D,2003
19309,12,27,Josef Melichar,3,72,15,D,2005
19310,11,28,Josef Melichar,1,70,12,D,2006
19311,9,30,Josef Melichar,0,39,9,D,2008
19312,13,20,Josef Vasicek,8,76,21,C,2000
19313,17,21,Josef Vasicek,14,78,31,C,2001
19314,10,22,Josef Vasicek,10,57,20,C,2002
19315,26,23,Josef Vasicek,19,82,45,LW,2003
19316,5,25,Josef Vasicek,4,23,9,C,2005
19317,16,26,Josef Vasicek,6,63,22,C,2006
19318,19,27,Josef Vasicek,16,81,35,C,2007
19319,12,21,Joseph Blandisi,5,41,17,LW,2015
19320,6,22,Joseph Blandisi,3,27,9,LW,2016
19321,0,23,Joseph Blandisi,0,3,0,LW,2017
19322,0,24,Joseph Cramarossa,0,10,0,LW,2016
19323,0,23,Joseph Labate,0,13,0,C,2016
19324,6,23,Joseph Morrow,1,33,7,D,2015
19325,1,24,Joseph Morrow,0,17,1,D,2016
19326,4,25,Joseph Morrow,1,18,5,D,2017
19327,1,20,Josh Anderson,0,6,1,RW,2014
19328,3,21,Josh Anderson,1,12,4,RW,2015
19329,12,22,Josh Anderson,17,78,29,RW,2016
19330,11,23,Josh Anderson,19,63,30,RW,2017
19331,0,23,Josh Archibald,0,1,0,RW,2015
19332,0,24,Josh Archibald,3,10,3,RW,2016
19333,0,25,Josh Archibald,0,3,0,RW,2017
19334,18,19,Josh Bailey,7,68,25,C,2008
19335,19,20,Josh Bailey,16,73,35,C,2009
19336,17,21,Josh Bailey,11,70,28,C,2010
19337,19,22,Josh Bailey,13,80,32,C,2011
19338,8,23,Josh Bailey,11,38,19,C,2012
19339,30,24,Josh Bailey,8,77,38,LW,2013
19340,26,25,Josh Bailey,15,70,41,LW,2014
19341,20,26,Josh Bailey,12,81,32,RW,2015
19342,43,27,Josh Bailey,13,82,56,RW,2016
19343,53,28,Josh Bailey,18,76,71,RW,2017
19344,6,21,Josh Gorges,0,49,6,D,2005
19345,3,22,Josh Gorges,1,54,4,D,2006
19346,9,23,Josh Gorges,0,62,9,D,2007
19347,19,24,Josh Gorges,4,81,23,D,2008
19348,7,25,Josh Gorges,3,82,10,D,2009
19349,6,26,Josh Gorges,1,36,7,D,2010
19350,14,27,Josh Gorges,2,82,16,D,2011
19351,7,28,Josh Gorges,2,48,9,D,2012
19352,13,29,Josh Gorges,1,66,14,D,2013
19353,6,30,Josh Gorges,0,46,6,D,2014
19354,10,31,Josh Gorges,2,77,12,D,2015
19355,5,32,Josh Gorges,1,66,6,D,2016
19356,2,33,Josh Gorges,0,34,2,D,2017
19357,0,23,Josh Gratton,1,14,1,LW,2005
19358,1,24,Josh Gratton,1,52,2,LW,2006
19359,0,25,Josh Gratton,0,1,0,LW,2007
19360,2,26,Josh Gratton,1,19,3,LW,2008
19361,3,21,Josh Green,1,27,4,LW,1998
19362,14,22,Josh Green,12,49,26,LW,1999
19363,5,24,Josh Green,10,61,15,LW,2001
19364,4,25,Josh Green,1,45,5,LW,2002
19365,6,26,Josh Green,5,50,11,LW,2003
19366,2,28,Josh Green,4,33,6,LW,2005
19367,5,29,Josh Green,2,57,7,C,2006
19368,0,33,Josh Green,0,12,0,LW,2010
19369,1,34,Josh Green,1,7,2,LW,2011
19370,0,21,Josh Hennessy,1,10,1,C,2006
19371,0,22,Josh Hennessy,0,5,0,C,2007
19372,0,23,Josh Hennessy,0,1,0,C,2008
19373,0,24,Josh Hennessy,0,4,0,C,2009
19374,0,26,Josh Hennessy,0,3,0,C,2011
19375,4,21,Josh Holden,2,30,6,C,1998
19376,5,22,Josh Holden,1,6,6,C,1999
19377,0,23,Josh Holden,1,10,1,C,2000
19378,0,24,Josh Holden,0,8,0,C,2001
19379,0,25,Josh Holden,1,5,1,C,2002
19380,0,26,Josh Holden,0,1,0,C,2003
19381,12,24,Josh Jooris,12,60,24,C,2014
19382,9,25,Josh Jooris,4,59,13,C,2015
19383,1,26,Josh Jooris,1,12,2,RW,2016
19384,0,27,Josh Jooris,0,9,0,RW,2017
19385,0,24,Josh Langfeld,0,1,0,RW,2001
19386,1,25,Josh Langfeld,0,12,1,RW,2002
19387,10,26,Josh Langfeld,7,38,17,RW,2003
19388,10,28,Josh Langfeld,2,57,12,RW,2005
19389,2,29,Josh Langfeld,0,33,2,RW,2006
19390,0,30,Josh Langfeld,0,2,0,RW,2007
19391,1,20,Josh Leivo,1,7,2,RW,2013
19392,0,21,Josh Leivo,1,9,1,LW,2014
19393,0,22,Josh Leivo,5,12,5,LW,2015
19394,8,23,Josh Leivo,2,13,10,LW,2016
19395,3,24,Josh Leivo,1,16,4,LW,2017
19396,3,23,Josh Manson,0,28,3,D,2014
19397,10,24,Josh Manson,5,71,15,D,2015
19398,12,25,Josh Manson,5,82,17,D,2016
19399,30,26,Josh Manson,7,80,37,D,2017
19400,0,20,Josh Morrissey,0,1,0,D,2015
19401,14,21,Josh Morrissey,6,82,20,D,2016
19402,19,22,Josh Morrissey,7,81,26,D,2017
19403,0,22,Josh Olson,1,5,1,LW,2003
19404,6,21,Joshua Ho-Sang,4,21,10,RW,2016
19405,10,22,Joshua Ho-Sang,2,22,12,RW,2017
19406,0,28,Jouni Peltonen,1,1,1,RW,1978
19407,0,28,Jouni Peltonen,1,1,1,RW,1978
19408,1,28,Jouni Rinne,1,1,2,RW,1978
19409,1,28,Jouni Rinne,1,1,2,RW,1978
19410,4,21,Jozef Balej,1,17,5,RW,2003
19411,1,23,Jozef Balej,0,1,1,RW,2005
19412,0,19,Jozef Cierny,0,1,0,LW,1993
19413,0,19,Jozef Stumpel,1,4,1,RW,1991
19414,3,20,Jozef Stumpel,1,13,4,RW,1992
19415,15,21,Jozef Stumpel,8,59,23,C,1993
19416,13,22,Jozef Stumpel,5,44,18,C,1994
19417,36,23,Jozef Stumpel,18,76,54,C,1995
19418,55,24,Jozef Stumpel,21,78,76,C,1996
19419,58,25,Jozef Stumpel,21,77,79,C,1997
19420,21,26,Jozef Stumpel,13,64,34,C,1998
19421,41,27,Jozef Stumpel,17,57,58,C,1999
19422,39,28,Jozef Stumpel,16,63,55,C,2000
19423,50,29,Jozef Stumpel,8,81,58,C,2001
19424,37,30,Jozef Stumpel,14,78,51,C,2002
19425,29,31,Jozef Stumpel,8,64,37,C,2003
19426,37,33,Jozef Stumpel,15,74,52,C,2005
19427,34,34,Jozef Stumpel,23,73,57,C,2006
19428,13,35,Jozef Stumpel,7,52,20,RW,2007
19429,0,,Jrek Gimaev,1,8,1,C,1977
19430,0,,Jrek Gimaev,1,8,1,C,1977
19431,3,28,Jrek Gimaev,2,6,5,RW,1978
19432,3,28,Jrek Gimaev,2,6,5,RW,1978
19433,1,20,Jude Drouin,0,9,1,C,1968
19434,0,21,Jude Drouin,0,3,0,C,1969
19435,52,22,Jude Drouin,16,75,68,C,1970
19436,43,23,Jude Drouin,13,63,56,C,1971
19437,46,24,Jude Drouin,27,78,73,C,1972
19438,24,25,Jude Drouin,19,65,43,C,1973
19439,36,26,Jude Drouin,18,78,54,C,1974
19440,41,27,Jude Drouin,21,76,62,C,1975
19441,29,28,Jude Drouin,24,78,53,C,1976
19442,17,29,Jude Drouin,5,56,22,C,1977
19443,16,31,Jude Drouin,8,78,24,C,1979
19444,0,32,Jude Drouin,0,7,0,C,1980
19445,0,28,Juha Jyrkkio,1,1,1,RW,1978
19446,0,28,Juha Jyrkkio,1,1,1,RW,1978
19447,3,24,Juha Lind,2,39,5,LW,1997
19448,6,26,Juha Lind,4,47,10,LW,1999
19449,4,27,Juha Lind,3,47,7,LW,2000
19450,9,22,Juha Widing,7,48,16,C,1969
19451,40,23,Juha Widing,25,78,65,C,1970
19452,28,24,Juha Widing,27,78,55,C,1971
19453,54,25,Juha Widing,16,77,70,C,1972
19454,30,26,Juha Widing,27,71,57,C,1973
19455,34,27,Juha Widing,26,80,60,C,1974
19456,15,28,Juha Widing,7,67,22,C,1975
19457,16,29,Juha Widing,9,76,25,C,1976
19458,24,30,Juha Widing,18,71,42,C,1977
19459,24,30,Juha Widing,18,71,42,C,1977
19460,0,24,Juha Ylonen,0,2,0,C,1996
19461,11,25,Juha Ylonen,1,55,12,C,1997
19462,17,26,Juha Ylonen,6,59,23,C,1998
19463,23,27,Juha Ylonen,6,76,29,C,1999
19464,14,28,Juha Ylonen,9,69,23,C,2000
19465,11,29,Juha Ylonen,4,80,15,LW,2001
19466,14,25,Juhani Tamminen,7,65,21,RW,1975
19467,14,25,Juhani Tamminen,7,65,21,RW,1975
19468,29,26,Juhani Tamminen,10,65,39,RW,1976
19469,29,26,Juhani Tamminen,10,65,39,RW,1976
19470,2,21,Jujhar Khaira,0,15,2,LW,2015
19471,0,22,Jujhar Khaira,1,10,1,LW,2016
19472,10,23,Jujhar Khaira,11,69,21,LW,2017
19473,5,27,Jukka Hentunen,4,38,9,LW,2001
19474,1,28,Jukka Koskilhati,0,1,1,RW,1978
19475,1,28,Jukka Koskilhati,0,1,1,RW,1978
19476,6,28,Jukka Porvari,2,31,8,RW,1981
19477,3,29,Jukka Porvari,1,8,4,RW,1982
19478,0,22,Julian Melchiori,0,1,0,D,2013
19479,0,24,Julian Melchiori,0,11,0,D,2015
19480,2,25,Julian Melchiori,0,18,2,D,2016
19481,1,27,Julien Brouillette,1,10,2,D,2013
19482,0,28,Julien Brouillette,0,1,0,D,2014
19483,0,24,Julien Vauclair,0,1,0,D,2003
19484,4,21,Julius Honka,1,16,5,D,2016
19485,3,22,Julius Honka,1,42,4,D,2017
19486,0,25,Junior Lessard,1,5,1,RW,2005
19487,0,26,Junior Lessard,1,1,1,RW,2006
19488,1,27,Junior Lessard,1,21,2,RW,2007
19489,3,20,Juraj Kolnik,4,29,7,RW,2000
19490,0,21,Juraj Kolnik,2,7,2,RW,2001
19491,1,22,Juraj Kolnik,0,10,1,RW,2002
19492,11,23,Juraj Kolnik,14,53,25,RW,2003
19493,20,25,Juraj Kolnik,15,77,35,RW,2005
19494,14,26,Juraj Kolnik,11,64,25,RW,2006
19495,38,22,Jussi Jokinen,17,81,55,LW,2005
19496,34,23,Jussi Jokinen,14,82,48,LW,2006
19497,26,24,Jussi Jokinen,16,72,42,LW,2007
19498,20,25,Jussi Jokinen,7,71,27,LW,2008
19499,35,26,Jussi Jokinen,30,81,65,LW,2009
19500,33,27,Jussi Jokinen,19,70,52,LW,2010
19501,34,28,Jussi Jokinen,12,79,46,LW,2011
19502,9,29,Jussi Jokinen,13,43,22,LW,2012
19503,36,30,Jussi Jokinen,21,81,57,LW,2013
19504,36,31,Jussi Jokinen,8,81,44,LW,2014
19505,42,32,Jussi Jokinen,18,81,60,LW,2015
19506,17,33,Jussi Jokinen,11,69,28,LW,2016
19507,1,34,Jussi Jokinen,0,14,1,LW,2017
19508,4,23,Jussi Timonen,0,14,4,D,2006
19509,0,20,Justin Abdelkader,0,2,0,LW,2007
19510,0,21,Justin Abdelkader,0,2,0,LW,2008
19511,3,22,Justin Abdelkader,3,50,6,LW,2009
19512,12,23,Justin Abdelkader,7,74,19,LW,2010
19513,14,24,Justin Abdelkader,8,81,22,LW,2011
19514,3,25,Justin Abdelkader,10,48,13,LW,2012
19515,18,26,Justin Abdelkader,10,70,28,LW,2013
19516,21,27,Justin Abdelkader,23,71,44,LW,2014
19517,23,28,Justin Abdelkader,19,82,42,LW,2015
19518,14,29,Justin Abdelkader,7,64,21,LW,2016
19519,22,30,Justin Abdelkader,13,75,35,LW,2017
19520,0,23,Justin Auger,0,2,0,RW,2017
19521,0,20,Justin Bailey,0,8,0,RW,2015
19522,2,21,Justin Bailey,2,32,4,RW,2016
19523,1,22,Justin Bailey,3,12,4,RW,2017
19524,9,23,Justin Braun,2,28,11,D,2010
19525,9,24,Justin Braun,2,66,11,D,2011
19526,7,25,Justin Braun,0,41,7,D,2012
19527,13,26,Justin Braun,4,82,17,D,2013
19528,22,27,Justin Braun,1,70,23,D,2014
19529,19,28,Justin Braun,4,80,23,D,2015
19530,9,29,Justin Braun,4,81,13,D,2016
19531,28,30,Justin Braun,5,81,33,D,2017
19532,1,22,Justin Dibenedetto,0,8,1,LW,2010
19533,2,26,Justin Dowling,0,9,2,C,2016
19534,0,23,Justin Duberman,0,4,0,RW,1993
19535,0,21,Justin Falk,0,3,0,D,2009
19536,3,22,Justin Falk,0,22,3,D,2010
19537,8,23,Justin Falk,1,47,9,D,2011
19538,3,24,Justin Falk,0,36,3,D,2012
19539,2,25,Justin Falk,0,21,2,D,2013
19540,1,26,Justin Falk,1,18,2,D,2014
19541,4,27,Justin Falk,0,24,4,D,2015
19542,8,28,Justin Falk,0,52,8,D,2016
19543,1,29,Justin Falk,1,46,2,D,2017
19544,14,19,Justin Faulk,8,66,22,D,2011
19545,10,20,Justin Faulk,5,38,15,D,2012
19546,27,21,Justin Faulk,5,76,32,D,2013
19547,34,22,Justin Faulk,15,82,49,D,2014
19548,21,23,Justin Faulk,16,64,37,D,2015
19549,20,24,Justin Faulk,17,75,37,D,2016
19550,23,25,Justin Faulk,8,76,31,D,2017
19551,1,23,Justin Florek,1,4,2,LW,2013
19552,8,26,Justin Fontaine,13,66,21,RW,2013
19553,22,27,Justin Fontaine,9,71,31,RW,2014
19554,11,28,Justin Fontaine,5,60,16,RW,2015
19555,0,20,Justin Hocking,0,1,0,D,1993
19556,0,26,Justin Hodgman,1,5,1,C,2014
19557,0,26,Justin Holl,2,2,2,D,2017
19558,0,32,Justin Johnson,0,2,0,RW,2013
19559,0,24,Justin Kloos,0,1,0,C,2017
19560,5,25,Justin Kurtz,3,27,8,D,2001
19561,2,22,Justin Mapletoft,2,11,4,C,2002
19562,4,23,Justin Mapletoft,1,27,5,C,2003
19563,1,22,Justin Mercier,1,9,2,LW,2009
19564,0,22,Justin Papineau,0,1,0,C,2001
19565,3,23,Justin Papineau,3,16,6,C,2002
19566,5,24,Justin Papineau,8,64,13,C,2003
19567,19,22,Justin Schultz,8,48,27,D,2012
19568,22,23,Justin Schultz,11,74,33,D,2013
19569,25,24,Justin Schultz,6,81,31,D,2014
19570,14,25,Justin Schultz,4,63,18,D,2015
19571,39,26,Justin Schultz,12,78,51,D,2016
19572,23,27,Justin Schultz,4,63,27,D,2017
19573,0,23,Justin Shugg,0,3,0,LW,2014
19574,13,19,Justin Williams,12,63,25,RW,2000
19575,23,20,Justin Williams,17,75,40,RW,2001
19576,16,21,Justin Williams,8,41,24,RW,2002
19577,33,22,Justin Williams,11,79,44,RW,2003
19578,45,24,Justin Williams,31,82,76,RW,2005
19579,34,25,Justin Williams,33,82,67,RW,2006
19580,21,26,Justin Williams,9,37,30,RW,2007
19581,10,27,Justin Williams,4,44,14,RW,2008
19582,19,28,Justin Williams,10,49,29,RW,2009
19583,35,29,Justin Williams,22,73,57,RW,2010
19584,37,30,Justin Williams,22,82,59,RW,2011
19585,22,31,Justin Williams,11,48,33,RW,2012
19586,24,32,Justin Williams,19,82,43,RW,2013
19587,23,33,Justin Williams,18,81,41,RW,2014
19588,30,34,Justin Williams,22,82,52,RW,2015
19589,24,35,Justin Williams,24,80,48,RW,2016
19590,35,36,Justin Williams,16,82,51,RW,2017
19591,10,23,Jyrki Jokipakka,0,51,10,D,2014
19592,10,24,Jyrki Jokipakka,2,58,12,D,2015
19593,0,25,Jyrki Jokipakka,0,3,0,D,2016
19594,3,22,Jyrki Lumme,1,21,4,D,1988
19595,26,23,Jyrki Lumme,4,65,30,D,1989
19596,27,24,Jyrki Lumme,5,80,32,D,1990
19597,32,25,Jyrki Lumme,12,75,44,D,1991
19598,36,26,Jyrki Lumme,8,74,44,D,1992
19599,42,27,Jyrki Lumme,13,83,55,D,1993
19600,12,28,Jyrki Lumme,5,36,17,D,1994
19601,37,29,Jyrki Lumme,17,80,54,D,1995
19602,24,30,Jyrki Lumme,11,66,35,D,1996
19603,21,31,Jyrki Lumme,9,74,30,D,1997
19604,21,32,Jyrki Lumme,7,60,28,D,1998
19605,32,33,Jyrki Lumme,8,74,40,D,1999
19606,21,34,Jyrki Lumme,4,58,25,D,2000
19607,9,35,Jyrki Lumme,4,66,13,D,2001
19608,11,36,Jyrki Lumme,6,73,17,D,2002
19609,2,22,Jyrki Seppa,0,13,2,D,1983
19610,1,27,Kael Mouillierat,1,6,2,LW,2014
19611,0,28,Kael Mouillierat,0,1,0,LW,2015
19612,11,27,Kai Nurminen,16,67,27,RW,1996
19613,0,31,Kai Nurminen,1,2,1,LW,2000
19614,0,22,Kai Suikkanen,0,1,0,LW,1981
19615,0,23,Kai Suikkanen,0,1,0,LW,1982
19616,3,19,Kailer Yamamoto,0,9,3,RW,2017
19617,0,23,Kalle Kossila,0,1,0,LW,2016
19618,1,24,Kalle Kossila,1,10,2,LW,2017
19619,1,22,Kamil Kreps,1,14,2,C,2006
19620,17,23,Kamil Kreps,8,76,25,C,2007
19621,15,24,Kamil Kreps,4,66,19,C,2008
19622,9,25,Kamil Kreps,5,76,14,C,2009
19623,1,23,Kamil Piros,0,8,1,C,2001
19624,2,24,Kamil Piros,3,3,5,C,2002
19625,1,25,Kamil Piros,1,17,2,C,2003
19626,2,20,Karel Betik,0,3,2,D,1998
19627,2,28,Karel Holy,4,6,6,RW,1978
19628,2,28,Karel Holy,4,6,6,RW,1978
19629,3,24,Karel Pilar,1,23,4,D,2001
19630,4,25,Karel Pilar,3,17,7,D,2002
19631,17,26,Karel Pilar,2,50,19,D,2003
19632,0,20,Karel Rachunek,0,6,0,D,1999
19633,30,21,Karel Rachunek,3,71,33,D,2000
19634,15,22,Karel Rachunek,3,51,18,D,2001
19635,25,23,Karel Rachunek,4,58,29,D,2002
19636,19,24,Karel Rachunek,2,72,21,D,2003
19637,20,27,Karel Rachunek,6,66,26,D,2006
19638,9,28,Karel Rachunek,4,47,13,D,2007
19639,12,25,Kari Eloranta,1,31,13,D,1981
19640,40,26,Kari Eloranta,4,80,44,D,1982
19641,34,27,Kari Eloranta,5,78,39,D,1983
19642,11,28,Kari Eloranta,2,65,13,D,1984
19643,6,30,Kari Eloranta,1,13,7,D,1986
19644,0,29,Kari Haakana,0,13,0,D,2002
19645,3,23,Kari Jalonen,9,25,12,C,1982
19646,3,24,Kari Jalonen,0,12,3,C,1983
19647,2,25,Kari Makkonen,2,9,4,RW,1979
19648,4,20,Karl Alzner,1,30,5,D,2008
19649,5,21,Karl Alzner,0,21,5,D,2009
19650,10,22,Karl Alzner,2,82,12,D,2010
19651,16,23,Karl Alzner,1,82,17,D,2011
19652,4,24,Karl Alzner,1,48,5,D,2012
19653,16,25,Karl Alzner,2,82,18,D,2013
19654,16,26,Karl Alzner,5,82,21,D,2014
19655,17,27,Karl Alzner,4,82,21,D,2015
19656,10,28,Karl Alzner,3,82,13,D,2016
19657,11,29,Karl Alzner,1,82,12,D,2017
19658,3,19,Karl Dykhuis,1,6,4,D,1991
19659,5,20,Karl Dykhuis,0,12,5,D,1992
19660,6,22,Karl Dykhuis,2,33,8,D,1994
19661,15,23,Karl Dykhuis,5,82,20,D,1995
19662,15,24,Karl Dykhuis,4,62,19,D,1996
19663,9,25,Karl Dykhuis,5,78,14,D,1997
19664,5,26,Karl Dykhuis,4,78,9,D,1998
19665,13,27,Karl Dykhuis,7,72,20,D,1999
19666,9,28,Karl Dykhuis,8,67,17,D,2000
19667,7,29,Karl Dykhuis,5,80,12,D,2001
19668,4,30,Karl Dykhuis,1,65,5,D,2002
19669,0,31,Karl Dykhuis,0,9,0,D,2003
19670,1,20,Karl Stewart,0,5,1,LW,2003
19671,0,22,Karl Stewart,0,8,0,LW,2005
19672,3,23,Karl Stewart,2,47,5,LW,2006
19673,0,24,Karl Stewart,0,9,0,LW,2007
19674,0,26,Karl Stollery,0,2,0,D,2013
19675,0,27,Karl Stollery,0,10,0,D,2014
19676,3,29,Karl Stollery,0,11,3,D,2016
19677,1,24,Karlis Skrastins,0,2,1,D,1998
19678,6,25,Karlis Skrastins,5,59,11,D,1999
19679,11,26,Karlis Skrastins,1,82,12,D,2000
19680,13,27,Karlis Skrastins,4,82,17,D,2001
19681,10,28,Karlis Skrastins,3,82,13,D,2002
19682,8,29,Karlis Skrastins,5,82,13,D,2003
19683,11,31,Karlis Skrastins,3,82,14,D,2005
19684,11,32,Karlis Skrastins,0,68,11,D,2006
19685,3,33,Karlis Skrastins,2,60,5,D,2007
19686,14,34,Karlis Skrastins,4,80,18,D,2008
19687,11,35,Karlis Skrastins,2,79,13,D,2009
19688,5,36,Karlis Skrastins,3,74,8,D,2010
19689,1,24,Kaspars Astashenko,0,8,1,D,1999
19690,1,25,Kaspars Astashenko,1,15,2,D,2000
19691,0,21,Kaspars Daugavins,0,1,0,LW,2009
19692,6,23,Kaspars Daugavins,5,65,11,LW,2011
19693,3,24,Kaspars Daugavins,1,25,4,LW,2012
19694,0,19,Kasperi Kapanen,0,9,0,RW,2015
19695,0,20,Kasperi Kapanen,1,8,1,RW,2016
19696,2,21,Kasperi Kapanen,7,38,9,RW,2017
19697,0,21,Keaton Ellerby,0,22,0,D,2009
19698,10,22,Keaton Ellerby,2,54,12,D,2010
19699,5,23,Keaton Ellerby,0,40,5,D,2011
19700,3,24,Keaton Ellerby,0,44,3,D,2012
19701,4,25,Keaton Ellerby,2,51,6,D,2013
19702,1,26,Keaton Ellerby,0,1,1,D,2014
19703,0,21,Keegan Lowe,0,2,0,D,2014
19704,0,24,Keegan Lowe,0,2,0,D,2017
19705,1,21,Keith Acton,0,2,1,C,1979
19706,24,22,Keith Acton,15,61,39,C,1980
19707,52,23,Keith Acton,36,78,88,C,1981
19708,26,24,Keith Acton,24,78,50,C,1982
19709,45,25,Keith Acton,20,71,65,C,1983
19710,38,26,Keith Acton,20,78,58,C,1984
19711,32,27,Keith Acton,26,79,58,C,1985
19712,29,28,Keith Acton,16,78,45,C,1986
19713,17,29,Keith Acton,11,72,28,C,1987
19714,25,30,Keith Acton,14,71,39,C,1988
19715,14,31,Keith Acton,13,69,27,C,1989
19716,23,32,Keith Acton,14,76,37,C,1990
19717,10,33,Keith Acton,7,50,17,C,1991
19718,15,34,Keith Acton,8,83,23,C,1992
19719,7,35,Keith Acton,2,77,9,C,1993
19720,0,26,Keith Aldridge,0,4,0,D,1999
19721,1,27,Keith Aucoin,0,7,1,C,2005
19722,1,28,Keith Aucoin,0,8,1,RW,2006
19723,8,29,Keith Aucoin,5,38,13,RW,2007
19724,4,30,Keith Aucoin,2,12,6,C,2008
19725,4,31,Keith Aucoin,1,9,5,C,2009
19726,0,32,Keith Aucoin,0,1,0,C,2010
19727,8,33,Keith Aucoin,3,27,11,C,2011
19728,6,34,Keith Aucoin,6,41,12,C,2012
19729,0,35,Keith Aucoin,0,2,0,C,2013
19730,0,21,Keith Aulie,2,40,2,D,2010
19731,3,22,Keith Aulie,0,36,3,D,2011
19732,5,23,Keith Aulie,2,45,7,D,2012
19733,1,24,Keith Aulie,0,15,1,D,2013
19734,1,25,Keith Aulie,0,31,1,D,2014
19735,31,23,Keith Ballard,8,82,39,D,2005
19736,22,24,Keith Ballard,5,69,27,D,2006
19737,15,25,Keith Ballard,6,82,21,D,2007
19738,28,26,Keith Ballard,6,82,34,D,2008
19739,20,27,Keith Ballard,8,82,28,D,2009
19740,5,28,Keith Ballard,2,65,7,D,2010
19741,6,29,Keith Ballard,1,47,7,D,2011
19742,2,30,Keith Ballard,0,36,2,D,2012
19743,7,31,Keith Ballard,2,45,9,D,2013
19744,1,32,Keith Ballard,0,14,1,D,2014
19745,18,19,Keith Brown,2,76,20,D,1979
19746,34,20,Keith Brown,9,80,43,D,1980
19747,20,21,Keith Brown,4,33,24,D,1981
19748,27,22,Keith Brown,4,50,31,D,1982
19749,25,23,Keith Brown,10,74,35,D,1983
19750,22,24,Keith Brown,1,56,23,D,1984
19751,29,25,Keith Brown,11,70,40,D,1985
19752,23,26,Keith Brown,4,73,27,D,1986
19753,6,27,Keith Brown,3,24,9,D,1987
19754,16,28,Keith Brown,2,74,18,D,1988
19755,20,29,Keith Brown,5,67,25,D,1989
19756,10,30,Keith Brown,1,45,11,D,1990
19757,10,31,Keith Brown,6,57,16,D,1991
19758,6,32,Keith Brown,2,33,8,D,1992
19759,8,33,Keith Brown,4,51,12,D,1993
19760,0,34,Keith Brown,0,13,0,D,1994
19761,2,21,Keith Carney,1,14,3,D,1991
19762,4,22,Keith Carney,2,30,6,D,1992
19763,8,23,Keith Carney,4,37,12,D,1993
19764,0,24,Keith Carney,1,18,1,D,1994
19765,14,25,Keith Carney,5,82,19,D,1995
19766,15,26,Keith Carney,3,81,18,D,1996
19767,19,27,Keith Carney,3,80,22,D,1997
19768,14,28,Keith Carney,2,82,16,D,1998
19769,20,29,Keith Carney,4,82,24,D,1999
19770,14,30,Keith Carney,2,82,16,D,2000
19771,9,31,Keith Carney,5,60,14,D,2001
19772,18,32,Keith Carney,4,81,22,D,2002
19773,5,33,Keith Carney,2,69,7,D,2003
19774,18,35,Keith Carney,2,79,20,D,2005
19775,13,36,Keith Carney,4,80,17,D,2006
19776,10,37,Keith Carney,1,61,11,D,2007
19777,30,28,Keith Christiansen,12,64,42,C,1972
19778,30,28,Keith Christiansen,12,64,42,C,1972
19779,25,29,Keith Christiansen,11,74,36,C,1973
19780,25,29,Keith Christiansen,11,74,36,C,1973
19781,0,20,Keith Crowder,1,5,1,RW,1978
19782,0,20,Keith Crowder,1,5,1,RW,1978
19783,12,22,Keith Crowder,13,47,25,RW,1980
19784,21,23,Keith Crowder,23,71,44,RW,1981
19785,39,24,Keith Crowder,35,74,74,RW,1982
19786,28,25,Keith Crowder,24,63,52,RW,1983
19787,38,26,Keith Crowder,32,79,70,RW,1984
19788,46,27,Keith Crowder,38,78,84,RW,1985
19789,30,28,Keith Crowder,22,58,52,RW,1986
19790,26,29,Keith Crowder,17,68,43,RW,1987
19791,18,30,Keith Crowder,15,69,33,RW,1988
19792,13,31,Keith Crowder,4,55,17,C,1989
19793,2,26,Keith Hanson,0,25,2,D,1983
19794,14,24,Keith Jones,12,71,26,RW,1992
19795,19,25,Keith Jones,16,68,35,RW,1993
19796,6,26,Keith Jones,14,40,20,RW,1994
19797,23,27,Keith Jones,18,68,41,LW,1995
19798,23,28,Keith Jones,25,78,48,RW,1996
19799,7,29,Keith Jones,3,23,10,RW,1997
19800,33,30,Keith Jones,20,78,53,RW,1998
19801,16,31,Keith Jones,9,57,25,RW,1999
19802,0,32,Keith Jones,0,8,0,RW,2000
19803,2,25,Keith Kokkola,0,33,2,D,1974
19804,2,25,Keith Kokkola,0,33,2,D,1974
19805,3,26,Keith Kokkola,0,16,3,D,1975
19806,3,26,Keith Kokkola,0,16,3,D,1975
19807,0,27,Keith Kokkola,0,5,0,D,1976
19808,0,27,Keith Kokkola,0,5,0,D,1976
19809,24,22,Keith Magnuson,0,76,24,D,1969
19810,20,23,Keith Magnuson,3,76,23,D,1970
19811,19,24,Keith Magnuson,2,74,21,D,1971
19812,19,25,Keith Magnuson,0,77,19,D,1972
19813,11,26,Keith Magnuson,2,57,13,D,1973
19814,12,27,Keith Magnuson,2,48,14,D,1974
19815,6,28,Keith Magnuson,1,48,7,D,1975
19816,6,29,Keith Magnuson,1,37,7,D,1976
19817,4,30,Keith Magnuson,2,67,6,D,1977
19818,4,31,Keith Magnuson,1,26,5,D,1978
19819,0,32,Keith Magnuson,0,3,0,D,1979
19820,12,27,Keith McCreary,14,70,26,LW,1967
19821,23,28,Keith McCreary,25,70,48,LW,1968
19822,8,29,Keith McCreary,18,60,26,LW,1969
19823,12,30,Keith McCreary,21,59,33,LW,1970
19824,4,31,Keith McCreary,4,33,8,LW,1971
19825,21,32,Keith McCreary,20,77,41,LW,1972
19826,19,33,Keith McCreary,18,76,37,LW,1973
19827,10,34,Keith McCreary,11,78,21,LW,1974
19828,2,20,Keith Osborne,0,5,2,RW,1989
19829,1,23,Keith Osborne,1,11,2,RW,1992
19830,12,19,Keith Primeau,3,58,15,C,1990
19831,10,20,Keith Primeau,6,35,16,C,1991
19832,17,21,Keith Primeau,15,73,32,C,1992
19833,42,22,Keith Primeau,31,78,73,C,1993
19834,27,23,Keith Primeau,15,45,42,C,1994
19835,25,24,Keith Primeau,27,74,52,C,1995
19836,25,25,Keith Primeau,26,75,51,C,1996
19837,37,26,Keith Primeau,26,81,63,C,1997
19838,32,27,Keith Primeau,30,78,62,C,1998
19839,10,28,Keith Primeau,7,23,17,C,1999
19840,39,29,Keith Primeau,34,71,73,C,2000
19841,29,30,Keith Primeau,19,75,48,C,2001
19842,27,31,Keith Primeau,19,80,46,C,2002
19843,15,32,Keith Primeau,7,54,22,C,2003
19844,6,34,Keith Primeau,1,9,7,C,2005
19845,0,21,Keith Redmond,1,12,1,LW,1993
19846,5,19,Keith Tkachuk,3,17,8,LW,1991
19847,23,20,Keith Tkachuk,28,83,51,LW,1992
19848,40,21,Keith Tkachuk,41,84,81,LW,1993
19849,29,22,Keith Tkachuk,22,48,51,LW,1994
19850,48,23,Keith Tkachuk,50,76,98,LW,1995
19851,34,24,Keith Tkachuk,52,81,86,LW,1996
19852,26,25,Keith Tkachuk,40,69,66,LW,1997
19853,32,26,Keith Tkachuk,36,68,68,LW,1998
19854,21,27,Keith Tkachuk,22,50,43,LW,1999
19855,44,28,Keith Tkachuk,35,76,79,LW,2000
19856,37,29,Keith Tkachuk,38,73,75,LW,2001
19857,24,30,Keith Tkachuk,31,56,55,LW,2002
19858,38,31,Keith Tkachuk,33,75,71,LW,2003
19859,21,33,Keith Tkachuk,15,41,36,LW,2005
19860,31,34,Keith Tkachuk,27,79,58,LW,2006
19861,31,35,Keith Tkachuk,27,79,58,C,2007
19862,24,36,Keith Tkachuk,25,79,49,LW,2008
19863,19,37,Keith Tkachuk,13,67,32,LW,2009
19864,0,23,Keith Wright,0,1,0,LW,1967
19865,2,20,Keith Yandle,0,7,2,D,2006
19866,7,21,Keith Yandle,5,43,12,D,2007
19867,26,22,Keith Yandle,4,69,30,D,2008
19868,29,23,Keith Yandle,12,82,41,D,2009
19869,48,24,Keith Yandle,11,82,59,D,2010
19870,32,25,Keith Yandle,11,82,43,D,2011
19871,20,26,Keith Yandle,10,48,30,D,2012
19872,45,27,Keith Yandle,8,82,53,D,2013
19873,46,28,Keith Yandle,6,84,52,D,2014
19874,42,29,Keith Yandle,5,82,47,D,2015
19875,36,30,Keith Yandle,5,82,41,D,2016
19876,48,31,Keith Yandle,8,82,56,D,2017
19877,0,24,Kellan Lain,1,9,1,LW,2013
19878,0,21,Kelly Buchberger,1,19,1,LW,1987
19879,9,22,Kelly Buchberger,5,66,14,LW,1988
19880,6,23,Kelly Buchberger,2,55,8,LW,1989
19881,1,24,Kelly Buchberger,3,64,4,LW,1990
19882,24,25,Kelly Buchberger,20,79,44,LW,1991
19883,18,26,Kelly Buchberger,12,83,30,RW,1992
19884,18,27,Kelly Buchberger,3,84,21,RW,1993
19885,17,28,Kelly Buchberger,7,48,24,RW,1994
19886,14,29,Kelly Buchberger,11,82,25,RW,1995
19887,30,30,Kelly Buchberger,8,81,38,RW,1996
19888,17,31,Kelly Buchberger,6,82,23,RW,1997
19889,4,32,Kelly Buchberger,4,52,8,RW,1998
19890,13,33,Kelly Buchberger,7,81,20,LW,1999
19891,14,34,Kelly Buchberger,6,82,20,LW,2000
19892,7,35,Kelly Buchberger,6,74,13,LW,2001
19893,9,36,Kelly Buchberger,3,79,12,LW,2002
19894,3,37,Kelly Buchberger,1,71,4,C,2003
19895,3,22,Kelly Chase,1,43,4,RW,1989
19896,0,23,Kelly Chase,1,2,1,RW,1990
19897,2,24,Kelly Chase,1,46,3,RW,1991
19898,5,25,Kelly Chase,2,49,7,RW,1992
19899,5,26,Kelly Chase,2,68,7,RW,1993
19900,4,27,Kelly Chase,0,28,4,RW,1994
19901,4,28,Kelly Chase,2,55,6,RW,1995
19902,2,29,Kelly Chase,1,30,3,RW,1996
19903,3,30,Kelly Chase,4,67,7,RW,1997
19904,7,31,Kelly Chase,3,45,10,RW,1998
19905,1,32,Kelly Chase,0,25,1,RW,1999
19906,1,20,Kelly Davis,0,18,1,RW,1978
19907,1,20,Kelly Davis,0,18,1,RW,1978
19908,1,22,Kelly Fairchild,0,1,1,C,1995
19909,2,23,Kelly Fairchild,0,22,2,C,1996
19910,0,25,Kelly Fairchild,0,1,0,C,1998
19911,0,28,Kelly Fairchild,2,10,2,C,2001
19912,3,23,Kelly Kisio,4,15,7,C,1982
19913,37,24,Kelly Kisio,23,70,60,C,1983
19914,41,25,Kelly Kisio,20,75,61,C,1984
19915,48,26,Kelly Kisio,21,76,69,C,1985
19916,40,27,Kelly Kisio,24,70,64,C,1986
19917,55,28,Kelly Kisio,23,77,78,C,1987
19918,36,29,Kelly Kisio,26,70,62,C,1988
19919,44,30,Kelly Kisio,22,68,66,C,1989
19920,20,31,Kelly Kisio,15,51,35,C,1990
19921,26,32,Kelly Kisio,11,48,37,C,1991
19922,52,33,Kelly Kisio,26,78,78,C,1992
19923,23,34,Kelly Kisio,7,51,30,C,1993
19924,4,35,Kelly Kisio,7,12,11,C,1994
19925,2,21,Kelly Miller,0,5,2,LW,1984
19926,20,22,Kelly Miller,13,74,33,LW,1985
19927,26,23,Kelly Miller,16,77,42,LW,1986
19928,23,24,Kelly Miller,9,80,32,C,1987
19929,21,25,Kelly Miller,19,78,40,LW,1988
19930,22,26,Kelly Miller,18,80,40,LW,1989
19931,26,27,Kelly Miller,24,80,50,LW,1990
19932,38,28,Kelly Miller,14,78,52,LW,1991
19933,27,29,Kelly Miller,18,84,45,LW,1992
19934,25,30,Kelly Miller,14,84,39,LW,1993
19935,13,31,Kelly Miller,10,48,23,RW,1994
19936,13,32,Kelly Miller,7,74,20,RW,1995
19937,14,33,Kelly Miller,10,77,24,RW,1996
19938,7,34,Kelly Miller,7,76,14,RW,1997
19939,5,35,Kelly Miller,2,62,7,LW,1998
19940,6,20,Kelly Pratt,4,46,10,RW,1973
19941,6,20,Kelly Pratt,4,46,10,RW,1973
19942,6,21,Kelly Pratt,0,22,6,RW,1974
19943,2,20,Ken Baird,0,10,2,LW,1971
19944,15,21,Ken Baird,14,75,29,D,1972
19945,15,21,Ken Baird,14,75,29,D,1972
19946,19,22,Ken Baird,17,68,36,D,1973
19947,19,22,Ken Baird,17,68,36,D,1973
19948,28,23,Ken Baird,30,77,58,D,1974
19949,28,23,Ken Baird,30,77,58,D,1974
19950,24,24,Ken Baird,13,48,37,LW,1975
19951,24,24,Ken Baird,13,48,37,LW,1975
19952,2,25,Ken Baird,1,9,3,D,1976
19953,0,25,Ken Baird,0,7,0,D,1976
19954,2,25,Ken Baird,1,2,3,D,1976
19955,2,25,Ken Baird,1,9,3,D,1976
19956,0,25,Ken Baird,0,7,0,D,1976
19957,2,25,Ken Baird,1,2,3,D,1976
19958,11,26,Ken Baird,16,55,27,LW,1977
19959,7,26,Ken Baird,14,49,21,LW,1977
19960,4,26,Ken Baird,2,6,6,LW,1977
19961,11,26,Ken Baird,16,55,27,LW,1977
19962,7,26,Ken Baird,14,49,21,LW,1977
19963,4,26,Ken Baird,2,6,6,LW,1977
19964,3,21,Ken Baumgartner,2,30,5,D,1987
19965,3,22,Ken Baumgartner,1,49,4,D,1988
19966,5,23,Ken Baumgartner,1,65,6,D,1989
19967,6,24,Ken Baumgartner,1,78,7,LW,1990
19968,1,25,Ken Baumgartner,0,55,1,LW,1991
19969,0,26,Ken Baumgartner,1,63,1,LW,1992
19970,4,27,Ken Baumgartner,4,64,8,LW,1993
19971,0,28,Ken Baumgartner,0,2,0,LW,1994
19972,4,29,Ken Baumgartner,2,72,6,LW,1995
19973,11,30,Ken Baumgartner,0,67,11,LW,1996
19974,1,31,Ken Baumgartner,0,82,1,LW,1997
19975,3,32,Ken Baumgartner,1,69,4,LW,1998
19976,0,20,Ken Belanger,0,3,0,LW,1994
19977,0,21,Ken Belanger,0,7,0,LW,1995
19978,2,22,Ken Belanger,0,18,2,LW,1996
19979,1,23,Ken Belanger,3,37,4,LW,1997
19980,5,24,Ken Belanger,2,54,7,LW,1998
19981,2,25,Ken Belanger,2,37,4,LW,1999
19982,2,26,Ken Belanger,2,40,4,LW,2000
19983,0,27,Ken Belanger,2,43,2,LW,2001
19984,0,28,Ken Belanger,0,4,0,LW,2002
19985,0,31,Ken Belanger,0,5,0,LW,2005
19986,3,21,Ken Berry,2,15,5,LW,1981
19987,3,23,Ken Berry,2,13,5,LW,1983
19988,3,27,Ken Berry,2,14,5,RW,1987
19989,1,28,Ken Berry,2,13,3,LW,1988
19990,0,26,Ken Block,0,1,0,D,1970
19991,53,28,Ken Block,5,78,58,D,1972
19992,53,28,Ken Block,5,78,58,D,1972
19993,43,29,Ken Block,3,74,46,D,1973
19994,43,29,Ken Block,3,74,46,D,1973
19995,28,30,Ken Block,1,73,29,D,1974
19996,17,30,Ken Block,0,37,17,D,1974
19997,11,30,Ken Block,1,36,12,D,1974
19998,28,30,Ken Block,1,73,29,D,1974
19999,17,30,Ken Block,0,37,17,D,1974
20000,11,30,Ken Block,1,36,12,D,1974
20001,25,31,Ken Block,1,79,26,D,1975
20002,25,31,Ken Block,1,79,26,D,1975
20003,10,32,Ken Block,3,52,13,D,1976
20004,10,32,Ken Block,3,52,13,D,1976
20005,25,33,Ken Block,1,77,26,D,1977
20006,25,33,Ken Block,1,77,26,D,1977
20007,3,34,Ken Block,2,22,5,D,1978
20008,3,34,Ken Block,2,22,5,D,1978
20009,0,21,Ken Breitenbach,0,7,0,D,1975
20010,5,22,Ken Breitenbach,0,31,5,D,1976
20011,8,24,Ken Breitenbach,1,30,9,D,1978
20012,4,19,Ken Daneyko,1,11,5,D,1983
20013,0,20,Ken Daneyko,0,1,0,D,1984
20014,10,21,Ken Daneyko,0,44,10,D,1985
20015,12,22,Ken Daneyko,2,79,14,D,1986
20016,7,23,Ken Daneyko,5,80,12,D,1987
20017,5,24,Ken Daneyko,5,80,10,D,1988
20018,15,25,Ken Daneyko,6,74,21,D,1989
20019,16,26,Ken Daneyko,4,80,20,D,1990
20020,7,27,Ken Daneyko,1,80,8,D,1991
20021,11,28,Ken Daneyko,2,84,13,D,1992
20022,9,29,Ken Daneyko,1,78,10,D,1993
20023,2,30,Ken Daneyko,1,25,3,D,1994
20024,4,31,Ken Daneyko,2,80,6,D,1995
20025,7,32,Ken Daneyko,2,77,9,D,1996
20026,1,33,Ken Daneyko,0,37,1,D,1997
20027,9,34,Ken Daneyko,2,82,11,D,1998
20028,6,35,Ken Daneyko,0,78,6,D,1999
20029,4,36,Ken Daneyko,0,77,4,D,2000
20030,6,37,Ken Daneyko,0,67,6,D,2001
20031,7,38,Ken Daneyko,2,69,9,D,2002
20032,6,25,Ken Desjardine,2,37,8,D,1972
20033,6,25,Ken Desjardine,2,37,8,D,1972
20034,10,26,Ken Desjardine,2,70,12,D,1973
20035,8,27,Ken Desjardine,0,46,8,D,1974
20036,0,28,Ken Desjardine,0,1,0,D,1975
20037,0,28,Ken Desjardine,0,1,0,D,1975
20038,0,24,Ken Duggan,0,1,0,D,1987
20039,3,26,Ken Gernander,2,10,5,RW,1995
20040,0,34,Ken Gernander,0,2,0,RW,2003
20041,0,21,Ken Hammond,1,3,1,D,1984
20042,1,22,Ken Hammond,0,3,1,D,1985
20043,2,23,Ken Hammond,0,10,2,D,1986
20044,9,24,Ken Hammond,7,46,16,D,1987
20045,3,25,Ken Hammond,0,22,3,D,1988
20046,0,27,Ken Hammond,1,1,1,D,1990
20047,10,28,Ken Hammond,5,46,15,D,1991
20048,4,29,Ken Hammond,4,62,8,D,1992
20049,31,23,Ken Hodge,25,74,56,RW,1967
20050,45,24,Ken Hodge,45,75,90,RW,1968
20051,29,25,Ken Hodge,25,72,54,RW,1969
20052,62,26,Ken Hodge,43,78,105,RW,1970
20053,40,27,Ken Hodge,16,60,56,RW,1971
20054,44,28,Ken Hodge,37,73,81,RW,1972
20055,55,29,Ken Hodge,50,76,105,RW,1973
20056,43,30,Ken Hodge,23,72,66,RW,1974
20057,36,31,Ken Hodge,25,72,61,RW,1975
20058,41,32,Ken Hodge,21,78,62,RW,1976
20059,4,33,Ken Hodge,2,18,6,RW,1977
20060,1,22,Ken Hodge,1,5,2,C,1988
20061,29,24,Ken Hodge,30,70,59,C,1990
20062,11,25,Ken Hodge,6,42,17,C,1991
20063,7,26,Ken Hodge,2,25,9,C,1992
20064,6,22,Ken Houston,5,38,11,RW,1975
20065,24,23,Ken Houston,20,78,44,RW,1976
20066,16,24,Ken Houston,22,74,38,RW,1977
20067,31,25,Ken Houston,21,80,52,RW,1978
20068,31,26,Ken Houston,23,80,54,RW,1979
20069,15,27,Ken Houston,15,42,30,RW,1980
20070,22,28,Ken Houston,22,70,44,RW,1981
20071,14,29,Ken Houston,25,71,39,RW,1982
20072,8,30,Ken Houston,8,37,16,RW,1983
20073,1,23,Ken Klee,3,23,4,D,1994
20074,3,24,Ken Klee,8,66,11,RW,1995
20075,8,25,Ken Klee,3,80,11,RW,1996
20076,2,26,Ken Klee,4,51,6,RW,1997
20077,13,27,Ken Klee,7,78,20,RW,1998
20078,13,28,Ken Klee,7,80,20,D,1999
20079,4,29,Ken Klee,2,54,6,D,2000
20080,8,30,Ken Klee,8,68,16,D,2001
20081,16,31,Ken Klee,1,70,17,D,2002
20082,25,32,Ken Klee,4,66,29,D,2003
20083,12,34,Ken Klee,3,74,15,D,2005
20084,16,35,Ken Klee,3,81,19,D,2006
20085,9,36,Ken Klee,1,72,10,D,2007
20086,10,37,Ken Klee,1,71,11,D,2008
20087,5,23,Ken Kuzyk,0,13,5,RW,1976
20088,4,24,Ken Kuzyk,5,28,9,RW,1977
20089,2,23,Ken Leiter,0,5,2,D,1984
20090,1,24,Ken Leiter,1,9,2,D,1985
20091,20,25,Ken Leiter,9,74,29,D,1986
20092,13,26,Ken Leiter,4,51,17,D,1987
20093,0,28,Ken Leiter,0,4,0,D,1989
20094,38,19,Ken Linseman,38,71,76,C,1977
20095,38,19,Ken Linseman,38,71,76,C,1977
20096,20,20,Ken Linseman,5,30,25,C,1978
20097,57,21,Ken Linseman,22,80,79,C,1979
20098,30,22,Ken Linseman,17,51,47,C,1980
20099,68,23,Ken Linseman,24,79,92,C,1981
20100,42,24,Ken Linseman,33,72,75,C,1982
20101,49,25,Ken Linseman,18,72,67,C,1983
20102,49,26,Ken Linseman,25,74,74,C,1984
20103,58,27,Ken Linseman,23,64,81,C,1985
20104,34,28,Ken Linseman,15,64,49,C,1986
20105,45,29,Ken Linseman,29,77,74,C,1987
20106,45,30,Ken Linseman,27,78,72,C,1988
20107,25,31,Ken Linseman,11,61,36,C,1989
20108,29,32,Ken Linseman,7,56,36,C,1990
20109,0,33,Ken Linseman,0,2,0,C,1991
20110,0,24,Ken Lovsin,0,1,0,D,1990
20111,0,22,Ken Mann,0,1,0,RW,1975
20112,0,19,Ken McRae,0,1,0,C,1987
20113,11,20,Ken McRae,6,37,17,C,1988
20114,8,21,Ken McRae,7,66,15,RW,1989
20115,0,22,Ken McRae,0,12,0,C,1990
20116,1,23,Ken McRae,0,10,1,C,1991
20117,0,24,Ken McRae,0,2,0,C,1992
20118,1,25,Ken McRae,1,9,2,C,1993
20119,3,23,Ken Morrow,0,18,3,D,1979
20120,11,24,Ken Morrow,2,80,13,D,1980
20121,18,25,Ken Morrow,1,75,19,D,1981
20122,11,26,Ken Morrow,5,79,16,D,1982
20123,11,27,Ken Morrow,3,63,14,D,1983
20124,7,28,Ken Morrow,1,15,8,D,1984
20125,12,29,Ken Morrow,0,69,12,D,1985
20126,8,30,Ken Morrow,3,64,11,D,1986
20127,4,31,Ken Morrow,1,53,5,D,1987
20128,3,32,Ken Morrow,1,34,4,D,1988
20129,1,22,Ken Murray,0,1,1,D,1969
20130,0,23,Ken Murray,0,4,0,D,1970
20131,5,25,Ken Murray,1,70,6,D,1972
20132,2,27,Ken Murray,0,8,2,D,1974
20133,2,28,Ken Murray,0,23,2,D,1975
20134,6,19,Ken Priestlay,11,34,17,C,1986
20135,12,20,Ken Priestlay,5,33,17,C,1987
20136,0,21,Ken Priestlay,2,15,2,C,1988
20137,7,22,Ken Priestlay,7,35,14,C,1989
20138,1,23,Ken Priestlay,0,2,1,C,1990
20139,8,24,Ken Priestlay,2,49,10,C,1991
20140,7,21,Ken Quinney,2,25,9,RW,1986
20141,2,22,Ken Quinney,2,15,4,RW,1987
20142,4,25,Ken Quinney,3,19,7,RW,1990
20143,7,23,Ken Richardson,5,21,12,C,1974
20144,5,26,Ken Richardson,2,12,7,C,1977
20145,1,27,Ken Richardson,1,16,2,C,1978
20146,1,22,Ken Sabourin,0,6,1,D,1988
20147,0,23,Ken Sabourin,0,5,0,D,1989
20148,7,24,Ken Sabourin,2,44,9,D,1990
20149,0,25,Ken Sabourin,0,19,0,D,1991
20150,25,35,Ken Schinkel,14,57,39,RW,1967
20151,34,36,Ken Schinkel,18,76,52,RW,1968
20152,25,37,Ken Schinkel,20,72,45,RW,1969
20153,19,38,Ken Schinkel,15,50,34,RW,1970
20154,30,39,Ken Schinkel,15,74,45,RW,1971
20155,10,40,Ken Schinkel,11,42,21,RW,1972
20156,1,19,Ken Solheim,4,10,5,LW,1980
20157,5,20,Ken Solheim,4,29,9,LW,1981
20158,4,21,Ken Solheim,2,35,6,LW,1982
20159,10,23,Ken Solheim,8,55,18,LW,1984
20160,0,24,Ken Solheim,1,6,1,LW,1985
20161,16,31,Ken Stephanson,3,77,19,D,1972
20162,16,31,Ken Stephanson,3,77,19,D,1972
20163,7,32,Ken Stephanson,0,29,7,D,1973
20164,7,32,Ken Stephanson,0,29,7,D,1973
20165,0,19,Ken Strong,0,2,0,LW,1982
20166,2,20,Ken Strong,0,2,2,LW,1983
20167,0,21,Ken Strong,2,11,2,LW,1984
20168,6,21,Ken Sutton,3,15,9,D,1990
20169,18,22,Ken Sutton,2,64,20,D,1991
20170,14,23,Ken Sutton,8,63,22,D,1992
20171,20,24,Ken Sutton,4,78,24,D,1993
20172,3,25,Ken Sutton,4,24,7,D,1994
20173,8,26,Ken Sutton,0,38,8,D,1995
20174,0,28,Ken Sutton,0,21,0,D,1997
20175,0,29,Ken Sutton,1,5,1,D,1998
20176,2,30,Ken Sutton,0,6,2,D,1999
20177,7,31,Ken Sutton,1,53,8,D,2000
20178,2,32,Ken Sutton,0,21,2,D,2001
20179,7,20,Ken Yaremchuk,6,47,13,C,1983
20180,16,21,Ken Yaremchuk,10,63,26,RW,1984
20181,20,22,Ken Yaremchuk,14,78,34,RW,1985
20182,8,23,Ken Yaremchuk,3,20,11,RW,1986
20183,5,24,Ken Yaremchuk,2,16,7,C,1987
20184,0,25,Ken Yaremchuk,1,11,1,C,1988
20185,0,22,Kenndal McArdle,0,3,0,LW,2008
20186,2,23,Kenndal McArdle,1,19,3,LW,2009
20187,0,24,Kenndal McArdle,0,11,0,LW,2010
20188,0,25,Kenndal McArdle,0,9,0,LW,2011
20189,1,21,Kenny Agostino,1,8,2,LW,2013
20190,0,23,Kenny Agostino,0,2,0,LW,2015
20191,2,24,Kenny Agostino,1,7,3,LW,2016
20192,1,25,Kenny Agostino,0,5,1,LW,2017
20193,7,20,Kenny Jonsson,2,39,9,D,1994
20194,26,21,Kenny Jonsson,4,66,30,D,1995
20195,18,22,Kenny Jonsson,3,81,21,D,1996
20196,26,23,Kenny Jonsson,14,81,40,D,1997
20197,18,24,Kenny Jonsson,8,63,26,D,1998
20198,24,25,Kenny Jonsson,1,65,25,D,1999
20199,21,26,Kenny Jonsson,8,65,29,D,2000
20200,22,27,Kenny Jonsson,10,76,32,D,2001
20201,18,28,Kenny Jonsson,8,71,26,D,2002
20202,24,29,Kenny Jonsson,5,79,29,D,2003
20203,42,34,Kenny Wharram,27,74,69,RW,1967
20204,39,35,Kenny Wharram,30,76,69,RW,1968
20205,7,22,Kent Carlson,3,65,10,D,1983
20206,1,23,Kent Carlson,1,18,2,D,1984
20207,3,24,Kent Carlson,2,28,5,D,1985
20208,0,27,Kent Carlson,1,2,1,D,1988
20209,21,31,Kent Douglas,11,76,32,D,1967
20210,29,32,Kent Douglas,2,69,31,D,1968
20211,15,36,Kent Douglas,3,60,18,D,1972
20212,15,36,Kent Douglas,3,60,18,D,1972
20213,3,27,Kent Huskins,0,33,3,D,2006
20214,15,28,Kent Huskins,4,76,19,D,2007
20215,4,29,Kent Huskins,2,33,6,D,2008
20216,19,30,Kent Huskins,3,82,22,D,2009
20217,8,31,Kent Huskins,2,50,10,D,2010
20218,5,32,Kent Huskins,2,25,7,D,2011
20219,1,33,Kent Huskins,0,19,1,D,2012
20220,4,20,Kent Manderville,0,15,4,LW,1991
20221,1,21,Kent Manderville,1,18,2,LW,1992
20222,9,22,Kent Manderville,7,67,16,LW,1993
20223,1,23,Kent Manderville,0,36,1,LW,1994
20224,5,24,Kent Manderville,3,37,8,LW,1995
20225,5,25,Kent Manderville,6,44,11,C,1996
20226,4,26,Kent Manderville,4,77,8,C,1997
20227,11,27,Kent Manderville,5,81,16,LW,1998
20228,7,28,Kent Manderville,1,69,8,C,1999
20229,10,29,Kent Manderville,5,82,15,C,2000
20230,5,30,Kent Manderville,3,38,8,C,2001
20231,5,31,Kent Manderville,2,82,7,C,2002
20232,0,23,Kent McDonell,0,3,0,RW,2002
20233,2,24,Kent McDonell,1,29,3,LW,2003
20234,65,21,Kent Nilsson,42,80,107,C,1977
20235,68,22,Kent Nilsson,39,78,107,C,1978
20236,68,22,Kent Nilsson,39,78,107,C,1978
20237,53,23,Kent Nilsson,40,80,93,C,1979
20238,82,24,Kent Nilsson,49,80,131,C,1980
20239,29,25,Kent Nilsson,26,41,55,C,1981
20240,58,26,Kent Nilsson,46,80,104,C,1982
20241,49,27,Kent Nilsson,31,67,80,C,1983
20242,62,28,Kent Nilsson,37,77,99,RW,1984
20243,44,29,Kent Nilsson,16,61,60,C,1985
20244,45,30,Kent Nilsson,18,61,63,RW,1986
20245,0,38,Kent Nilsson,1,6,1,C,1994
20246,0,22,Kent Paynter,0,2,0,D,1987
20247,0,23,Kent Paynter,0,1,0,D,1988
20248,2,24,Kent Paynter,1,13,3,D,1989
20249,0,25,Kent Paynter,0,1,0,D,1990
20250,0,26,Kent Paynter,0,5,0,D,1991
20251,0,27,Kent Paynter,0,6,0,D,1992
20252,1,28,Kent Paynter,0,9,1,D,1993
20253,1,23,Kent Ruhnke,0,2,1,RW,1975
20254,11,24,Kent Ruhnke,11,51,22,RW,1976
20255,11,24,Kent Ruhnke,11,51,22,RW,1976
20256,9,25,Kent Ruhnke,8,21,17,RW,1977
20257,18,26,Kent-Erik Andersson,15,73,33,RW,1977
20258,4,27,Kent-Erik Andersson,9,41,13,RW,1978
20259,10,28,Kent-Erik Andersson,9,61,19,RW,1979
20260,24,29,Kent-Erik Andersson,17,77,41,RW,1980
20261,12,30,Kent-Erik Andersson,9,70,21,RW,1981
20262,20,31,Kent-Erik Andersson,8,71,28,RW,1982
20263,15,32,Kent-Erik Andersson,5,63,20,RW,1983
20264,3,20,Kerby Rychel,0,5,3,LW,2014
20265,7,21,Kerby Rychel,2,32,9,LW,2015
20266,1,23,Kerby Rychel,1,4,2,LW,2017
20267,15,29,Kerry Bond,22,71,37,LW,1974
20268,15,29,Kerry Bond,22,71,37,LW,1974
20269,0,30,Kerry Bond,2,15,2,LW,1975
20270,0,30,Kerry Bond,2,15,2,LW,1975
20271,0,19,Kerry Huffman,0,9,0,D,1986
20272,17,20,Kerry Huffman,6,52,23,D,1987
20273,11,21,Kerry Huffman,0,29,11,D,1988
20274,12,22,Kerry Huffman,1,43,13,D,1989
20275,2,23,Kerry Huffman,1,10,3,D,1990
20276,18,24,Kerry Huffman,14,60,32,D,1991
20277,18,25,Kerry Huffman,4,52,22,D,1992
20278,14,26,Kerry Huffman,4,62,18,D,1993
20279,4,27,Kerry Huffman,2,37,6,D,1994
20280,12,28,Kerry Huffman,5,47,17,D,1995
20281,2,25,Kerry Ketter,0,41,2,D,1972
20282,9,28,Kerry Ketter,1,48,10,D,1975
20283,9,28,Kerry Ketter,1,48,10,D,1975
20284,4,21,Kevan Guy,0,24,4,D,1986
20285,3,22,Kevan Guy,0,11,3,D,1987
20286,2,23,Kevan Guy,2,45,4,D,1988
20287,5,24,Kevan Guy,2,30,7,D,1989
20288,6,25,Kevan Guy,1,43,7,D,1990
20289,0,26,Kevan Guy,0,3,0,D,1991
20290,5,26,Kevan Miller,1,47,6,D,2013
20291,5,27,Kevan Miller,2,41,7,D,2014
20292,13,28,Kevan Miller,5,71,18,D,2015
20293,10,29,Kevan Miller,3,58,13,D,2016
20294,15,30,Kevan Miller,1,68,16,D,2017
20295,22,24,Kevin Ahearn,20,78,42,LW,1972
20296,22,24,Kevin Ahearn,20,78,42,LW,1972
20297,6,24,Kevin Bieksa,0,39,6,D,2005
20298,30,25,Kevin Bieksa,12,81,42,D,2006
20299,10,26,Kevin Bieksa,2,34,12,D,2007
20300,32,27,Kevin Bieksa,11,72,43,D,2008
20301,19,28,Kevin Bieksa,3,55,22,D,2009
20302,16,29,Kevin Bieksa,6,66,22,D,2010
20303,36,30,Kevin Bieksa,8,78,44,D,2011
20304,6,31,Kevin Bieksa,6,36,12,D,2012
20305,20,32,Kevin Bieksa,4,76,24,D,2013
20306,10,33,Kevin Bieksa,4,60,14,D,2014
20307,11,34,Kevin Bieksa,4,71,15,D,2015
20308,11,35,Kevin Bieksa,3,81,14,D,2016
20309,8,36,Kevin Bieksa,0,59,8,D,2017
20310,3,20,Kevin Brown,2,23,5,RW,1994
20311,0,21,Kevin Brown,1,7,1,RW,1995
20312,4,22,Kevin Brown,0,11,4,RW,1996
20313,0,23,Kevin Brown,0,4,0,RW,1997
20314,2,24,Kevin Brown,4,12,6,RW,1998
20315,0,25,Kevin Brown,0,7,0,RW,1999
20316,0,27,Kevin Colley,0,16,0,C,2005
20317,7,23,Kevin Connauton,1,36,8,D,2013
20318,12,24,Kevin Connauton,9,62,21,D,2014
20319,12,25,Kevin Connauton,5,65,17,D,2015
20320,1,26,Kevin Connauton,0,24,1,D,2016
20321,10,27,Kevin Connauton,11,73,21,D,2017
20322,2,23,Kevin Czuczman,0,13,2,D,2013
20323,9,24,Kevin Dahl,2,61,11,D,1992
20324,3,25,Kevin Dahl,0,33,3,D,1993
20325,8,26,Kevin Dahl,4,34,12,D,1994
20326,1,27,Kevin Dahl,1,32,2,D,1995
20327,0,28,Kevin Dahl,0,2,0,D,1996
20328,1,29,Kevin Dahl,0,19,1,D,1997
20329,0,30,Kevin Dahl,0,3,0,D,1998
20330,0,32,Kevin Dahl,0,4,0,D,2000
20331,10,24,Kevin Dallman,4,67,14,D,2005
20332,9,25,Kevin Dallman,1,53,10,D,2006
20333,4,26,Kevin Dallman,3,34,7,D,2007
20334,1,25,Kevin Dean,0,17,1,D,1994
20335,6,26,Kevin Dean,0,41,6,D,1995
20336,4,27,Kevin Dean,2,28,6,D,1996
20337,8,28,Kevin Dean,1,50,9,D,1997
20338,10,29,Kevin Dean,1,62,11,D,1998
20339,8,30,Kevin Dean,3,64,11,D,1999
20340,11,31,Kevin Dean,0,69,11,D,2000
20341,10,20,Kevin Devine,4,46,14,LW,1974
20342,10,20,Kevin Devine,4,46,14,LW,1974
20343,28,21,Kevin Devine,21,80,49,LW,1975
20344,28,21,Kevin Devine,21,80,49,LW,1975
20345,20,22,Kevin Devine,30,81,50,LW,1976
20346,20,22,Kevin Devine,30,81,50,LW,1976
20347,23,23,Kevin Devine,19,76,42,LW,1977
20348,23,23,Kevin Devine,19,76,42,LW,1977
20349,0,24,Kevin Devine,0,5,0,LW,1978
20350,0,24,Kevin Devine,0,5,0,LW,1978
20351,1,28,Kevin Devine,0,2,1,LW,1982
20352,16,21,Kevin Dineen,25,57,41,RW,1984
20353,35,22,Kevin Dineen,33,57,68,RW,1985
20354,39,23,Kevin Dineen,40,78,79,RW,1986
20355,25,24,Kevin Dineen,25,74,50,RW,1987
20356,44,25,Kevin Dineen,45,79,89,RW,1988
20357,41,26,Kevin Dineen,25,67,66,RW,1989
20358,30,27,Kevin Dineen,17,61,47,RW,1990
20359,32,28,Kevin Dineen,30,80,62,RW,1991
20360,28,29,Kevin Dineen,35,83,63,RW,1992
20361,23,30,Kevin Dineen,19,71,42,RW,1993
20362,5,31,Kevin Dineen,8,40,13,RW,1994
20363,9,32,Kevin Dineen,2,46,11,RW,1995
20364,29,33,Kevin Dineen,19,78,48,RW,1996
20365,16,34,Kevin Dineen,7,54,23,RW,1997
20366,10,35,Kevin Dineen,8,67,18,RW,1998
20367,8,36,Kevin Dineen,4,67,12,RW,1999
20368,7,37,Kevin Dineen,8,66,15,RW,2000
20369,8,38,Kevin Dineen,5,59,13,RW,2001
20370,0,39,Kevin Dineen,0,4,0,RW,2002
20371,1,28,Kevin Doell,0,8,1,C,2007
20372,0,25,Kevin Evans,0,4,0,LW,1990
20373,1,26,Kevin Evans,0,5,1,LW,1991
20374,0,18,Kevin Fiala,0,1,0,LW,2014
20375,0,19,Kevin Fiala,1,5,1,LW,2015
20376,5,20,Kevin Fiala,11,54,16,LW,2016
20377,25,21,Kevin Fiala,23,80,48,LW,2017
20378,0,23,Kevin Gravel,0,5,0,D,2015
20379,6,24,Kevin Gravel,1,49,7,D,2016
20380,3,25,Kevin Gravel,0,16,3,D,2017
20381,0,19,Kevin Haller,0,2,0,D,1989
20382,8,20,Kevin Haller,1,21,9,D,1990
20383,17,21,Kevin Haller,8,66,25,D,1991
20384,14,22,Kevin Haller,11,73,25,D,1992
20385,9,23,Kevin Haller,4,68,13,D,1993
20386,8,24,Kevin Haller,2,36,10,D,1994
20387,9,25,Kevin Haller,5,69,14,D,1995
20388,11,26,Kevin Haller,2,62,13,D,1996
20389,5,27,Kevin Haller,3,65,8,D,1997
20390,6,28,Kevin Haller,1,82,7,D,1998
20391,5,29,Kevin Haller,3,67,8,D,1999
20392,5,30,Kevin Haller,1,30,6,D,2000
20393,0,31,Kevin Haller,0,1,0,D,2001
20394,0,18,Kevin Hatcher,1,2,1,D,1984
20395,10,19,Kevin Hatcher,9,79,19,D,1985
20396,16,20,Kevin Hatcher,8,78,24,D,1986
20397,27,21,Kevin Hatcher,14,71,41,D,1987
20398,27,22,Kevin Hatcher,13,62,40,D,1988
20399,41,23,Kevin Hatcher,13,80,54,D,1989
20400,50,24,Kevin Hatcher,24,79,74,D,1990
20401,37,25,Kevin Hatcher,17,79,54,D,1991
20402,45,26,Kevin Hatcher,34,83,79,D,1992
20403,24,27,Kevin Hatcher,16,72,40,D,1993
20404,19,28,Kevin Hatcher,10,47,29,D,1994
20405,26,29,Kevin Hatcher,15,74,41,D,1995
20406,39,30,Kevin Hatcher,15,80,54,D,1996
20407,29,31,Kevin Hatcher,19,74,48,D,1997
20408,27,32,Kevin Hatcher,11,66,38,D,1998
20409,19,33,Kevin Hatcher,4,74,23,D,1999
20410,14,34,Kevin Hatcher,4,57,18,D,2000
20411,28,22,Kevin Hayes,17,79,45,RW,2014
20412,22,23,Kevin Hayes,14,79,36,RW,2015
20413,32,24,Kevin Hayes,17,76,49,RW,2016
20414,19,25,Kevin Hayes,25,76,44,RW,2017
20415,0,26,Kevin Henderson,1,4,1,LW,2012
20416,0,19,Kevin Kaminski,0,1,0,C,1988
20417,0,20,Kevin Kaminski,0,1,0,C,1989
20418,0,22,Kevin Kaminski,0,5,0,C,1991
20419,5,24,Kevin Kaminski,0,13,5,RW,1993
20420,1,25,Kevin Kaminski,1,27,2,C,1994
20421,2,26,Kevin Kaminski,1,54,3,LW,1995
20422,2,27,Kevin Kaminski,1,38,3,C,1996
20423,0,26,Kevin Kemp,0,3,0,D,1980
20424,0,21,Kevin Klein,0,2,0,D,2005
20425,0,22,Kevin Klein,1,3,1,D,2006
20426,2,23,Kevin Klein,0,13,2,D,2007
20427,8,24,Kevin Klein,4,63,12,D,2008
20428,10,25,Kevin Klein,1,81,11,D,2009
20429,16,26,Kevin Klein,2,81,18,D,2010
20430,17,27,Kevin Klein,4,66,21,D,2011
20431,11,28,Kevin Klein,3,47,14,D,2012
20432,7,29,Kevin Klein,2,77,9,D,2013
20433,17,30,Kevin Klein,9,65,26,D,2014
20434,17,31,Kevin Klein,9,69,26,D,2015
20435,11,32,Kevin Klein,3,60,14,D,2016
20436,0,20,Kevin Krook,0,3,0,D,1978
20444,12,21,Kevin Labanc,8,55,20,RW,2016
20445,29,22,Kevin Labanc,11,77,40,RW,2017
20437,20,19,Kevin LaVallee,15,77,35,LW,1980
20438,29,20,Kevin LaVallee,32,75,61,LW,1981
20439,16,21,Kevin LaVallee,19,60,35,LW,1982
20440,3,22,Kevin LaVallee,3,19,6,LW,1983
20441,17,23,Kevin LaVallee,15,38,32,LW,1984
20442,20,24,Kevin LaVallee,18,64,38,LW,1985
20443,20,25,Kevin LaVallee,8,33,28,LW,1986
20446,19,20,Kevin Lowe,2,64,21,D,1979
20447,24,21,Kevin Lowe,10,79,34,D,1980
20448,31,22,Kevin Lowe,9,80,40,D,1981
20449,34,23,Kevin Lowe,6,80,40,D,1982
20450,42,24,Kevin Lowe,4,80,46,D,1983
20451,21,25,Kevin Lowe,4,80,25,D,1984
20452,16,26,Kevin Lowe,2,74,18,D,1985
20453,29,27,Kevin Lowe,8,77,37,D,1986
20454,15,28,Kevin Lowe,9,70,24,D,1987
20455,18,29,Kevin Lowe,7,76,25,D,1988
20456,26,30,Kevin Lowe,7,78,33,D,1989
20457,13,31,Kevin Lowe,3,73,16,D,1990
20458,8,32,Kevin Lowe,2,55,10,D,1991
20459,12,33,Kevin Lowe,3,49,15,D,1992
20460,14,34,Kevin Lowe,5,71,19,D,1993
20461,7,35,Kevin Lowe,1,44,8,D,1994
20462,5,36,Kevin Lowe,1,53,6,D,1995
20463,13,37,Kevin Lowe,1,64,14,D,1996
20464,0,38,Kevin Lowe,0,7,0,D,1997
20465,0,27,Kevin MacDonald,0,1,0,D,1993
20466,0,24,Kevin Maguire,0,17,0,RW,1986
20467,6,25,Kevin Maguire,4,46,10,RW,1987
20468,10,26,Kevin Maguire,8,60,18,C,1988
20469,9,27,Kevin Maguire,7,66,16,RW,1989
20470,5,28,Kevin Maguire,9,63,14,RW,1990
20471,0,29,Kevin Maguire,1,8,1,RW,1991
20472,0,22,Kevin Marshall,0,10,0,D,2011
20473,3,20,Kevin Maxwell,0,6,3,C,1980
20474,9,21,Kevin Maxwell,6,46,15,C,1981
20475,3,23,Kevin Maxwell,0,14,3,C,1983
20476,15,20,Kevin McCarthy,2,62,17,D,1977
20477,2,21,Kevin McCarthy,1,23,3,D,1978
20478,30,22,Kevin McCarthy,15,79,45,D,1979
20479,37,23,Kevin McCarthy,16,80,53,D,1980
20480,39,24,Kevin McCarthy,6,71,45,D,1981
20481,28,25,Kevin McCarthy,12,74,40,D,1982
20482,30,26,Kevin McCarthy,6,78,36,D,1983
20483,10,27,Kevin McCarthy,9,64,19,RW,1984
20484,0,28,Kevin McCarthy,0,4,0,D,1985
20485,0,29,Kevin McCarthy,0,2,0,D,1986
20486,4,19,Kevin McClelland,1,10,5,RW,1981
20487,4,20,Kevin McClelland,5,38,9,RW,1982
20488,24,21,Kevin McClelland,10,76,34,C,1983
20489,15,22,Kevin McClelland,8,62,23,C,1984
20490,25,23,Kevin McClelland,11,79,36,C,1985
20491,13,24,Kevin McClelland,12,72,25,C,1986
20492,6,25,Kevin McClelland,10,74,16,RW,1987
20493,14,26,Kevin McClelland,6,79,20,C,1988
20494,6,27,Kevin McClelland,5,71,11,C,1989
20495,0,28,Kevin McClelland,0,3,0,RW,1990
20496,1,29,Kevin McClelland,0,18,1,RW,1991
20497,0,31,Kevin McClelland,0,6,0,RW,1993
20498,3,23,Kevin Miehm,1,8,4,C,1992
20499,1,24,Kevin Miehm,0,14,1,C,1993
20500,5,23,Kevin Miller,3,24,8,RW,1988
20501,5,24,Kevin Miller,0,16,5,C,1989
20502,29,25,Kevin Miller,22,74,51,RW,1990
20503,26,26,Kevin Miller,20,80,46,RW,1991
20504,25,27,Kevin Miller,24,82,49,LW,1992
20505,25,28,Kevin Miller,23,75,48,RW,1993
20506,12,29,Kevin Miller,8,36,20,LW,1994
20507,25,30,Kevin Miller,28,81,53,LW,1995
20508,17,31,Kevin Miller,14,69,31,RW,1996
20509,7,32,Kevin Miller,4,37,11,RW,1997
20510,5,33,Kevin Miller,1,33,6,C,1998
20511,2,34,Kevin Miller,3,9,5,RW,1999
20512,2,38,Kevin Miller,0,4,2,RW,2003
20513,43,24,Kevin Morrison,24,78,67,D,1973
20514,43,24,Kevin Morrison,24,78,67,D,1973
20515,61,25,Kevin Morrison,20,78,81,D,1974
20516,61,25,Kevin Morrison,20,78,81,D,1974
20517,43,26,Kevin Morrison,22,80,65,D,1975
20518,43,26,Kevin Morrison,22,80,65,D,1975
20519,30,27,Kevin Morrison,8,75,38,D,1976
20520,40,28,Kevin Morrison,17,75,57,D,1977
20521,7,29,Kevin Morrison,2,32,9,D,1978
20522,7,29,Kevin Morrison,2,32,9,D,1978
20523,11,30,Kevin Morrison,4,41,15,D,1979
20524,8,23,Kevin Nugent,2,25,10,RW,1978
20525,8,23,Kevin Nugent,2,25,10,RW,1978
20526,4,23,Kevin O'Shea,4,41,8,RW,1970
20527,9,24,Kevin O'Shea,6,56,15,RW,1971
20528,5,25,Kevin O'Shea,3,37,8,RW,1972
20529,10,27,Kevin O'Shea,10,68,20,RW,1974
20530,10,27,Kevin O'Shea,10,68,20,RW,1974
20531,5,22,Kevin Porter,5,34,10,C,2008
20532,1,23,Kevin Porter,2,20,3,RW,2009
20533,11,24,Kevin Porter,14,74,25,RW,2010
20534,3,25,Kevin Porter,4,35,7,RW,2011
20535,5,26,Kevin Porter,4,31,9,RW,2012
20536,1,27,Kevin Porter,0,12,1,C,2013
20537,3,29,Kevin Porter,0,41,3,C,2015
20538,0,30,Kevin Porter,0,2,0,C,2016
20539,1,22,Kevin Primeau,0,7,1,RW,1977
20540,1,22,Kevin Primeau,0,7,1,RW,1977
20541,0,25,Kevin Primeau,0,2,0,RW,1980
20542,1,20,Kevin Quick,0,6,1,D,2008
20543,0,23,Kevin Rooney,0,4,0,C,2016
20544,0,24,Kevin Rooney,0,1,0,C,2017
20545,1,24,Kevin Roy,6,25,7,LW,2017
20546,0,21,Kevin Sawyer,0,8,0,LW,1995
20547,0,22,Kevin Sawyer,0,2,0,LW,1996
20548,0,25,Kevin Sawyer,0,3,0,RW,1999
20549,1,26,Kevin Sawyer,0,9,1,LW,2000
20550,1,27,Kevin Sawyer,1,57,2,LW,2001
20551,1,28,Kevin Sawyer,2,31,3,LW,2002
20552,0,20,Kevin Schamehorn,0,3,0,RW,1976
20553,0,23,Kevin Schamehorn,0,2,0,RW,1979
20554,0,24,Kevin Schamehorn,0,5,0,RW,1980
20555,34,22,Kevin Shattenkirk,9,72,43,D,2010
20556,34,23,Kevin Shattenkirk,9,81,43,D,2011
20557,18,24,Kevin Shattenkirk,5,48,23,D,2012
20558,35,25,Kevin Shattenkirk,10,81,45,D,2013
20559,36,26,Kevin Shattenkirk,8,56,44,D,2014
20560,30,27,Kevin Shattenkirk,14,72,44,D,2015
20561,12,28,Kevin Shattenkirk,2,19,14,D,2016
20562,18,29,Kevin Shattenkirk,5,46,23,D,2017
20563,2,20,Kevin Smyth,3,21,5,LW,1993
20564,5,21,Kevin Smyth,1,16,6,LW,1994
20565,1,22,Kevin Smyth,2,21,3,LW,1995
20566,2,22,Kevin Stevens,5,16,7,LW,1987
20567,3,23,Kevin Stevens,12,24,15,LW,1988
20568,41,24,Kevin Stevens,29,76,70,LW,1989
20569,46,25,Kevin Stevens,40,80,86,LW,1990
20570,69,26,Kevin Stevens,54,80,123,LW,1991
20571,56,27,Kevin Stevens,55,72,111,LW,1992
20572,47,28,Kevin Stevens,41,83,88,LW,1993
20573,12,29,Kevin Stevens,15,27,27,LW,1994
20574,23,30,Kevin Stevens,13,61,36,LW,1995
20575,20,31,Kevin Stevens,14,69,34,LW,1996
20576,27,32,Kevin Stevens,14,80,41,LW,1997
20577,20,33,Kevin Stevens,23,81,43,LW,1998
20578,5,34,Kevin Stevens,3,38,8,LW,1999
20579,22,35,Kevin Stevens,10,55,32,LW,2000
20580,4,36,Kevin Stevens,1,32,5,LW,2001
20581,0,20,Kevin Todd,0,1,0,C,1988
20582,0,22,Kevin Todd,0,1,0,C,1990
20583,42,23,Kevin Todd,21,80,63,C,1991
20584,14,24,Kevin Todd,9,55,23,C,1992
20585,14,25,Kevin Todd,8,47,22,C,1993
20586,8,26,Kevin Todd,3,33,11,C,1994
20587,27,27,Kevin Todd,16,74,43,C,1995
20588,21,28,Kevin Todd,9,65,30,C,1996
20589,7,29,Kevin Todd,4,27,11,C,1997
20590,0,24,Kevin Westgarth,0,9,0,RW,2008
20591,3,26,Kevin Westgarth,0,56,3,RW,2010
20592,1,27,Kevin Westgarth,1,25,2,RW,2011
20593,2,28,Kevin Westgarth,2,31,4,RW,2012
20594,3,29,Kevin Westgarth,4,48,7,RW,2013
20595,0,24,Kevin Wortman,0,5,0,D,1993
20596,0,23,Kevyn Adams,0,5,0,C,1997
20597,0,24,Kevyn Adams,0,1,0,C,1998
20598,8,25,Kevyn Adams,5,52,13,C,1999
20599,18,26,Kevyn Adams,11,78,29,C,2000
20600,11,27,Kevyn Adams,6,77,17,C,2001
20601,9,28,Kevyn Adams,9,77,18,C,2002
20602,12,29,Kevyn Adams,10,73,22,C,2003
20603,8,31,Kevyn Adams,15,82,23,C,2005
20604,9,32,Kevyn Adams,3,68,12,C,2006
20605,2,33,Kevyn Adams,0,27,2,C,2007
20606,12,20,Kim Clackson,1,77,13,D,1975
20607,8,21,Kim Clackson,3,71,11,D,1976
20608,8,21,Kim Clackson,3,71,11,D,1976
20609,7,22,Kim Clackson,2,52,9,D,1977
20610,7,22,Kim Clackson,2,52,9,D,1977
20611,12,23,Kim Clackson,0,71,12,D,1978
20612,12,23,Kim Clackson,0,71,12,D,1978
20613,3,24,Kim Clackson,0,45,3,D,1979
20614,5,25,Kim Clackson,0,61,5,D,1980
20615,0,20,Kim Davis,0,1,0,C,1977
20616,0,21,Kim Davis,1,1,1,C,1978
20617,7,22,Kim Davis,3,24,10,C,1979
20618,0,23,Kim Davis,1,10,1,C,1980
20619,0,21,Kim Issel,0,4,0,RW,1988
20620,15,23,Kim Johnsson,6,76,21,D,1999
20621,21,24,Kim Johnsson,5,75,26,D,2000
20622,30,25,Kim Johnsson,11,82,41,D,2001
20623,29,26,Kim Johnsson,10,82,39,D,2002
20624,29,27,Kim Johnsson,13,80,42,D,2003
20625,19,29,Kim Johnsson,6,47,25,D,2005
20626,19,30,Kim Johnsson,3,76,22,D,2006
20627,23,31,Kim Johnsson,4,80,27,D,2007
20628,22,32,Kim Johnsson,2,81,24,D,2008
20629,10,33,Kim Johnsson,7,60,17,D,2009
20630,0,20,Kim MacDougall,0,1,0,D,1974
20631,1,19,Kimbi Daniels,0,2,1,C,1990
20632,1,20,Kimbi Daniels,1,25,2,C,1991
20633,8,23,Kimmo Timonen,4,50,12,D,1998
20634,25,24,Kimmo Timonen,8,51,33,D,1999
20635,13,25,Kimmo Timonen,12,82,25,D,2000
20636,29,26,Kimmo Timonen,13,82,42,D,2001
20637,34,27,Kimmo Timonen,6,72,40,D,2002
20638,32,28,Kimmo Timonen,12,77,44,D,2003
20639,39,30,Kimmo Timonen,11,79,50,D,2005
20640,42,31,Kimmo Timonen,13,80,55,D,2006
20641,36,32,Kimmo Timonen,8,80,44,D,2007
20642,40,33,Kimmo Timonen,3,77,43,D,2008
20643,33,34,Kimmo Timonen,6,82,39,D,2009
20644,31,35,Kimmo Timonen,6,82,37,D,2010
20645,39,36,Kimmo Timonen,4,76,43,D,2011
20646,24,37,Kimmo Timonen,5,45,29,D,2012
20647,29,38,Kimmo Timonen,6,77,35,D,2013
20648,0,39,Kimmo Timonen,0,16,0,D,2014
20649,0,21,Kip Brennan,0,4,0,LW,2001
20650,0,22,Kip Brennan,0,19,0,LW,2002
20651,0,23,Kip Brennan,1,23,1,LW,2003
20652,1,25,Kip Brennan,0,12,1,LW,2005
20653,0,27,Kip Brennan,0,3,0,LW,2007
20654,3,21,Kip Miller,4,13,7,C,1990
20655,12,22,Kip Miller,6,39,18,C,1991
20656,2,24,Kip Miller,2,11,4,C,1993
20657,1,25,Kip Miller,0,8,1,C,1994
20658,4,26,Kip Miller,1,10,5,C,1995
20659,3,28,Kip Miller,1,9,4,C,1997
20660,23,29,Kip Miller,19,77,42,C,1998
20661,32,30,Kip Miller,10,74,42,C,1999
20662,8,31,Kip Miller,3,33,11,LW,2000
20663,17,32,Kip Miller,7,37,24,C,2001
20664,38,33,Kip Miller,12,72,50,C,2002
20665,22,34,Kip Miller,9,66,31,LW,2003
20666,0,23,Kirby Law,0,1,0,RW,2000
20667,0,25,Kirby Law,0,2,0,RW,2002
20668,1,26,Kirby Law,0,6,1,RW,2003
20669,0,20,Kirill Safronov,0,3,0,D,2001
20670,2,21,Kirill Safronov,2,32,4,D,2002
20671,2,21,Kirk Bowman,0,10,2,LW,1973
20672,13,24,Kirk Bowman,10,55,23,LW,1976
20673,4,25,Kirk Bowman,1,33,5,LW,1977
20674,8,21,Kirk Maltby,11,68,19,RW,1993
20675,3,22,Kirk Maltby,8,47,11,RW,1994
20676,6,23,Kirk Maltby,3,55,9,RW,1995
20677,5,24,Kirk Maltby,3,66,8,LW,1996
20678,9,25,Kirk Maltby,14,65,23,LW,1997
20679,6,26,Kirk Maltby,8,53,14,RW,1998
20680,8,27,Kirk Maltby,6,41,14,RW,1999
20681,7,28,Kirk Maltby,12,79,19,RW,2000
20682,15,29,Kirk Maltby,9,82,24,LW,2001
20683,23,30,Kirk Maltby,14,82,37,LW,2002
20684,19,31,Kirk Maltby,14,79,33,LW,2003
20685,6,33,Kirk Maltby,5,82,11,RW,2005
20686,5,34,Kirk Maltby,6,82,11,LW,2006
20687,4,35,Kirk Maltby,6,61,10,LW,2007
20688,6,36,Kirk Maltby,5,78,11,LW,2008
20689,2,37,Kirk Maltby,4,52,6,LW,2009
20690,37,18,Kirk Muller,17,80,54,C,1984
20691,41,19,Kirk Muller,25,77,66,C,1985
20692,50,20,Kirk Muller,26,79,76,C,1986
20693,57,21,Kirk Muller,37,80,94,C,1987
20694,43,22,Kirk Muller,31,80,74,LW,1988
20695,56,23,Kirk Muller,30,80,86,LW,1989
20696,51,24,Kirk Muller,19,80,70,LW,1990
20697,41,25,Kirk Muller,36,78,77,LW,1991
20698,57,26,Kirk Muller,37,80,94,C,1992
20699,34,27,Kirk Muller,23,76,57,C,1993
20700,16,28,Kirk Muller,11,45,27,C,1994
20701,19,29,Kirk Muller,13,51,32,C,1995
20702,19,30,Kirk Muller,21,76,40,C,1996
20703,21,31,Kirk Muller,8,70,29,C,1997
20704,11,32,Kirk Muller,4,82,15,LW,1998
20705,15,33,Kirk Muller,7,47,22,C,1999
20706,9,34,Kirk Muller,1,55,10,C,2000
20707,20,35,Kirk Muller,10,78,30,LW,2001
20708,5,36,Kirk Muller,1,55,6,LW,2002
20709,0,24,Kirk Nielsen,0,6,0,RW,1997
20710,0,19,Kirk Tomlinson,0,1,0,C,1987
20711,39,22,Kjell Dahlin,32,77,71,RW,1985
20712,8,23,Kjell Dahlin,12,41,20,RW,1986
20713,12,24,Kjell Dahlin,13,48,25,RW,1987
20714,0,27,Kjell Samuelsson,0,9,0,D,1985
20715,12,28,Kjell Samuelsson,3,76,15,D,1986
20716,24,29,Kjell Samuelsson,6,74,30,D,1987
20717,14,30,Kjell Samuelsson,3,69,17,D,1988
20718,17,31,Kjell Samuelsson,5,66,22,D,1989
20719,19,32,Kjell Samuelsson,9,78,28,D,1990
20720,11,33,Kjell Samuelsson,5,74,16,D,1991
20721,6,34,Kjell Samuelsson,3,63,9,D,1992
20722,8,35,Kjell Samuelsson,5,59,13,D,1993
20723,6,36,Kjell Samuelsson,1,41,7,D,1994
20724,11,37,Kjell Samuelsson,3,75,14,D,1995
20725,3,38,Kjell Samuelsson,4,34,7,D,1996
20726,3,39,Kjell Samuelsson,0,49,3,D,1997
20727,4,40,Kjell Samuelsson,1,46,5,D,1998
20728,3,23,Klas Dahlbeck,1,23,4,D,2014
20729,6,24,Klas Dahlbeck,2,71,8,D,2015
20730,4,25,Klas Dahlbeck,2,43,6,D,2016
20731,4,26,Klas Dahlbeck,1,33,5,D,2017
20732,0,21,Konstantin Koltsov,0,2,0,RW,2002
20733,20,22,Konstantin Koltsov,9,82,29,RW,2003
20734,6,24,Konstantin Koltsov,3,60,9,LW,2005
20735,1,20,Konstantin Pushkarev,0,1,1,RW,2005
20736,2,21,Konstantin Pushkarev,2,16,4,RW,2006
20737,1,28,Konstantin Shafranov,2,5,3,RW,1996
20738,0,22,Korbinian Holzer,0,2,0,D,2010
20739,1,24,Korbinian Holzer,2,22,3,D,2012
20740,6,26,Korbinian Holzer,0,34,6,D,2014
20741,3,27,Korbinian Holzer,0,29,3,D,2015
20742,5,28,Korbinian Holzer,2,32,7,D,2016
20743,0,29,Korbinian Holzer,0,16,0,D,2017
20744,14,24,Kraig Nienhuis,16,70,30,LW,1985
20745,2,25,Kraig Nienhuis,4,16,6,LW,1986
20746,0,26,Kraig Nienhuis,0,1,0,LW,1987
20747,0,19,Kris Beech,0,4,0,C,2000
20748,15,20,Kris Beech,10,79,25,C,2001
20749,1,21,Kris Beech,0,12,1,C,2002
20750,1,22,Kris Beech,0,4,1,C,2003
20751,2,24,Kris Beech,1,10,3,C,2005
20752,18,25,Kris Beech,8,64,26,C,2006
20753,5,26,Kris Beech,6,25,11,C,2007
20754,0,22,Kris Chucko,0,2,0,RW,2008
20755,0,19,Kris Draper,1,3,1,C,1990
20756,0,20,Kris Draper,2,10,2,C,1991
20757,0,21,Kris Draper,0,7,0,C,1992
20758,8,22,Kris Draper,5,39,13,C,1993
20759,6,23,Kris Draper,2,36,8,C,1994
20760,9,24,Kris Draper,7,52,16,C,1995
20761,5,25,Kris Draper,8,76,13,C,1996
20762,10,26,Kris Draper,13,64,23,C,1997
20763,14,27,Kris Draper,4,80,18,C,1998
20764,7,28,Kris Draper,5,51,12,C,1999
20765,17,29,Kris Draper,8,75,25,C,2000
20766,15,30,Kris Draper,15,82,30,RW,2001
20767,21,31,Kris Draper,14,82,35,C,2002
20768,16,32,Kris Draper,24,67,40,C,2003
20769,22,34,Kris Draper,10,80,32,RW,2005
20770,15,35,Kris Draper,14,81,29,C,2006
20771,8,36,Kris Draper,9,65,17,C,2007
20772,10,37,Kris Draper,7,79,17,C,2008
20773,15,38,Kris Draper,7,81,22,C,2009
20774,5,39,Kris Draper,6,47,11,C,2010
20775,0,21,Kris Foucault,0,1,0,LW,2011
20776,0,24,Kris Fredheim,0,3,0,D,2011
20777,0,21,Kris King,1,3,1,LW,1987
20778,3,22,Kris King,2,55,5,LW,1988
20779,7,23,Kris King,6,68,13,LW,1989
20780,14,24,Kris King,11,72,25,LW,1990
20781,9,25,Kris King,10,79,19,LW,1991
20782,11,26,Kris King,8,78,19,LW,1992
20783,8,27,Kris King,4,83,12,LW,1993
20784,2,28,Kris King,4,48,6,LW,1994
20785,11,29,Kris King,9,81,20,LW,1995
20786,11,30,Kris King,3,81,14,RW,1996
20787,3,31,Kris King,3,82,6,LW,1997
20788,2,32,Kris King,2,67,4,LW,1998
20789,4,33,Kris King,2,39,6,LW,1999
20790,0,34,Kris King,1,13,1,LW,2000
20791,0,19,Kris Letang,2,7,2,D,2006
20792,11,20,Kris Letang,6,63,17,D,2007
20793,23,21,Kris Letang,10,74,33,D,2008
20794,24,22,Kris Letang,3,73,27,D,2009
20795,42,23,Kris Letang,8,82,50,D,2010
20796,32,24,Kris Letang,10,51,42,D,2011
20797,33,25,Kris Letang,5,35,38,D,2012
20798,11,26,Kris Letang,11,37,22,D,2013
20799,43,27,Kris Letang,11,69,54,D,2014
20800,51,28,Kris Letang,16,71,67,D,2015
20801,29,29,Kris Letang,5,41,34,D,2016
20802,42,30,Kris Letang,9,79,51,D,2017
20803,27,23,Kris Manery,22,78,49,C,1977
20804,19,24,Kris Manery,17,60,36,C,1978
20805,9,25,Kris Manery,11,65,20,C,1979
20806,9,26,Kris Manery,13,47,22,C,1980
20807,2,24,Kris Newbury,2,15,4,C,2006
20808,1,25,Kris Newbury,1,28,2,C,2007
20809,0,26,Kris Newbury,0,1,0,C,2008
20810,0,27,Kris Newbury,1,4,1,C,2009
20811,1,28,Kris Newbury,0,11,1,C,2010
20812,0,29,Kris Newbury,0,7,0,C,2011
20813,1,30,Kris Newbury,0,6,1,C,2012
20814,1,31,Kris Newbury,0,4,1,C,2013
20815,8,20,Kris Russell,2,67,10,D,2007
20816,19,21,Kris Russell,2,66,21,D,2008
20817,15,22,Kris Russell,7,70,22,D,2009
20818,18,23,Kris Russell,5,73,23,D,2010
20819,6,24,Kris Russell,6,55,12,D,2011
20820,6,25,Kris Russell,1,33,7,D,2012
20821,22,26,Kris Russell,7,68,29,D,2013
20822,30,27,Kris Russell,4,79,34,D,2014
20823,15,28,Kris Russell,4,62,19,D,2015
20824,12,29,Kris Russell,1,68,13,D,2016
20825,17,30,Kris Russell,4,78,21,D,2017
20826,0,20,Kris Vernarsky,1,14,1,C,2002
20827,0,21,Kris Vernarsky,0,3,0,C,2003
20828,2,21,Kris Versteeg,2,13,4,RW,2007
20829,31,22,Kris Versteeg,22,78,53,LW,2008
20830,24,23,Kris Versteeg,20,79,44,RW,2009
20831,25,24,Kris Versteeg,21,80,46,RW,2010
20832,31,25,Kris Versteeg,23,71,54,RW,2011
20833,2,26,Kris Versteeg,2,10,4,RW,2012
20834,24,27,Kris Versteeg,12,81,36,RW,2013
20835,20,28,Kris Versteeg,14,61,34,LW,2014
20836,23,29,Kris Versteeg,15,77,38,RW,2015
20837,22,30,Kris Versteeg,15,69,37,RW,2016
20838,5,31,Kris Versteeg,3,24,8,RW,2017
20839,22,23,Kristian Huselius,23,79,45,LW,2001
20840,23,24,Kristian Huselius,20,78,43,LW,2002
20841,21,25,Kristian Huselius,10,76,31,LW,2003
20842,27,27,Kristian Huselius,20,78,47,LW,2005
20843,43,28,Kristian Huselius,34,81,77,LW,2006
20844,41,29,Kristian Huselius,25,81,66,LW,2007
20845,35,30,Kristian Huselius,21,74,56,LW,2008
20846,40,31,Kristian Huselius,23,74,63,LW,2009
20847,9,32,Kristian Huselius,14,39,23,LW,2010
20848,0,33,Kristian Huselius,0,2,0,LW,2011
20849,2,19,Kristian Kudroc,2,22,4,D,2000
20850,0,20,Kristian Kudroc,0,2,0,D,2001
20851,0,22,Kristian Kudroc,0,2,0,D,2003
20852,2,26,Krys Barch,3,26,5,RW,2006
20853,2,27,Krys Barch,1,48,3,RW,2007
20854,5,28,Krys Barch,4,72,9,RW,2008
20855,6,29,Krys Barch,0,63,6,RW,2009
20856,1,30,Krys Barch,2,44,3,RW,2010
20857,3,31,Krys Barch,2,51,5,RW,2011
20858,0,32,Krys Barch,0,22,0,RW,2012
20859,4,33,Krys Barch,0,55,4,LW,2013
20860,11,20,Krys Kolanos,11,57,22,C,2001
20861,0,21,Krys Kolanos,0,2,0,C,2002
20862,6,22,Krys Kolanos,4,41,10,C,2003
20863,1,24,Krys Kolanos,2,15,3,C,2005
20864,3,27,Krys Kolanos,3,21,6,C,2008
20865,1,30,Krys Kolanos,0,13,1,C,2011
20866,0,23,Krzysztof Oliwa,0,1,0,LW,1996
20867,3,24,Krzysztof Oliwa,2,73,5,RW,1997
20868,7,25,Krzysztof Oliwa,5,64,12,LW,1998
20869,10,26,Krzysztof Oliwa,6,69,16,RW,1999
20870,4,27,Krzysztof Oliwa,1,36,5,LW,2000
20871,2,28,Krzysztof Oliwa,0,57,2,LW,2001
20872,0,29,Krzysztof Oliwa,0,42,0,LW,2002
20873,2,30,Krzysztof Oliwa,3,65,5,LW,2003
20874,0,32,Krzysztof Oliwa,0,3,0,LW,2005
20875,2,22,Kurt Sauer,1,80,3,D,2002
20876,5,23,Kurt Sauer,1,69,6,D,2003
20877,4,25,Kurt Sauer,1,37,5,D,2005
20878,6,26,Kurt Sauer,0,48,6,D,2006
20879,5,27,Kurt Sauer,1,54,6,D,2007
20880,6,28,Kurt Sauer,1,68,7,D,2008
20881,0,29,Kurt Sauer,0,1,0,D,2009
20882,0,21,Kurt Walker,0,5,0,D,1975
20883,3,22,Kurt Walker,2,26,5,D,1976
20884,2,23,Kurt Walker,2,40,4,RW,1977
20885,0,21,Kurtis Foster,0,2,0,D,2002
20886,1,22,Kurtis Foster,0,3,1,D,2003
20887,18,24,Kurtis Foster,10,58,28,D,2005
20888,20,25,Kurtis Foster,3,57,23,D,2006
20889,12,26,Kurtis Foster,7,56,19,D,2007
20890,5,27,Kurtis Foster,1,10,6,D,2008
20891,34,28,Kurtis Foster,8,71,42,D,2009
20892,14,29,Kurtis Foster,8,74,22,D,2010
20893,10,30,Kurtis Foster,4,51,14,D,2011
20894,4,31,Kurtis Foster,1,23,5,D,2012
20895,0,22,Kurtis Gabriel,0,3,0,RW,2015
20896,1,23,Kurtis Gabriel,0,13,1,RW,2016
20897,3,23,Kurtis MacDermid,1,34,4,D,2017
20898,0,28,Kurtis McLean,1,4,1,RW,2008
20899,0,22,Kyle Baun,0,3,0,RW,2014
20900,0,23,Kyle Baun,0,2,0,RW,2015
20901,0,21,Kyle Brodziak,0,10,0,C,2005
20902,0,22,Kyle Brodziak,1,6,1,C,2006
20903,17,23,Kyle Brodziak,14,80,31,C,2007
20904,16,24,Kyle Brodziak,11,79,27,C,2008
20905,23,25,Kyle Brodziak,9,82,32,C,2009
20906,21,26,Kyle Brodziak,16,80,37,C,2010
20907,22,27,Kyle Brodziak,22,82,44,C,2011
20908,4,28,Kyle Brodziak,8,48,12,C,2012
20909,16,29,Kyle Brodziak,8,81,24,C,2013
20910,11,30,Kyle Brodziak,9,73,20,C,2014
20911,4,31,Kyle Brodziak,7,76,11,C,2015
20912,7,32,Kyle Brodziak,8,69,15,C,2016
20913,23,33,Kyle Brodziak,10,81,33,C,2017
20914,1,21,Kyle Calder,1,8,2,C,1999
20915,10,22,Kyle Calder,5,43,15,C,2000
20916,36,23,Kyle Calder,17,81,53,LW,2001
20917,27,24,Kyle Calder,15,82,42,LW,2002
20918,18,25,Kyle Calder,21,66,39,LW,2003
20919,33,27,Kyle Calder,26,79,59,LW,2005
20920,21,28,Kyle Calder,14,78,35,LW,2006
20921,13,29,Kyle Calder,7,65,20,LW,2007
20922,19,30,Kyle Calder,8,74,27,LW,2008
20923,2,31,Kyle Calder,0,14,2,LW,2009
20924,0,20,Kyle Capobianco,0,1,0,D,2017
20925,7,21,Kyle Chipchura,4,36,11,C,2007
20926,3,22,Kyle Chipchura,0,13,3,C,2008
20927,6,23,Kyle Chipchura,6,74,12,C,2009
20928,2,24,Kyle Chipchura,0,40,2,C,2010
20929,13,25,Kyle Chipchura,3,53,16,C,2011
20930,9,26,Kyle Chipchura,5,46,14,C,2012
20931,15,27,Kyle Chipchura,5,80,20,C,2013
20932,10,28,Kyle Chipchura,4,70,14,C,2014
20933,8,29,Kyle Chipchura,4,70,12,C,2015
20934,7,20,Kyle Clifford,7,76,14,LW,2010
20935,7,21,Kyle Clifford,5,81,12,LW,2011
20936,7,22,Kyle Clifford,7,48,14,LW,2012
20937,5,23,Kyle Clifford,3,71,8,LW,2013
20938,9,24,Kyle Clifford,6,80,15,LW,2014
20939,6,25,Kyle Clifford,3,56,9,LW,2015
20940,6,26,Kyle Clifford,6,73,12,LW,2016
20941,4,27,Kyle Clifford,6,50,10,LW,2017
20942,3,20,Kyle Connor,2,20,5,LW,2016
20943,26,21,Kyle Connor,31,76,57,LW,2017
20944,0,25,Kyle Criscuolo,0,9,0,C,2017
20945,1,20,Kyle Cumiskey,1,9,2,D,2006
20946,5,21,Kyle Cumiskey,0,38,5,D,2007
20947,0,22,Kyle Cumiskey,0,6,0,D,2008
20948,13,23,Kyle Cumiskey,7,61,20,D,2009
20949,7,24,Kyle Cumiskey,1,18,8,D,2010
20950,0,28,Kyle Cumiskey,0,7,0,D,2014
20951,0,21,Kyle Freadrich,0,10,0,RW,1999
20952,1,22,Kyle Freadrich,0,13,1,LW,2000
20953,0,24,Kyle Greentree,0,2,0,LW,2007
20954,0,25,Kyle Greentree,0,2,0,LW,2008
20955,12,18,Kyle McLaren,5,74,17,D,1995
20956,9,19,Kyle McLaren,5,58,14,D,1996
20957,20,20,Kyle McLaren,5,66,25,D,1997
20958,18,21,Kyle McLaren,6,52,24,D,1998
20959,11,22,Kyle McLaren,8,71,19,D,1999
20960,12,23,Kyle McLaren,5,58,17,D,2000
20961,8,24,Kyle McLaren,0,38,8,D,2001
20962,8,25,Kyle McLaren,0,33,8,D,2002
20963,22,26,Kyle McLaren,2,64,24,D,2003
20964,21,28,Kyle McLaren,2,77,23,D,2005
20965,12,29,Kyle McLaren,5,67,17,D,2006
20966,8,30,Kyle McLaren,3,61,11,D,2007
20967,3,19,Kyle Okposo,2,9,5,RW,2007
20968,21,20,Kyle Okposo,18,65,39,RW,2008
20969,33,21,Kyle Okposo,19,80,52,RW,2009
20970,15,22,Kyle Okposo,5,38,20,RW,2010
20971,21,23,Kyle Okposo,24,79,45,RW,2011
20972,20,24,Kyle Okposo,4,48,24,RW,2012
20973,42,25,Kyle Okposo,27,71,69,RW,2013
20974,33,26,Kyle Okposo,18,60,51,RW,2014
20975,42,27,Kyle Okposo,22,79,64,RW,2015
20976,26,28,Kyle Okposo,19,65,45,RW,2016
20977,29,29,Kyle Okposo,15,76,44,RW,2017
20978,0,19,Kyle Palmieri,1,10,1,C,2010
20979,3,20,Kyle Palmieri,4,18,7,C,2011
20980,11,21,Kyle Palmieri,10,42,21,C,2012
20981,17,22,Kyle Palmieri,14,71,31,RW,2013
20982,15,23,Kyle Palmieri,14,57,29,RW,2014
20983,27,24,Kyle Palmieri,30,82,57,RW,2015
20984,27,25,Kyle Palmieri,26,80,53,RW,2016
20985,20,26,Kyle Palmieri,24,62,44,RW,2017
20986,0,20,Kyle Quincey,0,1,0,D,2005
20987,0,21,Kyle Quincey,1,6,1,D,2006
20988,0,22,Kyle Quincey,0,6,0,D,2007
20989,34,23,Kyle Quincey,4,72,38,D,2008
20990,23,24,Kyle Quincey,6,79,29,D,2009
20991,1,25,Kyle Quincey,0,21,1,D,2010
20992,19,26,Kyle Quincey,7,72,26,D,2011
20993,2,27,Kyle Quincey,1,36,3,D,2012
20994,9,28,Kyle Quincey,4,82,13,D,2013
20995,15,29,Kyle Quincey,3,73,18,D,2014
20996,7,30,Kyle Quincey,4,47,11,D,2015
20997,1,31,Kyle Quincey,2,20,3,D,2016
20998,3,32,Kyle Quincey,0,18,3,D,2017
20999,0,23,Kyle Rau,0,9,0,C,2015
21000,1,24,Kyle Rau,2,24,3,C,2016
21001,1,25,Kyle Rau,0,3,1,C,2017
21002,0,21,Kyle Rossiter,0,2,0,D,2001
21003,0,22,Kyle Rossiter,0,3,0,D,2002
21004,1,23,Kyle Rossiter,0,6,1,D,2003
21005,1,18,Kyle Turris,0,3,1,C,2007
21006,12,19,Kyle Turris,8,63,20,C,2008
21007,14,21,Kyle Turris,11,65,25,C,2010
21008,17,22,Kyle Turris,12,55,29,C,2011
21009,17,23,Kyle Turris,12,48,29,C,2012
21010,31,24,Kyle Turris,26,82,57,C,2013
21011,40,25,Kyle Turris,24,82,64,C,2014
21012,17,26,Kyle Turris,13,57,30,C,2015
21013,28,27,Kyle Turris,27,78,55,C,2016
21014,6,28,Kyle Turris,3,11,9,C,2017
21015,0,22,Kyle Wanvig,1,7,1,RW,2002
21016,1,23,Kyle Wanvig,0,6,1,RW,2003
21017,8,25,Kyle Wanvig,4,51,12,RW,2005
21018,0,26,Kyle Wanvig,0,4,0,RW,2006
21019,0,27,Kyle Wanvig,1,7,1,RW,2007
21020,0,20,Kyle Wellwood,0,1,0,C,2003
21021,34,22,Kyle Wellwood,11,81,45,C,2005
21022,30,23,Kyle Wellwood,12,48,42,C,2006
21023,13,24,Kyle Wellwood,8,59,21,C,2007
21024,9,25,Kyle Wellwood,18,74,27,C,2008
21025,11,26,Kyle Wellwood,14,75,25,C,2009
21026,8,27,Kyle Wellwood,5,35,13,C,2010
21027,29,28,Kyle Wellwood,18,77,47,C,2011
21028,9,29,Kyle Wellwood,6,39,15,C,2012
21029,2,25,Kyle Wilson,0,2,2,C,2009
21030,7,26,Kyle Wilson,4,32,11,C,2010
21031,0,27,Kyle Wilson,0,5,0,C,2011
21032,8,24,Kyosti Karjalainen,1,28,9,RW,1991
21033,0,22,Ladislav Benysek,0,2,0,D,1997
21034,5,25,Ladislav Benysek,2,71,7,D,2000
21035,7,26,Ladislav Benysek,1,74,8,D,2001
21036,0,27,Ladislav Benysek,0,14,0,D,2002
21037,0,23,Ladislav Karabin,0,9,0,LW,1993
21038,0,20,Ladislav Kohn,1,5,1,RW,1995
21039,1,22,Ladislav Kohn,0,4,1,RW,1997
21040,3,23,Ladislav Kohn,1,16,4,RW,1998
21041,16,24,Ladislav Kohn,5,77,21,RW,1999
21042,7,25,Ladislav Kohn,7,77,14,RW,2000
21043,0,26,Ladislav Kohn,0,4,0,RW,2001
21044,1,27,Ladislav Kohn,0,3,1,RW,2002
21045,4,20,Ladislav Nagy,2,11,6,RW,1999
21046,9,21,Ladislav Nagy,8,46,17,RW,2000
21047,19,22,Ladislav Nagy,23,74,42,LW,2001
21048,35,23,Ladislav Nagy,22,80,57,LW,2002
21049,28,24,Ladislav Nagy,24,55,52,LW,2003
21050,41,26,Ladislav Nagy,15,51,56,LW,2005
21051,43,27,Ladislav Nagy,12,80,55,LW,2006
21052,17,28,Ladislav Nagy,9,38,26,LW,2007
21053,7,20,Ladislav Smid,3,77,10,D,2006
21054,4,21,Ladislav Smid,0,65,4,D,2007
21055,11,22,Ladislav Smid,0,60,11,D,2008
21056,8,23,Ladislav Smid,1,51,9,D,2009
21057,10,24,Ladislav Smid,0,78,10,D,2010
21058,10,25,Ladislav Smid,5,78,15,D,2011
21059,3,26,Ladislav Smid,1,48,4,D,2012
21060,6,27,Ladislav Smid,2,73,8,D,2013
21061,1,28,Ladislav Smid,0,31,1,D,2014
21062,0,29,Ladislav Smid,0,22,0,D,2015
21063,1,20,Lance Bouma,0,16,1,C,2010
21064,2,21,Lance Bouma,1,27,3,C,2011
21065,10,23,Lance Bouma,5,78,15,LW,2013
21066,18,24,Lance Bouma,16,78,34,C,2014
21067,5,25,Lance Bouma,2,44,7,C,2015
21068,4,26,Lance Bouma,3,61,7,C,2016
21069,6,27,Lance Bouma,3,53,9,LW,2017
21070,12,23,Lance Nethery,11,33,23,C,1980
21071,2,24,Lance Nethery,0,8,2,C,1981
21072,1,27,Lance Pitlick,0,15,1,D,1994
21073,6,28,Lance Pitlick,1,28,7,D,1995
21074,5,29,Lance Pitlick,5,66,10,D,1996
21075,7,30,Lance Pitlick,2,69,9,D,1997
21076,6,31,Lance Pitlick,3,50,9,D,1998
21077,5,32,Lance Pitlick,3,62,8,D,1999
21078,2,33,Lance Pitlick,1,68,3,D,2000
21079,1,34,Lance Pitlick,1,35,2,D,2001
21080,2,22,Lance Ward,0,30,2,D,2000
21081,4,23,Lance Ward,1,68,5,D,2001
21082,2,24,Lance Ward,3,65,5,D,2002
21083,4,25,Lance Ward,0,46,4,D,2003
21084,0,22,Landon Ferraro,0,4,0,C,2013
21085,0,23,Landon Ferraro,1,3,1,C,2014
21086,5,24,Landon Ferraro,5,68,10,C,2015
21087,0,26,Landon Ferraro,1,2,1,C,2017
21088,0,20,Landon Wilson,1,7,1,RW,1995
21089,12,21,Landon Wilson,8,49,20,RW,1996
21090,5,22,Landon Wilson,1,28,6,RW,1997
21091,3,23,Landon Wilson,3,22,6,RW,1998
21092,3,24,Landon Wilson,1,40,4,RW,1999
21093,13,25,Landon Wilson,18,70,31,RW,2000
21094,12,26,Landon Wilson,7,47,19,RW,2001
21095,8,27,Landon Wilson,6,31,14,RW,2002
21096,4,28,Landon Wilson,6,54,10,RW,2003
21097,6,33,Landon Wilson,2,27,8,RW,2008
21098,15,19,Lane Lambert,20,73,35,RW,1983
21099,11,20,Lane Lambert,14,69,25,RW,1984
21100,3,21,Lane Lambert,2,34,5,RW,1985
21101,7,22,Lane Lambert,7,33,14,RW,1986
21102,28,23,Lane Lambert,13,61,41,RW,1987
21103,2,24,Lane Lambert,2,13,4,RW,1988
21104,0,22,Lane MacDermid,0,5,0,D,2011
21105,0,23,Lane MacDermid,2,9,2,D,2012
21106,2,24,Lane MacDermid,0,7,2,LW,2013
21107,16,20,Lanny McDonald,14,70,30,RW,1973
21108,27,21,Lanny McDonald,17,64,44,RW,1974
21109,56,22,Lanny McDonald,37,75,93,RW,1975
21110,44,23,Lanny McDonald,46,80,90,RW,1976
21111,40,24,Lanny McDonald,47,74,87,RW,1977
21112,42,25,Lanny McDonald,43,79,85,RW,1978
21113,35,26,Lanny McDonald,40,81,75,RW,1979
21114,46,27,Lanny McDonald,35,80,81,RW,1980
21115,42,28,Lanny McDonald,40,71,82,RW,1981
21116,32,29,Lanny McDonald,66,80,98,RW,1982
21117,33,30,Lanny McDonald,33,65,66,RW,1983
21118,18,31,Lanny McDonald,19,43,37,RW,1984
21119,43,32,Lanny McDonald,28,80,71,RW,1985
21120,12,33,Lanny McDonald,14,58,26,RW,1986
21121,13,34,Lanny McDonald,10,60,23,RW,1987
21122,7,35,Lanny McDonald,11,51,18,RW,1988
21123,3,24,Larry Bignell,0,20,3,D,1973
21124,5,26,Larry Bignell,5,41,10,D,1975
21125,5,26,Larry Bignell,5,41,10,D,1975
21126,0,20,Larry Bolonchuk,0,15,0,D,1972
21127,1,23,Larry Bolonchuk,0,1,1,D,1975
21128,0,24,Larry Bolonchuk,0,9,0,D,1976
21129,8,25,Larry Bolonchuk,3,49,11,D,1977
21130,3,22,Larry Brown,0,15,3,D,1969
21131,5,23,Larry Brown,2,64,7,D,1970
21132,0,24,Larry Brown,0,12,0,D,1971
21133,7,25,Larry Brown,0,55,7,D,1972
21134,4,26,Larry Brown,0,45,4,D,1973
21135,15,27,Larry Brown,1,78,16,D,1974
21136,5,28,Larry Brown,2,74,7,D,1975
21137,6,29,Larry Brown,1,55,7,D,1976
21138,8,30,Larry Brown,1,57,9,D,1977
21139,15,34,Larry Cahan,9,74,24,D,1967
21140,11,35,Larry Cahan,3,72,14,D,1968
21141,8,36,Larry Cahan,4,70,12,D,1969
21142,11,37,Larry Cahan,3,67,14,D,1970
21143,10,39,Larry Cahan,1,75,11,D,1972
21144,10,39,Larry Cahan,1,75,11,D,1972
21145,0,40,Larry Cahan,0,3,0,D,1973
21146,0,40,Larry Cahan,0,3,0,D,1973
21147,8,21,Larry Carriere,2,40,10,D,1972
21148,24,22,Larry Carriere,6,78,30,D,1973
21149,11,23,Larry Carriere,1,80,12,D,1974
21150,15,24,Larry Carriere,4,75,19,D,1975
21151,12,25,Larry Carriere,3,74,15,D,1976
21152,3,26,Larry Carriere,0,18,3,D,1977
21153,1,28,Larry Carriere,0,2,1,D,1979
21154,0,20,Larry Courville,1,3,1,LW,1995
21155,2,21,Larry Courville,0,19,2,LW,1996
21156,0,22,Larry Courville,0,11,0,LW,1997
21157,0,20,Larry DePalma,0,1,0,LW,1985
21158,6,21,Larry DePalma,9,56,15,LW,1986
21159,1,22,Larry DePalma,1,7,2,LW,1987
21160,7,23,Larry DePalma,5,43,12,LW,1988
21161,0,25,Larry DePalma,3,14,3,LW,1990
21162,6,27,Larry DePalma,2,20,8,LW,1992
21163,0,28,Larry DePalma,1,7,1,LW,1993
21164,0,21,Larry Floyd,1,5,1,C,1982
21165,3,22,Larry Floyd,1,7,4,C,1983
21166,0,25,Larry Fullan,1,4,1,LW,1974
21167,17,22,Larry Giroux,5,74,22,D,1973
21168,26,23,Larry Giroux,2,60,28,D,1974
21169,1,24,Larry Giroux,1,10,2,D,1975
21170,0,25,Larry Giroux,0,2,0,D,1976
21171,3,26,Larry Giroux,0,5,3,D,1977
21172,22,27,Larry Giroux,5,73,27,D,1978
21173,5,28,Larry Giroux,2,50,7,D,1979
21174,9,22,Larry Goodenough,3,20,12,D,1974
21175,34,23,Larry Goodenough,8,77,42,D,1975
21176,17,24,Larry Goodenough,6,62,23,D,1976
21177,6,25,Larry Goodenough,1,42,7,D,1977
21178,9,26,Larry Goodenough,4,36,13,D,1978
21179,2,27,Larry Goodenough,0,5,2,D,1979
21180,0,21,Larry Gould,0,2,0,LW,1973
21181,16,27,Larry Hale,3,67,19,D,1968
21182,9,28,Larry Hale,1,53,10,D,1969
21183,11,29,Larry Hale,1,70,12,D,1970
21184,1,30,Larry Hale,0,6,1,D,1971
21185,26,31,Larry Hale,4,68,30,D,1972
21186,26,31,Larry Hale,4,68,30,D,1972
21187,14,32,Larry Hale,2,69,16,D,1973
21188,14,32,Larry Hale,2,69,16,D,1973
21189,18,33,Larry Hale,2,76,20,D,1974
21190,18,33,Larry Hale,2,76,20,D,1974
21191,12,34,Larry Hale,2,77,14,D,1975
21192,12,34,Larry Hale,2,77,14,D,1975
21193,14,35,Larry Hale,0,67,14,D,1976
21194,14,35,Larry Hale,0,67,14,D,1976
21195,11,36,Larry Hale,2,56,13,D,1977
21196,11,36,Larry Hale,2,56,13,D,1977
21197,17,30,Larry Hillman,3,55,20,D,1967
21198,10,31,Larry Hillman,1,37,11,D,1968
21199,26,32,Larry Hillman,5,76,31,D,1969
21200,13,33,Larry Hillman,3,73,16,D,1970
21201,13,34,Larry Hillman,2,65,15,D,1971
21202,24,35,Larry Hillman,5,78,29,D,1972
21203,21,36,Larry Hillman,5,44,26,D,1973
21204,21,36,Larry Hillman,5,44,26,D,1973
21205,16,37,Larry Hillman,0,77,16,D,1974
21206,16,37,Larry Hillman,0,77,16,D,1974
21207,12,38,Larry Hillman,1,71,13,D,1975
21208,12,38,Larry Hillman,1,71,13,D,1975
21209,0,23,Larry Hopkins,0,2,0,LW,1977
21210,0,25,Larry Hopkins,0,5,0,LW,1979
21211,15,27,Larry Hopkins,10,41,25,LW,1981
21212,1,28,Larry Hopkins,3,12,4,LW,1982
21213,0,25,Larry Hornung,0,1,0,D,1970
21214,9,26,Larry Hornung,2,47,11,D,1971
21215,45,27,Larry Hornung,13,77,58,D,1972
21216,45,27,Larry Hornung,13,77,58,D,1972
21217,19,28,Larry Hornung,4,51,23,D,1973
21218,19,28,Larry Hornung,4,51,23,D,1973
21219,25,29,Larry Hornung,7,69,32,D,1974
21220,25,29,Larry Hornung,7,69,32,D,1974
21221,18,30,Larry Hornung,3,76,21,D,1975
21222,18,30,Larry Hornung,3,76,21,D,1975
21223,10,31,Larry Hornung,6,79,16,D,1976
21224,9,31,Larry Hornung,4,58,13,D,1976
21225,1,31,Larry Hornung,2,21,3,D,1976
21226,10,31,Larry Hornung,6,79,16,D,1976
21227,9,31,Larry Hornung,4,58,13,D,1976
21228,1,31,Larry Hornung,2,21,3,D,1976
21229,4,32,Larry Hornung,1,19,5,D,1977
21230,4,32,Larry Hornung,1,19,5,D,1977
21231,0,21,Larry Huras,0,2,0,D,1976
21232,9,22,Larry Israelson,12,46,21,LW,1974
21233,9,22,Larry Israelson,12,46,21,LW,1974
21234,22,23,Larry Israelson,10,57,32,LW,1975
21235,22,23,Larry Israelson,10,57,32,LW,1975
21236,0,24,Larry Israelson,0,2,0,LW,1976
21237,0,24,Larry Israelson,0,2,0,LW,1976
21238,4,27,Larry Jeffrey,2,47,6,LW,1967
21239,6,28,Larry Jeffrey,1,75,7,LW,1968
21240,0,24,Larry Johnston,0,4,0,D,1967
21241,20,28,Larry Johnston,4,65,24,D,1971
21242,12,29,Larry Johnston,1,73,13,D,1972
21243,12,30,Larry Johnston,2,65,14,D,1973
21244,7,31,Larry Johnston,0,16,7,D,1974
21245,9,31,Larry Johnston,0,49,9,D,1974
21246,9,31,Larry Johnston,0,49,9,D,1974
21247,10,32,Larry Johnston,2,72,12,D,1975
21248,3,33,Larry Johnston,0,25,3,D,1976
21249,8,27,Larry Keenan,12,40,20,LW,1967
21250,9,28,Larry Keenan,5,46,14,LW,1968
21251,23,29,Larry Keenan,10,56,33,LW,1969
21252,23,30,Larry Keenan,8,61,31,LW,1970
21253,1,31,Larry Keenan,3,28,4,LW,1971
21254,0,25,Larry Landon,0,2,0,RW,1983
21255,0,26,Larry Landon,0,7,0,RW,1984
21256,45,32,Larry Lund,21,77,66,C,1972
21257,45,32,Larry Lund,21,77,66,C,1972
21258,53,33,Larry Lund,33,75,86,C,1973
21259,75,34,Larry Lund,33,78,108,C,1974
21260,49,35,Larry Lund,24,73,73,C,1975
21261,49,35,Larry Lund,24,73,73,C,1975
21262,38,36,Larry Lund,29,80,67,C,1976
21263,38,36,Larry Lund,29,80,67,C,1976
21264,17,37,Larry Lund,9,76,26,C,1977
21265,17,37,Larry Lund,9,76,26,C,1977
21266,40,30,Larry Mavety,10,73,50,D,1972
21267,40,30,Larry Mavety,9,67,49,D,1972
21268,0,30,Larry Mavety,0,4,0,D,1972
21269,0,30,Larry Mavety,1,2,1,D,1972
21270,40,30,Larry Mavety,10,73,50,D,1972
21271,40,30,Larry Mavety,9,67,49,D,1972
21272,0,30,Larry Mavety,0,4,0,D,1972
21273,0,30,Larry Mavety,1,2,1,D,1972
21274,36,31,Larry Mavety,15,77,51,D,1973
21275,36,31,Larry Mavety,15,77,51,D,1973
21276,31,32,Larry Mavety,10,74,41,D,1974
21277,22,32,Larry Mavety,10,57,32,D,1974
21278,9,32,Larry Mavety,0,17,9,D,1974
21279,31,32,Larry Mavety,10,74,41,D,1974
21280,22,32,Larry Mavety,10,57,32,D,1974
21281,9,32,Larry Mavety,0,17,9,D,1974
21282,4,33,Larry Mavety,0,14,4,D,1975
21283,4,33,Larry Mavety,0,14,4,D,1975
21284,2,34,Larry Mavety,2,10,4,D,1976
21285,2,34,Larry Mavety,2,10,4,D,1976
21286,0,20,Larry McIntyre,0,1,0,D,1969
21287,3,23,Larry McIntyre,0,40,3,D,1972
21288,4,20,Larry Melnyk,0,26,4,D,1980
21289,8,21,Larry Melnyk,0,48,8,D,1981
21290,0,22,Larry Melnyk,0,1,0,D,1982
21291,11,24,Larry Melnyk,0,28,11,D,1984
21292,11,25,Larry Melnyk,3,52,14,D,1985
21293,12,26,Larry Melnyk,3,73,15,D,1986
21294,4,27,Larry Melnyk,2,63,6,D,1987
21295,11,28,Larry Melnyk,3,74,14,D,1988
21296,2,29,Larry Melnyk,0,67,2,D,1989
21297,2,24,Larry Mickey,0,4,2,RW,1967
21298,19,25,Larry Mickey,8,55,27,RW,1968
21299,4,26,Larry Mickey,4,21,8,RW,1969
21300,12,27,Larry Mickey,6,65,18,RW,1970
21301,3,28,Larry Mickey,1,18,4,RW,1971
21302,9,29,Larry Mickey,15,77,24,RW,1972
21303,4,30,Larry Mickey,3,13,7,RW,1973
21304,0,31,Larry Mickey,2,23,2,RW,1974
21305,60,19,Larry Murphy,16,80,76,D,1980
21306,44,20,Larry Murphy,22,79,66,D,1981
21307,48,21,Larry Murphy,14,77,62,D,1982
21308,36,22,Larry Murphy,13,78,49,D,1983
21309,42,23,Larry Murphy,13,79,55,D,1984
21310,44,24,Larry Murphy,21,78,65,D,1985
21311,58,25,Larry Murphy,23,80,81,D,1986
21312,53,26,Larry Murphy,8,79,61,D,1987
21313,35,27,Larry Murphy,11,78,46,D,1988
21314,58,28,Larry Murphy,10,77,68,D,1989
21315,34,29,Larry Murphy,9,75,43,D,1990
21316,56,30,Larry Murphy,21,77,77,D,1991
21317,63,31,Larry Murphy,22,83,85,D,1992
21318,56,32,Larry Murphy,17,84,73,D,1993
21319,25,33,Larry Murphy,13,48,38,D,1994
21320,49,34,Larry Murphy,12,82,61,D,1995
21321,36,35,Larry Murphy,9,81,45,D,1996
21322,41,36,Larry Murphy,11,82,52,D,1997
21323,42,37,Larry Murphy,10,80,52,D,1998
21324,30,38,Larry Murphy,10,81,40,D,1999
21325,19,39,Larry Murphy,2,57,21,D,2000
21326,0,20,Larry Patey,0,1,0,C,1973
21327,20,21,Larry Patey,25,79,45,C,1974
21328,10,22,Larry Patey,12,71,22,C,1975
21329,29,23,Larry Patey,21,80,50,C,1976
21330,17,24,Larry Patey,17,80,34,C,1977
21331,19,25,Larry Patey,15,78,34,C,1978
21332,17,26,Larry Patey,17,78,34,C,1979
21333,23,27,Larry Patey,22,80,45,C,1980
21334,12,28,Larry Patey,14,70,26,C,1981
21335,12,29,Larry Patey,9,67,21,C,1982
21336,3,30,Larry Patey,1,26,4,C,1983
21337,1,31,Larry Patey,0,7,1,C,1984
21338,3,20,Larry Playfair,0,26,3,D,1978
21339,10,21,Larry Playfair,2,79,12,D,1979
21340,9,22,Larry Playfair,3,75,12,D,1980
21341,10,23,Larry Playfair,6,77,16,D,1981
21342,13,24,Larry Playfair,4,79,17,D,1982
21343,11,25,Larry Playfair,5,76,16,D,1983
21344,14,26,Larry Playfair,3,72,17,D,1984
21345,3,27,Larry Playfair,1,61,4,D,1985
21346,7,28,Larry Playfair,2,37,9,D,1986
21347,7,29,Larry Playfair,0,54,7,D,1987
21348,6,30,Larry Playfair,0,48,6,D,1988
21349,1,31,Larry Playfair,0,4,1,D,1989
21350,0,23,Larry Pleau,1,20,1,C,1969
21351,5,24,Larry Pleau,1,19,6,C,1970
21352,10,25,Larry Pleau,7,55,17,C,1971
21353,48,26,Larry Pleau,39,78,87,LW,1972
21354,48,26,Larry Pleau,39,78,87,LW,1972
21355,43,27,Larry Pleau,26,77,69,LW,1973
21356,43,27,Larry Pleau,26,77,69,LW,1973
21357,34,28,Larry Pleau,30,78,64,LW,1974
21358,34,28,Larry Pleau,30,78,64,LW,1974
21359,45,29,Larry Pleau,29,75,74,LW,1975
21360,45,29,Larry Pleau,29,75,74,LW,1975
21361,21,30,Larry Pleau,11,78,32,LW,1976
21362,21,30,Larry Pleau,11,78,32,LW,1976
21363,18,31,Larry Pleau,16,54,34,LW,1977
21364,18,31,Larry Pleau,16,54,34,LW,1977
21365,6,32,Larry Pleau,6,28,12,LW,1978
21366,6,32,Larry Pleau,6,28,12,LW,1978
21367,14,37,Larry Popein,5,47,19,C,1967
21368,4,21,Larry Robinson,2,36,6,D,1972
21369,20,22,Larry Robinson,6,78,26,D,1973
21370,47,23,Larry Robinson,14,80,61,D,1974
21371,30,24,Larry Robinson,10,80,40,D,1975
21372,66,25,Larry Robinson,19,77,85,D,1976
21373,52,26,Larry Robinson,13,80,65,D,1977
21374,45,27,Larry Robinson,16,67,61,D,1978
21375,61,28,Larry Robinson,14,72,75,D,1979
21376,38,29,Larry Robinson,12,65,50,D,1980
21377,47,30,Larry Robinson,12,71,59,D,1981
21378,49,31,Larry Robinson,14,71,63,D,1982
21379,34,32,Larry Robinson,9,74,43,D,1983
21380,33,33,Larry Robinson,14,76,47,D,1984
21381,63,34,Larry Robinson,19,78,82,D,1985
21382,37,35,Larry Robinson,13,70,50,D,1986
21383,34,36,Larry Robinson,6,53,40,D,1987
21384,26,37,Larry Robinson,4,74,30,D,1988
21385,32,38,Larry Robinson,7,64,39,D,1989
21386,22,39,Larry Robinson,1,62,23,D,1990
21387,10,40,Larry Robinson,3,56,13,D,1991
21388,2,21,Larry Romanchych,0,10,2,RW,1970
21389,30,23,Larry Romanchych,18,70,48,RW,1972
21390,29,24,Larry Romanchych,22,73,51,RW,1973
21391,12,25,Larry Romanchych,8,53,20,RW,1974
21392,19,26,Larry Romanchych,16,67,35,RW,1975
21393,5,27,Larry Romanchych,4,25,9,RW,1976
21394,0,20,Larry Sacharuk,1,8,1,D,1972
21395,4,21,Larry Sacharuk,2,23,6,D,1973
21396,22,22,Larry Sacharuk,20,76,42,D,1974
21397,7,23,Larry Sacharuk,6,42,13,D,1975
21398,0,24,Larry Sacharuk,0,2,0,D,1976
21399,9,26,Larry Sacharuk,2,15,11,D,1978
21400,9,26,Larry Sacharuk,2,15,11,D,1978
21401,5,20,Larry Skinner,4,19,9,C,1976
21402,5,21,Larry Skinner,3,14,8,C,1977
21403,2,22,Larry Skinner,3,12,5,C,1978
21404,0,23,Larry Skinner,0,2,0,C,1979
21405,2,19,Larry Trader,0,15,2,D,1982
21406,7,21,Larry Trader,3,40,10,D,1984
21407,0,23,Larry Trader,0,5,0,D,1986
21408,4,24,Larry Trader,2,31,6,D,1987
21409,1,20,Larry Wright,0,27,1,C,1971
21410,1,21,Larry Wright,0,9,1,C,1972
21411,0,23,Larry Wright,0,2,0,D,1974
21412,0,24,Larry Wright,1,2,1,C,1975
21413,6,26,Larry Wright,3,66,9,RW,1977
21414,10,39,Larry Zeidel,1,57,11,D,1967
21415,0,40,Larry Zeidel,0,9,0,D,1968
21416,0,20,Lars Eller,2,7,2,C,2009
21417,10,21,Lars Eller,7,77,17,C,2010
21418,12,22,Lars Eller,16,79,28,C,2011
21419,22,23,Lars Eller,8,46,30,C,2012
21420,14,24,Lars Eller,12,77,26,C,2013
21421,12,25,Lars Eller,15,77,27,C,2014
21422,13,26,Lars Eller,13,79,26,C,2015
21423,13,27,Lars Eller,12,81,25,C,2016
21424,20,28,Lars Eller,18,81,38,C,2017
21425,2,25,Lars Jonsson,0,8,2,D,2006
21426,19,26,Lars Lindgren,2,64,21,D,1978
21427,30,27,Lars Lindgren,5,73,35,D,1979
21428,18,28,Lars Lindgren,4,52,22,D,1980
21429,16,29,Lars Lindgren,5,75,21,D,1981
21430,14,30,Lars Lindgren,6,64,20,D,1982
21431,16,31,Lars Lindgren,3,66,19,D,1983
21432,31,25,Lars Molin,15,72,46,LW,1981
21433,27,26,Lars Molin,12,58,39,LW,1982
21434,7,27,Lars Molin,6,42,13,LW,1983
21435,1,25,Lars Zetterstrom,0,14,1,D,1978
21436,53,30,Lars-Erik Sjoberg,7,75,60,D,1974
21437,53,30,Lars-Erik Sjoberg,7,75,60,D,1974
21438,36,31,Lars-Erik Sjoberg,5,81,41,D,1975
21439,36,31,Lars-Erik Sjoberg,5,81,41,D,1975
21440,38,32,Lars-Erik Sjoberg,2,52,40,D,1976
21441,38,32,Lars-Erik Sjoberg,2,52,40,D,1976
21442,39,33,Lars-Erik Sjoberg,11,78,50,D,1977
21443,39,33,Lars-Erik Sjoberg,11,78,50,D,1977
21444,3,34,Lars-Erik Sjoberg,0,9,3,D,1978
21445,3,34,Lars-Erik Sjoberg,0,9,3,D,1978
21446,27,35,Lars-Erik Sjoberg,7,79,34,D,1979
21447,1,22,Lasse Kukkonen,0,10,1,D,2003
21448,9,25,Lasse Kukkonen,5,74,14,D,2006
21449,4,26,Lasse Kukkonen,1,53,5,D,2007
21450,2,27,Lasse Kukkonen,0,22,2,D,2008
21451,10,28,Lasse Pirjeta,11,51,21,C,2002
21452,14,29,Lasse Pirjeta,8,70,22,C,2003
21453,3,31,Lasse Pirjeta,4,25,7,C,2005
21454,0,20,Laurent Dauphin,1,8,1,C,2015
21455,1,21,Laurent Dauphin,2,24,3,C,2016
21456,0,22,Laurent Dauphin,0,2,0,C,2017
21457,8,22,Lauri Korpikoski,6,68,14,LW,2008
21458,6,23,Lauri Korpikoski,5,71,11,LW,2009
21459,21,24,Lauri Korpikoski,19,79,40,LW,2010
21460,20,25,Lauri Korpikoski,17,82,37,LW,2011
21461,5,26,Lauri Korpikoski,6,36,11,LW,2012
21462,16,27,Lauri Korpikoski,9,64,25,LW,2013
21463,15,28,Lauri Korpikoski,6,69,21,LW,2014
21464,12,29,Lauri Korpikoski,10,71,22,LW,2015
21465,0,30,Lauri Korpikoski,0,9,0,LW,2016
21466,21,25,Lauri Mononen,15,75,36,RW,1975
21467,21,25,Lauri Mononen,15,75,36,RW,1975
21468,29,26,Lauri Mononen,21,67,50,RW,1976
21469,29,26,Lauri Mononen,21,67,50,RW,1976
21470,0,20,Lauri Tukonen,0,4,0,RW,2006
21471,0,21,Lauri Tukonen,0,1,0,RW,2007
21472,32,19,Laurie Boschman,16,80,48,C,1979
21473,19,20,Laurie Boschman,14,53,33,C,1980
21474,22,21,Laurie Boschman,11,65,33,C,1981
21475,17,22,Laurie Boschman,11,74,28,C,1982
21476,46,23,Laurie Boschman,28,61,74,C,1983
21477,44,24,Laurie Boschman,32,80,76,C,1984
21478,42,25,Laurie Boschman,27,77,69,C,1985
21479,24,26,Laurie Boschman,17,80,41,C,1986
21480,23,27,Laurie Boschman,25,80,48,C,1987
21481,26,28,Laurie Boschman,10,70,36,C,1988
21482,17,29,Laurie Boschman,10,66,27,C,1989
21483,9,30,Laurie Boschman,11,78,20,C,1990
21484,20,31,Laurie Boschman,8,75,28,C,1991
21485,7,32,Laurie Boschman,9,70,16,C,1992
21486,0,24,Lawrence Nycholat,0,9,0,D,2003
21487,6,27,Lawrence Nycholat,2,19,8,D,2006
21488,0,28,Lawrence Nycholat,0,3,0,D,2007
21489,1,29,Lawrence Nycholat,0,19,1,D,2008
21490,7,19,Lawson Crouse,5,72,12,LW,2016
21491,0,20,Lawson Crouse,1,11,1,LW,2017
21492,0,23,Layne Ulmer,0,1,0,C,2003
21493,2,19,Lee Fogolin,2,50,4,D,1974
21494,9,20,Lee Fogolin,0,58,9,D,1975
21495,15,21,Lee Fogolin,3,71,18,D,1976
21496,23,22,Lee Fogolin,0,76,23,D,1977
21497,19,23,Lee Fogolin,3,74,22,D,1978
21498,10,24,Lee Fogolin,5,80,15,D,1979
21499,17,25,Lee Fogolin,13,80,30,D,1980
21500,25,26,Lee Fogolin,4,80,29,D,1981
21501,18,27,Lee Fogolin,0,72,18,D,1982
21502,16,28,Lee Fogolin,5,80,21,D,1983
21503,14,29,Lee Fogolin,4,79,18,D,1984
21504,22,30,Lee Fogolin,4,80,26,D,1985
21505,5,31,Lee Fogolin,1,44,6,D,1986
21506,1,19,Lee Giffin,1,8,2,RW,1986
21507,2,20,Lee Giffin,0,19,2,RW,1987
21508,0,23,Lee Goren,2,21,2,RW,2000
21509,1,25,Lee Goren,2,14,3,RW,2002
21510,1,26,Lee Goren,0,2,1,RW,2003
21511,2,28,Lee Goren,1,28,3,RW,2005
21512,0,29,Lee Goren,0,2,0,RW,2006
21513,0,26,Lee Inglis,0,5,0,LW,1973
21514,0,26,Lee Inglis,0,5,0,LW,1973
21515,2,27,Lee Inglis,0,5,2,LW,1974
21516,2,27,Lee Inglis,0,5,2,LW,1974
21517,1,20,Lee Norwood,1,11,2,D,1980
21518,10,21,Lee Norwood,7,28,17,D,1981
21519,1,22,Lee Norwood,0,8,1,D,1982
21520,24,25,Lee Norwood,5,71,29,D,1985
21521,21,26,Lee Norwood,6,57,27,D,1986
21522,22,27,Lee Norwood,9,51,31,D,1987
21523,32,28,Lee Norwood,10,66,42,D,1988
21524,14,29,Lee Norwood,8,64,22,D,1989
21525,9,30,Lee Norwood,6,49,15,D,1990
21526,11,31,Lee Norwood,3,50,14,D,1991
21527,7,32,Lee Norwood,3,32,10,D,1992
21528,1,33,Lee Norwood,0,16,1,D,1993
21529,0,23,Lee Sorochan,0,2,0,D,1998
21530,0,24,Lee Sorochan,0,1,0,D,1999
21531,13,22,Lee Stempniak,14,57,27,RW,2005
21532,25,23,Lee Stempniak,27,82,52,RW,2006
21533,25,24,Lee Stempniak,13,80,38,RW,2007
21534,30,25,Lee Stempniak,14,75,44,RW,2008
21535,20,26,Lee Stempniak,28,80,48,RW,2009
21536,19,27,Lee Stempniak,19,82,38,RW,2010
21537,14,28,Lee Stempniak,14,61,28,RW,2011
21538,23,29,Lee Stempniak,9,47,32,RW,2012
21539,22,30,Lee Stempniak,12,73,34,RW,2013
21540,13,31,Lee Stempniak,15,71,28,RW,2014
21541,32,32,Lee Stempniak,19,82,51,RW,2015
21542,24,33,Lee Stempniak,16,82,40,RW,2016
21543,6,34,Lee Stempniak,3,37,9,RW,2017
21544,1,25,Lee Sweatt,1,3,2,D,2010
21545,16,27,Leif Rohlin,6,56,22,D,1995
21546,8,28,Leif Rohlin,2,40,10,D,1996
21547,29,27,Leif Svensson,2,74,31,D,1978
21548,11,28,Leif Svensson,4,47,15,D,1979
21549,0,21,Leigh Verstraete,0,3,0,RW,1982
21550,0,23,Leigh Verstraete,0,2,0,RW,1984
21551,1,26,Leigh Verstraete,0,3,1,RW,1987
21552,0,20,Len Barrie,0,1,0,C,1989
21553,2,23,Len Barrie,2,8,4,C,1992
21554,0,24,Len Barrie,0,2,0,C,1993
21555,11,25,Len Barrie,3,48,14,C,1994
21556,0,26,Len Barrie,0,5,0,C,1995
21557,14,30,Len Barrie,9,60,23,C,1999
21558,18,31,Len Barrie,5,60,23,LW,2000
21559,0,23,Len Esau,0,2,0,D,1991
21560,1,24,Len Esau,0,4,1,D,1992
21561,3,25,Len Esau,0,6,3,D,1993
21562,6,26,Len Esau,0,15,6,D,1994
21563,10,24,Len Fontaine,8,39,18,RW,1972
21564,1,25,Len Fontaine,0,7,1,RW,1973
21565,8,26,Len Fontaine,1,21,9,C,1974
21566,8,26,Len Fontaine,1,21,9,C,1974
21567,10,23,Len Frig,4,66,14,D,1973
21568,17,24,Len Frig,3,80,20,D,1974
21569,12,25,Len Frig,3,62,15,D,1975
21570,7,26,Len Frig,2,66,9,D,1976
21571,3,27,Len Frig,1,30,4,D,1977
21572,2,29,Len Frig,0,7,2,D,1979
21573,21,22,Len Hachborn,11,38,32,C,1983
21574,17,23,Len Hachborn,5,40,22,C,1984
21575,1,24,Len Hachborn,4,24,5,C,1985
21576,13,31,Len Lilyholm,8,77,21,LW,1972
21577,13,31,Len Lilyholm,8,77,21,LW,1972
21578,1,31,Len Lunde,0,7,1,C,1967
21579,3,34,Len Lunde,1,20,4,C,1970
21580,22,37,Len Lunde,26,72,48,LW,1973
21581,22,37,Len Lunde,26,72,48,LW,1973
21582,0,32,Len Ronson,0,5,0,LW,1968
21583,5,27,Lennart Petrell,4,60,9,C,2011
21584,6,28,Lennart Petrell,3,35,9,C,2012
21585,13,35,Leo Boivin,9,73,22,D,1967
21586,19,36,Leo Boivin,6,69,25,D,1968
21587,12,37,Leo Boivin,3,69,15,D,1969
21588,5,26,Leo Komarov,4,42,9,C,2012
21589,18,28,Leo Komarov,8,62,26,C,2014
21590,17,29,Leo Komarov,19,67,36,C,2015
21591,18,30,Leo Komarov,14,82,32,C,2016
21592,12,31,Leo Komarov,7,74,19,C,2017
21593,7,19,Leon Draisaitl,2,37,9,C,2014
21594,32,20,Leon Draisaitl,19,72,51,C,2015
21595,48,21,Leon Draisaitl,29,82,77,C,2016
21596,45,22,Leon Draisaitl,25,78,70,C,2017
21597,21,28,Leon Rochefort,21,74,42,RW,1967
21598,21,29,Leon Rochefort,14,65,35,RW,1968
21599,23,30,Leon Rochefort,9,76,32,RW,1969
21600,10,31,Leon Rochefort,5,57,15,RW,1970
21601,12,32,Leon Rochefort,17,64,29,RW,1971
21602,22,33,Leon Rochefort,11,74,33,RW,1972
21603,12,34,Leon Rochefort,10,56,22,RW,1973
21604,11,35,Leon Rochefort,18,76,29,RW,1974
21605,3,36,Leon Rochefort,0,11,3,RW,1975
21606,3,27,Les Auge,0,6,3,D,1980
21607,10,21,Lew Morrison,9,66,19,RW,1969
21608,7,22,Lew Morrison,5,78,12,RW,1970
21609,5,23,Lew Morrison,5,58,10,RW,1971
21610,9,24,Lew Morrison,6,78,15,RW,1972
21611,4,25,Lew Morrison,1,52,5,RW,1973
21612,9,26,Lew Morrison,7,70,16,RW,1974
21613,5,27,Lew Morrison,4,78,9,RW,1975
21614,1,28,Lew Morrison,2,76,3,RW,1976
21615,2,29,Lew Morrison,0,8,2,RW,1977
21616,0,23,Lex Hudson,0,2,0,D,1978
21617,1,20,Liam O'Brien,1,13,2,C,2014
21618,0,22,Liam O'Brien,0,1,0,LW,2016
21619,0,23,Liam O'Brien,0,3,0,C,2017
21620,0,22,Liam Reddox,0,1,0,LW,2007
21621,7,23,Liam Reddox,5,46,12,LW,2008
21622,2,24,Liam Reddox,0,9,2,LW,2009
21623,9,25,Liam Reddox,1,44,10,LW,2010
21624,1,19,Lias Andersson,1,7,2,C,2017
21625,0,23,Libor Pivko,0,1,0,LW,2003
21626,5,23,Libor Zabransky,1,34,6,D,1996
21627,1,24,Libor Zabransky,0,6,1,D,1997
21628,5,22,Linden Vey,0,18,5,RW,2013
21629,14,23,Linden Vey,10,75,24,RW,2014
21630,11,24,Linden Vey,4,41,15,RW,2015
21631,0,25,Linden Vey,0,4,0,RW,2016
21632,1,21,Lindsay Carson,0,18,1,C,1981
21633,19,22,Lindsay Carson,18,78,37,C,1982
21634,3,23,Lindsay Carson,1,16,4,C,1983
21635,19,24,Lindsay Carson,20,77,39,C,1984
21636,12,25,Lindsay Carson,9,50,21,LW,1985
21637,15,26,Lindsay Carson,11,71,26,LW,1986
21638,11,27,Lindsay Carson,7,63,18,LW,1987
21639,0,23,Lindsay Vallis,0,1,0,RW,1993
21640,14,19,Lindy Ruff,5,63,19,D,1979
21641,18,20,Lindy Ruff,8,65,26,RW,1980
21642,32,21,Lindy Ruff,16,79,48,D,1981
21643,17,22,Lindy Ruff,12,60,29,LW,1982
21644,31,23,Lindy Ruff,14,58,45,RW,1983
21645,11,24,Lindy Ruff,13,39,24,LW,1984
21646,12,25,Lindy Ruff,20,54,32,LW,1985
21647,14,26,Lindy Ruff,6,50,20,LW,1986
21648,23,27,Lindy Ruff,2,77,25,D,1987
21649,16,28,Lindy Ruff,6,76,22,LW,1988
21650,6,29,Lindy Ruff,3,56,9,LW,1989
21651,1,30,Lindy Ruff,0,14,1,D,1990
21652,2,20,Link Gaetz,0,12,2,D,1988
21653,0,21,Link Gaetz,0,5,0,D,1989
21654,6,23,Link Gaetz,6,48,12,D,1991
21655,0,24,Linus Klasen,0,4,0,LW,2010
21656,22,23,Linus Omark,5,51,27,LW,2010
21657,0,24,Linus Omark,3,14,3,LW,2011
21658,2,26,Linus Omark,0,14,2,LW,2013
21659,1,19,Logan Brown,0,4,1,C,2017
21660,4,20,Logan Couture,5,25,9,C,2009
21661,24,21,Logan Couture,32,79,56,C,2010
21662,34,22,Logan Couture,31,80,65,C,2011
21663,16,23,Logan Couture,21,48,37,C,2012
21664,30,24,Logan Couture,23,65,53,C,2013
21665,40,25,Logan Couture,27,82,67,C,2014
21666,21,26,Logan Couture,15,52,36,C,2015
21667,27,27,Logan Couture,25,73,52,C,2016
21668,27,28,Logan Couture,34,78,61,C,2017
21669,2,24,Logan Shaw,5,53,7,RW,2015
21670,7,25,Logan Shaw,3,55,10,RW,2016
21671,4,26,Logan Shaw,2,30,6,RW,2017
21672,13,24,Lonnie Loach,10,53,23,LW,1992
21673,0,25,Lonnie Loach,0,3,0,LW,1993
21674,1,22,Lonny Bohonos,0,3,1,RW,1995
21675,11,23,Lonny Bohonos,11,36,22,RW,1996
21676,4,24,Lonny Bohonos,5,37,9,RW,1997
21677,0,25,Lonny Bohonos,3,7,3,RW,1998
21678,19,20,Lorne Henning,7,63,26,C,1972
21679,15,21,Lorne Henning,12,60,27,C,1973
21680,6,22,Lorne Henning,5,60,11,C,1974
21681,10,23,Lorne Henning,7,80,17,C,1975
21682,18,24,Lorne Henning,13,80,31,C,1976
21683,15,25,Lorne Henning,12,79,27,C,1977
21684,20,26,Lorne Henning,13,73,33,C,1978
21685,6,27,Lorne Henning,3,39,9,C,1979
21686,2,28,Lorne Henning,1,9,3,C,1980
21687,2,25,Lorne Rombough,1,3,3,LW,1973
21688,1,25,Lorne Stamler,2,7,3,LW,1976
21689,0,26,Lorne Stamler,0,2,0,LW,1977
21690,3,27,Lorne Stamler,4,45,7,LW,1978
21691,7,28,Lorne Stamler,8,62,15,LW,1979
21692,2,23,Lorry Gloeckner,0,13,2,D,1978
21693,37,30,Lou Angotti,12,70,49,C,1967
21694,20,31,Lou Angotti,17,71,37,C,1968
21695,26,32,Lou Angotti,12,70,38,C,1969
21696,16,33,Lou Angotti,9,65,25,C,1970
21697,10,34,Lou Angotti,5,65,15,C,1971
21698,22,35,Lou Angotti,15,77,37,C,1972
21699,23,36,Lou Angotti,12,51,35,C,1973
21700,5,37,Lou Angotti,2,26,7,C,1974
21701,0,27,Lou Crawford,0,7,0,LW,1989
21702,1,29,Lou Crawford,2,19,3,LW,1991
21703,10,23,Lou Franceschetti,2,30,12,RW,1981
21704,0,25,Lou Franceschetti,0,2,0,RW,1983
21705,7,26,Lou Franceschetti,4,22,11,LW,1984
21706,14,27,Lou Franceschetti,7,76,21,LW,1985
21707,9,28,Lou Franceschetti,12,75,21,LW,1986
21708,8,29,Lou Franceschetti,4,59,12,RW,1987
21709,10,30,Lou Franceschetti,7,63,17,LW,1988
21710,15,31,Lou Franceschetti,21,80,36,RW,1989
21711,8,32,Lou Franceschetti,2,51,10,LW,1990
21712,0,33,Lou Franceschetti,0,1,0,LW,1991
21713,1,26,Lou Nanne,0,2,1,D,1967
21714,12,27,Lou Nanne,2,41,14,D,1968
21715,20,28,Lou Nanne,3,74,23,D,1969
21716,11,29,Lou Nanne,5,68,16,D,1970
21717,28,30,Lou Nanne,21,78,49,RW,1971
21718,20,31,Lou Nanne,15,74,35,RW,1972
21719,21,32,Lou Nanne,11,76,32,RW,1973
21720,9,33,Lou Nanne,6,49,15,RW,1974
21721,14,34,Lou Nanne,3,79,17,RW,1975
21722,20,35,Lou Nanne,2,68,22,D,1976
21723,1,36,Lou Nanne,0,26,1,D,1977
21724,3,21,Lou Nistico,1,13,4,C,1973
21725,11,22,Lou Nistico,11,29,22,LW,1974
21726,11,22,Lou Nistico,11,29,22,LW,1974
21727,22,23,Lou Nistico,12,65,34,LW,1975
21728,22,23,Lou Nistico,12,65,34,LW,1975
21729,36,24,Lou Nistico,20,79,56,LW,1976
21730,36,24,Lou Nistico,20,79,56,LW,1976
21731,0,25,Lou Nistico,0,3,0,C,1977
21732,13,21,Loui Eriksson,6,59,19,LW,2006
21733,17,22,Loui Eriksson,14,69,31,LW,2007
21734,27,23,Loui Eriksson,36,82,63,LW,2008
21735,42,24,Loui Eriksson,29,82,71,LW,2009
21736,46,25,Loui Eriksson,27,79,73,LW,2010
21737,45,26,Loui Eriksson,26,82,71,LW,2011
21738,17,27,Loui Eriksson,12,48,29,LW,2012
21739,27,28,Loui Eriksson,10,61,37,RW,2013
21740,25,29,Loui Eriksson,22,81,47,LW,2014
21741,33,30,Loui Eriksson,30,82,63,RW,2015
21742,13,31,Loui Eriksson,11,65,24,LW,2016
21743,13,32,Loui Eriksson,10,50,23,LW,2017
21744,1,20,Louie DeBrusk,2,25,3,LW,1991
21745,2,21,Louie DeBrusk,8,51,10,LW,1992
21746,6,22,Louie DeBrusk,4,48,10,LW,1993
21747,0,23,Louie DeBrusk,2,34,2,LW,1994
21748,3,24,Louie DeBrusk,1,38,4,LW,1995
21749,0,25,Louie DeBrusk,2,32,2,LW,1996
21750,2,26,Louie DeBrusk,1,54,3,LW,1997
21751,0,27,Louie DeBrusk,0,15,0,LW,1998
21752,3,28,Louie DeBrusk,4,61,7,LW,1999
21753,0,29,Louie DeBrusk,0,39,0,RW,2000
21754,0,31,Louie DeBrusk,0,4,0,LW,2002
21755,2,21,Louis Belpedio,0,1,2,D,2017
21756,5,21,Louis Leblanc,5,42,10,C,2011
21757,0,23,Louis Leblanc,0,8,0,C,2013
21758,0,23,Louis Robitaille,0,2,0,D,2005
21759,12,20,Louis Sleigher,26,62,38,RW,1978
21760,1,21,Louis Sleigher,0,2,1,RW,1979
21761,0,23,Louis Sleigher,0,8,0,RW,1981
21762,10,24,Louis Sleigher,14,51,24,RW,1982
21763,19,25,Louis Sleigher,15,44,34,RW,1983
21764,21,26,Louis Sleigher,13,76,34,RW,1984
21765,2,27,Louis Sleigher,4,13,6,RW,1985
21766,24,26,Lowell MacDonald,21,74,45,RW,1967
21767,14,27,Lowell MacDonald,14,58,28,RW,1968
21768,1,29,Lowell MacDonald,0,10,1,LW,1970
21769,41,31,Lowell MacDonald,34,78,75,LW,1972
21770,39,32,Lowell MacDonald,43,78,82,LW,1973
21771,33,33,Lowell MacDonald,27,71,60,LW,1974
21772,43,34,Lowell MacDonald,30,69,73,LW,1975
21773,1,35,Lowell MacDonald,1,3,2,LW,1976
21774,8,36,Lowell MacDonald,5,19,13,LW,1977
21775,3,,Lubomir Penicka,0,7,3,LW,1977
21776,0,28,Lubomir Penicka,0,4,0,RW,1978
21777,0,28,Lubomir Penicka,0,4,0,RW,1978
21778,1,28,Lubomir Rohacik,0,5,1,RW,1978
21779,23,32,Lubomir Sekeras,11,80,34,D,2000
21780,20,33,Lubomir Sekeras,4,69,24,D,2001
21781,9,34,Lubomir Sekeras,2,60,11,D,2002
21782,1,35,Lubomir Sekeras,1,4,2,D,2003
21783,1,20,Lubomir Vaic,1,5,2,C,1997
21784,0,22,Lubomir Vaic,0,4,0,C,1999
21785,32,24,Lubomir Visnovsky,7,81,39,D,2000
21786,17,25,Lubomir Visnovsky,4,72,21,D,2001
21787,16,26,Lubomir Visnovsky,8,57,24,D,2002
21788,21,27,Lubomir Visnovsky,8,58,29,D,2003
21789,50,29,Lubomir Visnovsky,17,80,67,D,2005
21790,40,30,Lubomir Visnovsky,18,69,58,D,2006
21791,33,31,Lubomir Visnovsky,8,82,41,D,2007
21792,23,32,Lubomir Visnovsky,8,50,31,D,2008
21793,30,33,Lubomir Visnovsky,15,73,45,D,2009
21794,50,34,Lubomir Visnovsky,18,81,68,D,2010
21795,21,35,Lubomir Visnovsky,6,68,27,D,2011
21796,11,36,Lubomir Visnovsky,3,35,14,D,2012
21797,8,37,Lubomir Visnovsky,3,24,11,D,2013
21798,15,38,Lubomir Visnovsky,5,53,20,D,2014
21799,11,22,Lubos Bartecko,5,32,16,LW,1998
21800,23,23,Lubos Bartecko,16,67,39,LW,1999
21801,8,24,Lubos Bartecko,5,50,13,LW,2000
21802,14,25,Lubos Bartecko,13,71,27,LW,2001
21803,9,26,Lubos Bartecko,7,37,16,LW,2002
21804,0,19,Luc Bourdon,0,9,0,D,2006
21805,0,20,Luc Bourdon,2,27,2,D,2007
21806,11,19,Luc Dufour,14,73,25,LW,1982
21807,4,20,Luc Dufour,6,41,10,LW,1983
21808,6,21,Luc Dufour,3,53,9,LW,1984
21809,0,26,Luc Gauthier,0,3,0,D,1990
21810,39,20,Luc Robitaille,45,79,84,LW,1986
21811,58,21,Luc Robitaille,53,80,111,LW,1987
21812,52,22,Luc Robitaille,46,78,98,LW,1988
21813,49,23,Luc Robitaille,52,80,101,LW,1989
21814,46,24,Luc Robitaille,45,76,91,LW,1990
21815,63,25,Luc Robitaille,44,80,107,LW,1991
21816,62,26,Luc Robitaille,63,84,125,LW,1992
21817,42,27,Luc Robitaille,44,83,86,LW,1993
21818,19,28,Luc Robitaille,23,46,42,LW,1994
21819,46,29,Luc Robitaille,23,77,69,LW,1995
21820,24,30,Luc Robitaille,24,69,48,LW,1996
21821,24,31,Luc Robitaille,16,57,40,LW,1997
21822,35,32,Luc Robitaille,39,82,74,LW,1998
21823,38,33,Luc Robitaille,36,71,74,LW,1999
21824,51,34,Luc Robitaille,37,82,88,LW,2000
21825,20,35,Luc Robitaille,30,81,50,LW,2001
21826,20,36,Luc Robitaille,11,81,31,LW,2002
21827,29,37,Luc Robitaille,22,80,51,LW,2003
21828,9,39,Luc Robitaille,15,65,24,LW,2005
21829,0,20,Luca Caputi,1,5,1,LW,2008
21830,6,21,Luca Caputi,2,23,8,LW,2009
21831,0,22,Luca Caputi,0,7,0,LW,2010
21832,7,19,Luca Sbisa,0,39,7,D,2008
21833,0,20,Luca Sbisa,0,8,0,D,2009
21834,9,21,Luca Sbisa,2,68,11,D,2010
21835,19,22,Luca Sbisa,5,80,24,D,2011
21836,7,23,Luca Sbisa,1,41,8,D,2012
21837,5,24,Luca Sbisa,1,30,6,D,2013
21838,8,25,Luca Sbisa,3,76,11,D,2014
21839,6,26,Luca Sbisa,2,41,8,D,2015
21840,11,27,Luca Sbisa,2,82,13,D,2016
21841,12,28,Luca Sbisa,2,30,14,D,2017
21842,0,21,Lucas Lessio,0,3,0,LW,2013
21843,3,22,Lucas Lessio,2,26,5,LW,2014
21844,1,23,Lucas Lessio,1,12,2,LW,2015
21845,2,21,Lucas Wallmark,0,8,2,C,2016
21846,0,22,Lucas Wallmark,1,11,1,C,2017
21847,1,25,Luciano Borsato,0,1,1,C,1990
21848,21,26,Luciano Borsato,15,56,36,RW,1991
21849,20,27,Luciano Borsato,15,67,35,C,1992
21850,13,28,Luciano Borsato,5,75,18,RW,1993
21851,0,29,Luciano Borsato,0,4,0,C,1994
21852,8,20,Lucien DeBlois,22,71,30,RW,1977
21853,17,21,Lucien DeBlois,11,62,28,RW,1978
21854,20,22,Lucien DeBlois,27,76,47,RW,1979
21855,16,23,Lucien DeBlois,26,74,42,RW,1980
21856,27,24,Lucien DeBlois,25,65,52,RW,1981
21857,27,25,Lucien DeBlois,27,79,54,RW,1982
21858,45,26,Lucien DeBlois,34,80,79,RW,1983
21859,11,27,Lucien DeBlois,12,51,23,RW,1984
21860,17,28,Lucien DeBlois,14,61,31,RW,1985
21861,8,29,Lucien DeBlois,3,40,11,RW,1986
21862,21,30,Lucien DeBlois,9,74,30,C,1987
21863,24,31,Lucien DeBlois,9,73,33,C,1988
21864,8,32,Lucien DeBlois,9,70,17,LW,1989
21865,14,33,Lucien DeBlois,12,52,26,RW,1990
21866,13,34,Lucien DeBlois,9,65,22,LW,1991
21867,3,23,Lucien Grenier,2,23,5,RW,1969
21868,7,24,Lucien Grenier,9,68,16,RW,1970
21869,4,25,Lucien Grenier,3,60,7,RW,1971
21870,0,,Ludimir Ozlizlo,0,6,0,D,1977
21871,0,,Ludimir Ozlizlo,0,6,0,D,1977
21872,0,22,Lukas Kaspar,0,3,0,LW,2007
21873,2,23,Lukas Kaspar,2,13,4,LW,2008
21874,0,18,Lukas Krajicek,0,5,0,D,2001
21875,6,20,Lukas Krajicek,1,18,7,D,2003
21876,14,22,Lukas Krajicek,2,67,16,D,2005
21877,13,23,Lukas Krajicek,3,78,16,D,2006
21878,9,24,Lukas Krajicek,2,39,11,D,2007
21879,17,25,Lukas Krajicek,2,71,19,D,2008
21880,2,26,Lukas Krajicek,1,50,3,D,2009
21881,6,23,Lukas Sedlak,7,62,13,LW,2016
21882,4,24,Lukas Sedlak,4,53,8,LW,2017
21883,1,20,Luke Adam,3,19,4,LW,2010
21884,10,21,Luke Adam,10,52,20,LW,2011
21885,0,22,Luke Adam,1,4,1,LW,2012
21886,0,23,Luke Adam,1,12,1,C,2013
21887,0,24,Luke Adam,0,3,0,C,2014
21888,2,24,Luke Gazdic,2,67,4,LW,2013
21889,1,25,Luke Gazdic,2,40,3,LW,2014
21890,0,26,Luke Gazdic,1,29,1,LW,2015
21891,0,27,Luke Gazdic,0,11,0,LW,2016
21892,6,24,Luke Glendening,1,56,7,C,2013
21893,6,25,Luke Glendening,12,82,18,C,2014
21894,13,26,Luke Glendening,8,81,21,C,2015
21895,11,27,Luke Glendening,3,74,14,C,2016
21896,8,28,Luke Glendening,11,69,19,RW,2017
21897,2,20,Luke Kunin,2,19,4,C,2017
21898,6,18,Luke Richardson,4,78,10,D,1987
21899,7,19,Luke Richardson,2,55,9,D,1988
21900,14,20,Luke Richardson,4,67,18,D,1989
21901,9,21,Luke Richardson,1,78,10,D,1990
21902,19,22,Luke Richardson,2,75,21,D,1991
21903,10,23,Luke Richardson,3,82,13,D,1992
21904,6,24,Luke Richardson,2,69,8,D,1993
21905,10,25,Luke Richardson,3,46,13,D,1994
21906,9,26,Luke Richardson,2,82,11,D,1995
21907,11,27,Luke Richardson,1,82,12,D,1996
21908,3,28,Luke Richardson,2,81,5,D,1997
21909,6,29,Luke Richardson,0,78,6,D,1998
21910,5,30,Luke Richardson,2,74,7,D,1999
21911,6,31,Luke Richardson,2,82,8,D,2000
21912,8,32,Luke Richardson,1,72,9,D,2001
21913,13,33,Luke Richardson,0,82,13,D,2002
21914,5,34,Luke Richardson,1,64,6,D,2003
21915,9,36,Luke Richardson,1,65,10,D,2005
21916,3,37,Luke Richardson,0,27,3,D,2006
21917,7,38,Luke Richardson,2,76,9,D,2007
21918,0,39,Luke Richardson,0,2,0,D,2008
21919,12,19,Luke Schenn,2,70,14,D,2008
21920,12,20,Luke Schenn,5,79,17,D,2009
21921,17,21,Luke Schenn,5,82,22,D,2010
21922,20,22,Luke Schenn,2,79,22,D,2011
21923,8,23,Luke Schenn,3,47,11,D,2012
21924,8,24,Luke Schenn,4,79,12,D,2013
21925,11,25,Luke Schenn,3,58,14,D,2014
21926,12,26,Luke Schenn,4,72,16,D,2015
21927,7,27,Luke Schenn,1,78,8,D,2016
21928,6,28,Luke Schenn,1,64,7,D,2017
21929,0,20,Luke Sellars,0,1,0,D,2001
21930,0,24,Luke Witkowski,0,16,0,D,2014
21931,0,25,Luke Witkowski,0,4,0,D,2015
21932,4,26,Luke Witkowski,0,34,4,D,2016
21933,3,27,Luke Witkowski,1,31,4,RW,2017
21934,0,30,Lyle Bradley,1,4,1,C,1973
21935,0,33,Lyle Bradley,0,2,0,C,1976
21936,0,24,Lyle Moffat,0,1,0,LW,1972
21937,7,26,Lyle Moffat,2,22,9,LW,1974
21938,16,27,Lyle Moffat,17,75,33,LW,1975
21939,16,27,Lyle Moffat,17,75,33,LW,1975
21940,11,28,Lyle Moffat,13,74,24,LW,1976
21941,11,28,Lyle Moffat,13,74,24,LW,1976
21942,16,29,Lyle Moffat,9,57,25,LW,1977
21943,16,29,Lyle Moffat,9,57,25,LW,1977
21944,18,30,Lyle Moffat,14,70,32,LW,1978
21945,18,30,Lyle Moffat,14,70,32,LW,1978
21946,9,31,Lyle Moffat,10,74,19,LW,1979
21947,2,21,Lyle Odelein,0,8,2,D,1989
21948,2,22,Lyle Odelein,0,52,2,D,1990
21949,7,23,Lyle Odelein,1,71,8,D,1991
21950,14,24,Lyle Odelein,2,83,16,D,1992
21951,29,25,Lyle Odelein,11,79,40,D,1993
21952,7,26,Lyle Odelein,3,48,10,D,1994
21953,14,27,Lyle Odelein,3,79,17,D,1995
21954,13,28,Lyle Odelein,3,79,16,D,1996
21955,19,29,Lyle Odelein,4,79,23,D,1997
21956,26,30,Lyle Odelein,5,70,31,D,1998
21957,22,31,Lyle Odelein,2,73,24,D,1999
21958,14,32,Lyle Odelein,3,81,17,D,2000
21959,16,33,Lyle Odelein,2,77,18,D,2001
21960,4,34,Lyle Odelein,7,68,11,D,2002
21961,12,35,Lyle Odelein,4,82,16,D,2003
21962,1,37,Lyle Odelein,0,27,1,D,2005
21963,1,24,Lyle Phair,0,15,1,LW,1985
21964,0,25,Lyle Phair,2,5,2,LW,1986
21965,6,26,Lyle Phair,4,28,10,LW,1987
21966,4,19,Lyndon Byers,2,10,6,RW,1983
21967,8,20,Lyndon Byers,3,33,11,RW,1984
21968,2,21,Lyndon Byers,0,5,2,RW,1985
21969,3,22,Lyndon Byers,2,18,5,RW,1986
21970,14,23,Lyndon Byers,10,53,24,RW,1987
21971,4,24,Lyndon Byers,0,49,4,RW,1988
21972,4,25,Lyndon Byers,4,43,8,RW,1989
21973,2,26,Lyndon Byers,2,19,4,RW,1990
21974,1,27,Lyndon Byers,1,31,2,RW,1991
21975,1,28,Lyndon Byers,4,18,5,RW,1992
21976,0,21,Lynn Loyns,3,19,3,LW,2002
21977,2,22,Lynn Loyns,0,14,2,LW,2003
21978,0,24,Lynn Loyns,0,1,0,LW,2005
21979,13,24,Lynn Powis,8,57,21,C,1973
21980,20,25,Lynn Powis,11,73,31,C,1974
21981,10,26,Lynn Powis,4,21,14,C,1975
21982,10,26,Lynn Powis,4,21,14,C,1975
21983,30,27,Lynn Powis,30,63,60,C,1976
21984,30,27,Lynn Powis,30,63,60,C,1976
21985,25,28,Lynn Powis,16,69,41,C,1977
21986,19,28,Lynn Powis,12,55,31,C,1977
21987,6,28,Lynn Powis,4,14,10,C,1977
21988,25,28,Lynn Powis,16,69,41,C,1977
21989,19,28,Lynn Powis,12,55,31,C,1977
21990,6,28,Lynn Powis,4,14,10,C,1977
21991,0,24,MacGregor Sharp,0,8,0,C,2009
21992,0,23,MacKenzie Weegar,0,3,0,D,2016
21993,6,24,MacKenzie Weegar,2,60,8,D,2017
21994,12,22,Madison Bowey,0,51,12,D,2017
21995,15,26,Magnus Arvedson,11,61,26,LW,1997
21996,26,27,Magnus Arvedson,21,80,47,LW,1998
21997,13,28,Magnus Arvedson,15,47,28,LW,1999
21998,16,29,Magnus Arvedson,17,51,33,LW,2000
21999,27,30,Magnus Arvedson,12,74,39,LW,2001
22000,21,31,Magnus Arvedson,16,80,37,LW,2002
22001,7,32,Magnus Arvedson,8,41,15,C,2003
22002,14,34,Magnus Johansson,0,45,14,D,2007
22003,19,19,Magnus Paajarvi,15,80,34,LW,2010
22004,6,20,Magnus Paajarvi,2,41,8,LW,2011
22005,7,21,Magnus Paajarvi,9,42,16,LW,2012
22006,6,22,Magnus Paajarvi,6,55,12,LW,2013
22007,1,23,Magnus Paajarvi,0,10,1,LW,2014
22008,6,24,Magnus Paajarvi,3,48,9,LW,2015
22009,5,25,Magnus Paajarvi,8,32,13,LW,2016
22010,2,26,Magnus Paajarvi,6,35,8,LW,2017
22011,4,24,Magnus Roupe,2,33,6,LW,1987
22012,1,25,Magnus Roupe,1,7,2,LW,1988
22013,5,31,Magnus Svensson,2,19,7,D,1994
22014,9,32,Magnus Svensson,2,27,11,D,1995
22015,0,19,Maksim Mayorov,0,3,0,RW,2008
22016,0,20,Maksim Mayorov,0,4,0,LW,2009
22017,0,21,Maksim Mayorov,1,5,1,LW,2010
22018,1,22,Maksim Mayorov,1,10,2,LW,2011
22019,0,22,Mal Davis,0,6,0,RW,1978
22020,0,24,Mal Davis,2,5,2,LW,1980
22021,12,26,Mal Davis,8,24,20,LW,1982
22022,1,27,Mal Davis,2,11,3,LW,1983
22023,9,28,Mal Davis,17,47,26,RW,1984
22024,0,29,Mal Davis,2,7,2,LW,1985
22025,8,18,Manny Malhotra,8,73,16,C,1998
22026,0,19,Manny Malhotra,0,27,0,C,1999
22027,8,20,Manny Malhotra,4,50,12,C,2000
22028,6,21,Manny Malhotra,8,72,14,C,2001
22029,7,22,Manny Malhotra,3,59,10,C,2002
22030,13,23,Manny Malhotra,12,65,25,C,2003
22031,21,25,Manny Malhotra,10,58,31,C,2005
22032,16,26,Manny Malhotra,9,82,25,C,2006
22033,18,27,Manny Malhotra,11,71,29,C,2007
22034,24,28,Manny Malhotra,11,77,35,C,2008
22035,19,29,Manny Malhotra,14,71,33,C,2009
22036,19,30,Manny Malhotra,11,72,30,C,2010
22037,11,31,Manny Malhotra,7,78,18,C,2011
22038,0,32,Manny Malhotra,0,9,0,C,2012
22039,6,33,Manny Malhotra,7,69,13,C,2013
22040,3,34,Manny Malhotra,1,58,4,C,2014
22041,6,19,Marc Bergevin,0,60,6,D,1984
22042,7,20,Marc Bergevin,7,71,14,D,1985
22043,10,21,Marc Bergevin,4,66,14,D,1986
22044,6,22,Marc Bergevin,1,58,7,D,1987
22045,13,23,Marc Bergevin,2,69,15,D,1988
22046,4,24,Marc Bergevin,0,18,4,D,1989
22047,0,25,Marc Bergevin,0,4,0,D,1990
22048,17,26,Marc Bergevin,7,75,24,D,1991
22049,12,27,Marc Bergevin,2,78,14,D,1992
22050,15,28,Marc Bergevin,1,83,16,D,1993
22051,4,29,Marc Bergevin,2,44,6,D,1994
22052,9,30,Marc Bergevin,1,70,10,D,1995
22053,4,31,Marc Bergevin,0,82,4,D,1996
22054,7,32,Marc Bergevin,3,81,10,D,1997
22055,1,33,Marc Bergevin,1,52,2,D,1998
22056,8,34,Marc Bergevin,1,81,9,D,1999
22057,4,35,Marc Bergevin,1,38,5,D,2000
22058,3,36,Marc Bergevin,0,30,3,D,2001
22059,5,37,Marc Bergevin,2,70,7,D,2002
22060,10,38,Marc Bergevin,1,61,11,D,2003
22061,0,23,Marc Bureau,0,5,0,C,1989
22062,6,24,Marc Bureau,0,14,6,C,1990
22063,4,25,Marc Bureau,6,46,10,C,1991
22064,21,26,Marc Bureau,10,63,31,RW,1992
22065,7,27,Marc Bureau,8,75,15,C,1993
22066,12,28,Marc Bureau,2,48,14,C,1994
22067,7,29,Marc Bureau,3,65,10,C,1995
22068,9,30,Marc Bureau,6,43,15,C,1996
22069,6,31,Marc Bureau,13,74,19,C,1997
22070,6,32,Marc Bureau,4,71,10,C,1998
22071,5,33,Marc Bureau,3,63,8,C,1999
22072,6,21,Marc Chorney,1,8,7,D,1980
22073,6,22,Marc Chorney,1,60,7,D,1981
22074,5,23,Marc Chorney,3,67,8,D,1982
22075,10,24,Marc Chorney,3,75,13,D,1983
22076,4,23,Marc Chouinard,3,44,7,C,2000
22077,5,24,Marc Chouinard,4,45,9,C,2001
22078,4,25,Marc Chouinard,3,70,7,C,2002
22079,10,26,Marc Chouinard,11,45,21,C,2003
22080,16,28,Marc Chouinard,14,74,30,C,2005
22081,2,29,Marc Chouinard,2,42,4,C,2006
22082,8,20,Marc Crawford,4,40,12,LW,1981
22083,5,21,Marc Crawford,4,41,9,LW,1982
22084,1,22,Marc Crawford,0,19,1,LW,1983
22085,0,23,Marc Crawford,0,1,0,LW,1984
22086,14,24,Marc Crawford,11,54,25,LW,1985
22087,3,25,Marc Crawford,0,21,3,LW,1986
22088,0,27,Marc Dufour,0,2,0,RW,1968
22089,10,21,Marc Fortier,4,27,14,C,1987
22090,19,22,Marc Fortier,20,57,39,C,1988
22091,17,23,Marc Fortier,13,59,30,RW,1989
22092,4,24,Marc Fortier,0,14,4,C,1990
22093,9,25,Marc Fortier,5,39,14,C,1991
22094,1,26,Marc Fortier,0,16,1,C,1992
22095,3,18,Marc Habscheid,1,7,4,C,1981
22096,10,19,Marc Habscheid,3,32,13,C,1982
22097,0,20,Marc Habscheid,1,9,1,C,1983
22098,3,21,Marc Habscheid,5,26,8,RW,1984
22099,3,22,Marc Habscheid,2,6,5,C,1985
22100,0,23,Marc Habscheid,2,15,2,C,1986
22101,11,24,Marc Habscheid,4,16,15,C,1987
22102,31,25,Marc Habscheid,23,76,54,RW,1988
22103,11,26,Marc Habscheid,15,66,26,LW,1989
22104,8,27,Marc Habscheid,9,46,17,RW,1990
22105,11,28,Marc Habscheid,7,46,18,LW,1991
22106,0,27,Marc Labelle,0,9,0,LW,1996
22107,0,22,Marc Laforge,0,9,0,D,1989
22108,0,26,Marc Laforge,0,5,0,D,1993
22109,1,20,Marc Magnan,0,4,1,LW,1982
22110,4,21,Marc Methot,0,20,4,D,2006
22111,0,22,Marc Methot,0,9,0,D,2007
22112,13,23,Marc Methot,4,66,17,D,2008
22113,6,24,Marc Methot,2,60,8,D,2009
22114,15,25,Marc Methot,0,74,15,D,2010
22115,6,26,Marc Methot,1,46,7,D,2011
22116,9,27,Marc Methot,2,47,11,D,2012
22117,17,28,Marc Methot,6,75,23,D,2013
22118,10,29,Marc Methot,1,45,11,D,2014
22119,7,30,Marc Methot,5,69,12,D,2015
22120,12,31,Marc Methot,0,68,12,D,2016
22121,2,32,Marc Methot,1,36,3,D,2017
22122,0,20,Marc Moro,0,1,0,D,1997
22123,0,22,Marc Moro,0,8,0,D,1999
22124,0,23,Marc Moro,0,6,0,D,2000
22125,0,24,Marc Moro,0,15,0,D,2001
22126,0,24,Marc Potvin,0,9,0,RW,1990
22127,0,25,Marc Potvin,1,5,1,RW,1991
22128,1,26,Marc Potvin,0,20,1,RW,1992
22129,3,27,Marc Potvin,2,54,5,RW,1993
22130,1,28,Marc Potvin,0,6,1,RW,1994
22131,0,29,Marc Potvin,0,27,0,RW,1995
22132,0,20,Marc Pouliot,1,8,1,C,2005
22133,7,21,Marc Pouliot,4,46,11,C,2006
22134,6,22,Marc Pouliot,1,24,7,C,2007
22135,12,23,Marc Pouliot,8,63,20,C,2008
22136,7,24,Marc Pouliot,7,35,14,C,2009
22137,0,25,Marc Pouliot,0,3,0,C,2010
22138,4,26,Marc Pouliot,0,13,4,C,2011
22139,2,36,Marc Reaume,0,27,2,D,1970
22140,1,27,Marc Rodgers,1,21,2,RW,1999
22141,5,20,Marc Savard,1,28,6,C,1997
22142,36,21,Marc Savard,9,70,45,C,1998
22143,31,22,Marc Savard,22,78,53,C,1999
22144,42,23,Marc Savard,23,77,65,C,2000
22145,19,24,Marc Savard,14,56,33,C,2001
22146,33,25,Marc Savard,17,67,50,C,2002
22147,33,26,Marc Savard,19,45,52,C,2003
22148,69,28,Marc Savard,28,82,97,C,2005
22149,74,29,Marc Savard,22,82,96,C,2006
22150,63,30,Marc Savard,15,74,78,C,2007
22151,63,31,Marc Savard,25,82,88,C,2008
22152,23,32,Marc Savard,10,41,33,C,2009
22153,8,33,Marc Savard,2,25,10,C,2010
22154,8,21,Marc Staal,2,80,10,D,2007
22155,12,22,Marc Staal,3,82,15,D,2008
22156,19,23,Marc Staal,8,82,27,D,2009
22157,22,24,Marc Staal,7,77,29,D,2010
22158,3,25,Marc Staal,2,46,5,D,2011
22159,9,26,Marc Staal,2,21,11,D,2012
22160,11,27,Marc Staal,3,72,14,D,2013
22161,15,28,Marc Staal,5,80,20,D,2014
22162,13,29,Marc Staal,2,77,15,D,2015
22163,7,30,Marc Staal,3,72,10,D,2016
22164,7,31,Marc Staal,1,72,8,D,2017
22165,2,20,Marc Tardif,3,18,5,LW,1969
22166,30,21,Marc Tardif,19,76,49,LW,1970
22167,22,22,Marc Tardif,31,75,53,LW,1971
22168,25,23,Marc Tardif,25,76,50,LW,1972
22169,30,24,Marc Tardif,40,75,70,LW,1973
22170,30,24,Marc Tardif,40,75,70,LW,1973
22171,39,25,Marc Tardif,50,76,89,LW,1974
22172,34,25,Marc Tardif,38,53,72,LW,1974
22173,5,25,Marc Tardif,12,23,17,LW,1974
22174,5,25,Marc Tardif,12,23,17,LW,1974
22175,77,26,Marc Tardif,71,81,148,LW,1975
22176,77,26,Marc Tardif,71,81,148,LW,1975
22177,60,27,Marc Tardif,49,62,109,LW,1976
22178,60,27,Marc Tardif,49,62,109,LW,1976
22179,89,28,Marc Tardif,65,78,154,LW,1977
22180,89,28,Marc Tardif,65,78,154,LW,1977
22181,55,29,Marc Tardif,41,74,96,LW,1978
22182,55,29,Marc Tardif,41,74,96,LW,1978
22183,35,30,Marc Tardif,33,58,68,LW,1979
22184,31,31,Marc Tardif,23,63,54,LW,1980
22185,31,32,Marc Tardif,39,75,70,C,1981
22186,31,33,Marc Tardif,21,76,52,LW,1982
22187,1,22,Marc-Andre Bergeron,1,5,2,D,2002
22188,17,23,Marc-Andre Bergeron,9,54,26,D,2003
22189,20,25,Marc-Andre Bergeron,15,75,35,D,2005
22190,32,26,Marc-Andre Bergeron,14,78,46,D,2006
22191,10,27,Marc-Andre Bergeron,9,55,19,D,2007
22192,18,28,Marc-Andre Bergeron,14,72,32,D,2008
22193,21,29,Marc-Andre Bergeron,13,60,34,D,2009
22194,6,30,Marc-Andre Bergeron,2,23,8,D,2010
22195,20,31,Marc-Andre Bergeron,4,43,24,D,2011
22196,8,32,Marc-Andre Bergeron,1,25,9,D,2012
22197,3,22,Marc-Andre Bourdon,4,45,7,D,2011
22198,0,22,Marc-Andre Cliche,0,1,0,RW,2009
22199,6,26,Marc-Andre Cliche,1,76,7,C,2013
22200,5,27,Marc-Andre Cliche,2,74,7,C,2014
22201,0,20,Marc-Andre Gragnani,0,2,0,LW,2007
22202,0,21,Marc-Andre Gragnani,0,4,0,D,2008
22203,2,23,Marc-Andre Gragnani,1,9,3,LW,2010
22204,13,24,Marc-Andre Gragnani,2,58,15,LW,2011
22205,0,25,Marc-Andre Gragnani,0,1,0,LW,2012
22206,0,28,Marc-Andre Gragnani,0,4,0,D,2015
22207,23,19,Marc-Edouard Vlasic,3,81,26,D,2006
22208,12,20,Marc-Edouard Vlasic,2,82,14,D,2007
22209,30,21,Marc-Edouard Vlasic,6,82,36,D,2008
22210,13,22,Marc-Edouard Vlasic,3,64,16,D,2009
22211,14,23,Marc-Edouard Vlasic,4,80,18,D,2010
22212,19,24,Marc-Edouard Vlasic,4,82,23,D,2011
22213,4,25,Marc-Edouard Vlasic,3,48,7,D,2012
22214,19,26,Marc-Edouard Vlasic,5,81,24,D,2013
22215,14,27,Marc-Edouard Vlasic,9,70,23,D,2014
22216,31,28,Marc-Edouard Vlasic,8,67,39,D,2015
22217,22,29,Marc-Edouard Vlasic,6,75,28,D,2016
22218,21,30,Marc-Edouard Vlasic,11,81,32,D,2017
22219,49,20,Marcel Dionne,28,78,77,C,1971
22220,50,21,Marcel Dionne,40,77,90,C,1972
22221,54,22,Marcel Dionne,24,74,78,C,1973
22222,74,23,Marcel Dionne,47,80,121,C,1974
22223,54,24,Marcel Dionne,40,80,94,C,1975
22224,69,25,Marcel Dionne,53,80,122,C,1976
22225,43,26,Marcel Dionne,36,70,79,C,1977
22226,71,27,Marcel Dionne,59,80,130,C,1978
22227,84,28,Marcel Dionne,53,80,137,C,1979
22228,77,29,Marcel Dionne,58,80,135,C,1980
22229,67,30,Marcel Dionne,50,78,117,C,1981
22230,51,31,Marcel Dionne,56,80,107,C,1982
22231,53,32,Marcel Dionne,39,66,92,C,1983
22232,80,33,Marcel Dionne,46,80,126,C,1984
22233,58,34,Marcel Dionne,36,80,94,C,1985
22234,56,35,Marcel Dionne,28,81,84,C,1986
22235,34,36,Marcel Dionne,31,67,65,C,1987
22236,16,37,Marcel Dionne,7,37,23,C,1988
22237,14,22,Marcel Goc,8,81,22,C,2005
22238,8,23,Marcel Goc,5,78,13,C,2006
22239,3,24,Marcel Goc,5,51,8,C,2007
22240,9,25,Marcel Goc,2,55,11,C,2008
22241,18,26,Marcel Goc,12,73,30,C,2009
22242,15,27,Marcel Goc,9,51,24,C,2010
22243,16,28,Marcel Goc,11,57,27,C,2011
22244,10,29,Marcel Goc,9,42,19,C,2012
22245,14,30,Marcel Goc,11,74,25,C,2013
22246,6,31,Marcel Goc,3,74,9,C,2014
22247,1,20,Marcel Hossa,3,10,4,LW,2001
22248,7,21,Marcel Hossa,6,34,13,LW,2002
22249,1,22,Marcel Hossa,1,15,2,LW,2003
22250,6,24,Marcel Hossa,10,64,16,LW,2005
22251,8,25,Marcel Hossa,10,64,18,LW,2006
22252,7,26,Marcel Hossa,1,50,8,LW,2007
22253,0,22,Marcel Mueller,0,3,0,C,2010
22254,17,37,Marcel Pronovost,3,70,20,D,1967
22255,2,38,Marcel Pronovost,1,34,3,D,1968
22256,1,39,Marcel Pronovost,0,7,1,D,1969
22257,2,20,Marco Scandella,0,20,2,D,2010
22258,9,21,Marco Scandella,3,63,12,D,2011
22259,0,22,Marco Scandella,1,6,1,D,2012
22260,14,23,Marco Scandella,3,76,17,D,2013
22261,12,24,Marco Scandella,11,64,23,D,2014
22262,16,25,Marco Scandella,5,73,21,D,2015
22263,9,26,Marco Scandella,4,71,13,D,2016
22264,17,27,Marco Scandella,5,82,22,D,2017
22265,20,19,Marco Sturm,10,74,30,C,1997
22266,22,20,Marco Sturm,16,78,38,C,1998
22267,15,21,Marco Sturm,12,74,27,LW,1999
22268,18,22,Marco Sturm,14,81,32,LW,2000
22269,20,23,Marco Sturm,21,77,41,LW,2001
22270,20,24,Marco Sturm,28,82,48,LW,2002
22271,20,25,Marco Sturm,21,64,41,RW,2003
22272,30,27,Marco Sturm,29,74,59,LW,2005
22273,17,28,Marco Sturm,27,76,44,LW,2006
22274,29,29,Marco Sturm,27,80,56,LW,2007
22275,6,30,Marco Sturm,7,19,13,LW,2008
22276,15,31,Marco Sturm,22,76,37,LW,2009
22277,11,32,Marco Sturm,5,35,16,LW,2010
22278,2,33,Marco Sturm,3,48,5,LW,2011
22279,7,20,Marcus Foligno,6,14,13,LW,2011
22280,13,21,Marcus Foligno,5,47,18,LW,2012
22281,12,22,Marcus Foligno,7,74,19,LW,2013
22282,12,23,Marcus Foligno,8,57,20,LW,2014
22283,13,24,Marcus Foligno,10,75,23,LW,2015
22284,10,25,Marcus Foligno,13,80,23,LW,2016
22285,15,26,Marcus Foligno,8,77,23,LW,2017
22286,14,20,Marcus Johansson,13,69,27,C,2010
22287,32,21,Marcus Johansson,14,80,46,C,2011
22288,16,22,Marcus Johansson,6,34,22,C,2012
22289,36,23,Marcus Johansson,8,80,44,C,2013
22290,27,24,Marcus Johansson,20,82,47,LW,2014
22291,29,25,Marcus Johansson,17,74,46,LW,2015
22292,34,26,Marcus Johansson,24,82,58,LW,2016
22293,9,27,Marcus Johansson,5,29,14,LW,2017
22294,0,20,Marcus Kruger,0,7,0,C,2010
22295,17,21,Marcus Kruger,9,71,26,C,2011
22296,9,22,Marcus Kruger,4,47,13,C,2012
22297,20,23,Marcus Kruger,8,81,28,C,2013
22298,10,24,Marcus Kruger,7,81,17,C,2014
22299,4,25,Marcus Kruger,0,41,4,C,2015
22300,12,26,Marcus Kruger,5,70,17,C,2016
22301,5,27,Marcus Kruger,1,48,6,C,2017
22302,1,20,Marcus Nilson,1,8,2,RW,1998
22303,2,21,Marcus Nilson,0,9,2,RW,1999
22304,24,22,Marcus Nilson,12,78,36,RW,2000
22305,19,23,Marcus Nilson,14,81,33,LW,2001
22306,19,24,Marcus Nilson,15,82,34,LW,2002
22307,13,25,Marcus Nilson,11,83,24,LW,2003
22308,11,27,Marcus Nilson,6,70,17,LW,2005
22309,10,28,Marcus Nilson,5,63,15,LW,2006
22310,2,29,Marcus Nilson,3,47,5,LW,2007
22311,3,21,Marcus Pettersson,1,22,4,D,2017
22312,31,24,Marcus Ragnarsson,8,71,39,D,1995
22313,14,25,Marcus Ragnarsson,3,69,17,D,1996
22314,20,26,Marcus Ragnarsson,5,79,25,D,1997
22315,13,27,Marcus Ragnarsson,0,74,13,D,1998
22316,13,28,Marcus Ragnarsson,3,63,16,D,1999
22317,12,29,Marcus Ragnarsson,3,68,15,D,2000
22318,15,30,Marcus Ragnarsson,5,70,20,D,2001
22319,13,31,Marcus Ragnarsson,3,68,16,D,2002
22320,9,32,Marcus Ragnarsson,7,70,16,D,2003
22321,3,24,Marcus Sorensen,1,19,4,RW,2016
22322,2,25,Marcus Sorensen,5,32,7,LW,2017
22323,1,24,Marek Hrivik,0,5,1,LW,2015
22324,2,25,Marek Hrivik,0,16,2,LW,2016
22325,0,26,Marek Hrivik,0,3,0,LW,2017
22326,1,19,Marek Malik,0,1,1,D,1994
22327,0,20,Marek Malik,0,7,0,D,1995
22328,5,21,Marek Malik,1,47,6,D,1996
22329,9,23,Marek Malik,2,52,11,D,1998
22330,10,24,Marek Malik,4,57,14,D,1999
22331,14,25,Marek Malik,6,61,20,D,2000
22332,19,26,Marek Malik,4,82,23,D,2001
22333,13,27,Marek Malik,7,79,20,D,2002
22334,16,28,Marek Malik,3,78,19,D,2003
22335,16,30,Marek Malik,2,74,18,D,2005
22336,19,31,Marek Malik,2,69,21,D,2006
22337,8,32,Marek Malik,2,42,10,D,2007
22338,5,33,Marek Malik,0,42,5,D,2008
22339,2,21,Marek Posmyk,1,18,3,D,1999
22340,0,22,Marek Posmyk,0,1,0,D,2000
22341,0,21,Marek Svatos,2,4,2,RW,2003
22342,18,23,Marek Svatos,32,61,50,RW,2005
22343,15,24,Marek Svatos,15,66,30,RW,2006
22344,11,25,Marek Svatos,26,62,37,RW,2007
22345,20,26,Marek Svatos,14,69,34,RW,2008
22346,4,27,Marek Svatos,7,54,11,RW,2009
22347,4,28,Marek Svatos,4,28,8,RW,2010
22348,39,26,Marek Zidlicky,14,82,53,D,2003
22349,37,28,Marek Zidlicky,12,67,49,D,2005
22350,26,29,Marek Zidlicky,4,79,30,D,2006
22351,38,30,Marek Zidlicky,5,79,43,D,2007
22352,30,31,Marek Zidlicky,12,76,42,D,2008
22353,37,32,Marek Zidlicky,6,78,43,D,2009
22354,17,33,Marek Zidlicky,7,46,24,D,2010
22355,20,34,Marek Zidlicky,2,63,22,D,2011
22356,15,35,Marek Zidlicky,4,48,19,D,2012
22357,30,36,Marek Zidlicky,12,81,42,D,2013
22358,27,37,Marek Zidlicky,7,84,34,D,2014
22359,12,38,Marek Zidlicky,4,53,16,D,2015
22360,0,28,Marian Bezak,2,4,2,RW,1978
22361,0,28,Marian Bezak,2,4,2,RW,1978
22362,0,21,Marian Cisar,0,3,0,RW,1999
22363,15,22,Marian Cisar,12,60,27,RW,2000
22364,2,23,Marian Cisar,1,10,3,RW,2001
22365,18,18,Marian Gaborik,18,71,36,LW,2000
22366,37,19,Marian Gaborik,30,78,67,RW,2001
22367,35,20,Marian Gaborik,30,81,65,RW,2002
22368,22,21,Marian Gaborik,18,65,40,RW,2003
22369,28,23,Marian Gaborik,38,65,66,RW,2005
22370,27,24,Marian Gaborik,30,48,57,RW,2006
22371,41,25,Marian Gaborik,42,77,83,RW,2007
22372,10,26,Marian Gaborik,13,17,23,RW,2008
22373,44,27,Marian Gaborik,42,76,86,RW,2009
22374,26,28,Marian Gaborik,22,62,48,RW,2010
22375,35,29,Marian Gaborik,41,82,76,RW,2011
22376,15,30,Marian Gaborik,12,47,27,RW,2012
22377,19,31,Marian Gaborik,11,41,30,RW,2013
22378,20,32,Marian Gaborik,27,69,47,RW,2014
22379,10,33,Marian Gaborik,12,54,22,RW,2015
22380,11,34,Marian Gaborik,10,56,21,RW,2016
22381,3,35,Marian Gaborik,4,16,7,RW,2017
22382,1,19,Marian Hossa,0,7,1,LW,1997
22383,15,20,Marian Hossa,15,60,30,LW,1998
22384,27,21,Marian Hossa,29,78,56,LW,1999
22385,43,22,Marian Hossa,32,81,75,RW,2000
22386,35,23,Marian Hossa,31,80,66,RW,2001
22387,35,24,Marian Hossa,45,80,80,RW,2002
22388,46,25,Marian Hossa,36,81,82,RW,2003
22389,53,27,Marian Hossa,39,80,92,RW,2005
22390,57,28,Marian Hossa,43,82,100,RW,2006
22391,37,29,Marian Hossa,29,72,66,RW,2007
22392,31,30,Marian Hossa,40,74,71,RW,2008
22393,27,31,Marian Hossa,24,57,51,RW,2009
22394,32,32,Marian Hossa,25,65,57,RW,2010
22395,48,33,Marian Hossa,29,81,77,RW,2011
22396,14,34,Marian Hossa,17,40,31,RW,2012
22397,30,35,Marian Hossa,30,72,60,RW,2013
22398,39,36,Marian Hossa,22,82,61,RW,2014
22399,20,37,Marian Hossa,13,64,33,RW,2015
22400,19,38,Marian Hossa,26,73,45,RW,2016
22401,54,29,Marian Stastny,35,74,89,RW,1981
22402,43,30,Marian Stastny,36,60,79,RW,1982
22403,32,31,Marian Stastny,20,68,52,RW,1983
22404,14,32,Marian Stastny,7,50,21,LW,1984
22405,30,33,Marian Stastny,23,70,53,RW,1985
22406,0,22,Mario Bliznak,0,2,0,C,2009
22407,0,23,Mario Bliznak,1,4,1,C,2010
22408,1,20,Mario Doyon,1,7,2,D,1988
22409,3,21,Mario Doyon,2,9,5,D,1989
22410,0,22,Mario Doyon,0,12,0,D,1990
22411,0,20,Mario Faubert,1,10,1,D,1974
22412,8,21,Mario Faubert,1,21,9,D,1975
22413,11,22,Mario Faubert,2,47,13,D,1976
22414,6,23,Mario Faubert,0,18,6,D,1977
22415,13,25,Mario Faubert,5,49,18,D,1979
22416,44,26,Mario Faubert,8,72,52,D,1980
22417,8,27,Mario Faubert,4,14,12,D,1981
22418,1,22,Mario Giallonardo,0,8,1,D,1979
22419,2,23,Mario Giallonardo,0,15,2,D,1980
22420,2,29,Mario Kempe,2,18,4,RW,2017
22421,0,20,Mario Larocque,0,5,0,D,1998
22422,57,19,Mario Lemieux,43,73,100,C,1984
22423,93,20,Mario Lemieux,48,79,141,C,1985
22424,53,21,Mario Lemieux,54,63,107,C,1986
22425,98,22,Mario Lemieux,70,77,168,C,1987
22426,114,23,Mario Lemieux,85,76,199,C,1988
22427,78,24,Mario Lemieux,45,59,123,C,1989
22428,26,25,Mario Lemieux,19,26,45,C,1990
22429,87,26,Mario Lemieux,44,64,131,C,1991
22430,91,27,Mario Lemieux,69,60,160,C,1992
22431,20,28,Mario Lemieux,17,22,37,C,1993
22432,92,30,Mario Lemieux,69,70,161,C,1995
22433,72,31,Mario Lemieux,50,76,122,LW,1996
22434,41,35,Mario Lemieux,35,43,76,C,2000
22435,25,36,Mario Lemieux,6,24,31,C,2001
22436,63,37,Mario Lemieux,28,67,91,C,2002
22437,8,38,Mario Lemieux,1,10,9,C,2003
22438,15,40,Mario Lemieux,7,26,22,C,2005
22439,1,20,Mario Marois,1,8,2,D,1977
22440,26,21,Mario Marois,5,71,31,D,1978
22441,23,22,Mario Marois,8,79,31,D,1979
22442,21,23,Mario Marois,5,69,26,D,1980
22443,32,24,Mario Marois,11,71,43,D,1981
22444,12,25,Mario Marois,2,36,14,D,1982
22445,36,26,Mario Marois,13,80,49,D,1983
22446,37,27,Mario Marois,6,76,43,D,1984
22447,40,28,Mario Marois,5,76,45,D,1985
22448,40,29,Mario Marois,4,79,44,D,1986
22449,44,30,Mario Marois,7,79,51,D,1987
22450,12,31,Mario Marois,3,49,15,D,1988
22451,15,32,Mario Marois,3,67,18,D,1989
22452,14,33,Mario Marois,2,64,16,D,1990
22453,4,34,Mario Marois,1,51,5,D,1991
22454,0,27,Mario Roberge,0,5,0,LW,1990
22455,1,28,Mario Roberge,2,20,3,LW,1991
22456,4,29,Mario Roberge,4,50,8,LW,1992
22457,2,30,Mario Roberge,1,28,3,LW,1993
22458,0,31,Mario Roberge,0,9,0,LW,1994
22459,0,23,Mario Thyer,0,5,0,C,1989
22460,18,18,Mario Tremblay,21,63,39,RW,1974
22461,16,19,Mario Tremblay,11,71,27,RW,1975
22462,28,20,Mario Tremblay,18,74,46,RW,1976
22463,14,21,Mario Tremblay,10,56,24,RW,1977
22464,29,22,Mario Tremblay,30,76,59,RW,1978
22465,26,23,Mario Tremblay,16,77,42,RW,1979
22466,38,24,Mario Tremblay,25,77,63,RW,1980
22467,40,25,Mario Tremblay,33,80,73,RW,1981
22468,37,26,Mario Tremblay,30,80,67,RW,1982
22469,25,27,Mario Tremblay,14,67,39,RW,1983
22470,35,28,Mario Tremblay,31,75,66,RW,1984
22471,20,29,Mario Tremblay,19,56,39,RW,1985
22472,1,21,Mariusz Czerkawski,2,4,3,RW,1993
22473,14,22,Mariusz Czerkawski,12,47,26,RW,1994
22474,23,23,Mariusz Czerkawski,17,70,40,RW,1995
22475,21,24,Mariusz Czerkawski,26,76,47,LW,1996
22476,13,25,Mariusz Czerkawski,12,68,25,RW,1997
22477,17,26,Mariusz Czerkawski,21,78,38,RW,1998
22478,35,27,Mariusz Czerkawski,35,79,70,RW,1999
22479,32,28,Mariusz Czerkawski,30,82,62,RW,2000
22480,29,29,Mariusz Czerkawski,22,82,51,RW,2001
22481,9,30,Mariusz Czerkawski,5,43,14,LW,2002
22482,24,31,Mariusz Czerkawski,25,81,49,RW,2003
22483,2,33,Mariusz Czerkawski,8,35,10,RW,2005
22484,0,23,Mark Alt,0,1,0,D,2014
22485,0,26,Mark Alt,0,7,0,D,2017
22486,0,24,Mark Arcobello,0,1,0,LW,2012
22487,14,25,Mark Arcobello,4,41,18,C,2013
22488,14,26,Mark Arcobello,17,77,31,C,2014
22489,1,27,Mark Arcobello,3,20,4,C,2015
22490,0,24,Mark Astley,0,1,0,D,1993
22491,1,25,Mark Astley,2,14,3,D,1994
22492,18,26,Mark Astley,2,60,20,D,1995
22493,0,22,Mark Barberio,0,2,0,D,2012
22494,5,23,Mark Barberio,5,49,10,D,2013
22495,6,24,Mark Barberio,1,52,7,D,2014
22496,8,25,Mark Barberio,2,30,10,D,2015
22497,4,26,Mark Barberio,0,26,4,D,2016
22498,10,27,Mark Barberio,3,46,13,D,2017
22499,0,22,Mark Beaufait,1,5,1,C,1992
22500,1,20,Mark Bell,0,13,1,C,2000
22501,16,21,Mark Bell,12,80,28,LW,2001
22502,15,22,Mark Bell,14,82,29,RW,2002
22503,24,23,Mark Bell,21,82,45,LW,2003
22504,23,25,Mark Bell,25,82,48,LW,2005
22505,10,26,Mark Bell,11,71,21,LW,2006
22506,6,27,Mark Bell,4,35,10,LW,2007
22507,0,31,Mark Bell,0,5,0,LW,2011
22508,0,22,Mark Borowiecki,0,2,0,D,2011
22509,0,23,Mark Borowiecki,0,6,0,D,2012
22510,0,24,Mark Borowiecki,1,13,1,D,2013
22511,10,25,Mark Borowiecki,1,63,11,D,2014
22512,1,26,Mark Borowiecki,1,63,2,D,2015
22513,2,27,Mark Borowiecki,1,70,3,D,2016
22514,8,28,Mark Borowiecki,3,52,11,D,2017
22515,10,20,Mark Botell,4,32,14,D,1981
22516,0,23,Mark Cornforth,0,6,0,D,1995
22517,9,27,Mark Cullen,7,29,16,C,2005
22518,0,28,Mark Cullen,0,3,0,C,2006
22519,1,33,Mark Cullen,0,6,1,C,2011
22520,2,22,Mark Cundari,1,4,3,D,2012
22521,0,23,Mark Cundari,0,4,0,D,2013
22522,1,22,Mark Eaton,1,27,2,D,1999
22523,8,23,Mark Eaton,3,34,11,D,2000
22524,5,24,Mark Eaton,3,58,8,D,2001
22525,7,25,Mark Eaton,2,50,9,D,2002
22526,9,26,Mark Eaton,4,75,13,D,2003
22527,1,28,Mark Eaton,3,69,4,D,2005
22528,3,29,Mark Eaton,0,35,3,D,2006
22529,3,30,Mark Eaton,0,36,3,D,2007
22530,5,31,Mark Eaton,4,68,9,D,2008
22531,13,32,Mark Eaton,3,79,16,D,2009
22532,3,33,Mark Eaton,0,34,3,D,2010
22533,3,34,Mark Eaton,1,62,4,D,2011
22534,0,35,Mark Eaton,0,23,0,D,2012
22535,10,23,Mark Fayne,4,57,14,D,2010
22536,13,24,Mark Fayne,4,82,17,D,2011
22537,5,25,Mark Fayne,1,31,6,D,2012
22538,7,26,Mark Fayne,4,72,11,D,2013
22539,6,27,Mark Fayne,2,74,8,D,2014
22540,5,28,Mark Fayne,2,69,7,D,2015
22541,2,29,Mark Fayne,0,4,2,D,2016
22542,3,21,Mark Ferner,0,13,3,D,1986
22543,0,23,Mark Ferner,0,2,0,D,1988
22544,0,24,Mark Ferner,0,2,0,D,1989
22545,1,25,Mark Ferner,0,7,1,D,1990
22546,5,28,Mark Ferner,3,50,8,D,1993
22547,1,29,Mark Ferner,0,17,1,D,1994
22548,2,21,Mark Fistric,0,37,2,D,2007
22549,4,22,Mark Fistric,0,36,4,D,2008
22550,9,23,Mark Fistric,1,67,10,D,2009
22551,3,24,Mark Fistric,2,57,5,D,2010
22552,2,25,Mark Fistric,0,60,2,D,2011
22553,6,26,Mark Fistric,0,25,6,D,2012
22554,5,27,Mark Fistric,0,34,5,D,2013
22555,0,28,Mark Fistric,0,9,0,D,2014
22556,1,25,Mark Flood,0,6,1,D,2009
22557,4,27,Mark Flood,3,33,7,D,2011
22558,0,20,Mark Fraser,0,7,0,D,2006
22559,3,23,Mark Fraser,3,61,6,D,2009
22560,2,24,Mark Fraser,0,26,2,D,2010
22561,0,25,Mark Fraser,0,4,0,D,2011
22562,8,26,Mark Fraser,0,45,8,D,2012
22563,1,27,Mark Fraser,1,42,2,D,2013
22564,4,28,Mark Fraser,0,34,4,D,2014
22565,1,18,Mark Freer,0,1,1,C,1986
22566,0,19,Mark Freer,0,1,0,C,1987
22567,1,20,Mark Freer,0,5,1,C,1988
22568,0,21,Mark Freer,0,2,0,C,1989
22569,7,23,Mark Freer,6,50,13,LW,1991
22570,14,24,Mark Freer,10,63,24,LW,1992
22571,0,25,Mark Freer,0,2,0,C,1993
22572,4,22,Mark Fusco,0,17,4,D,1983
22573,8,23,Mark Fusco,3,63,11,D,1984
22574,1,22,Mark Giordano,0,7,1,D,2005
22575,8,23,Mark Giordano,7,48,15,D,2006
22576,17,25,Mark Giordano,2,58,19,D,2008
22577,19,26,Mark Giordano,11,82,30,D,2009
22578,35,27,Mark Giordano,8,82,43,D,2010
22579,18,28,Mark Giordano,9,61,27,D,2011
22580,11,29,Mark Giordano,4,47,15,D,2012
22581,33,30,Mark Giordano,14,64,47,D,2013
22582,37,31,Mark Giordano,11,61,48,D,2014
22583,35,32,Mark Giordano,21,82,56,D,2015
22584,27,33,Mark Giordano,12,81,39,D,2016
22585,25,34,Mark Giordano,13,82,38,D,2017
22586,0,21,Mark Greig,0,4,0,RW,1990
22587,5,22,Mark Greig,0,17,5,RW,1991
22588,7,23,Mark Greig,1,22,8,RW,1992
22589,7,24,Mark Greig,6,44,13,RW,1993
22590,1,25,Mark Greig,1,8,2,RW,1994
22591,3,29,Mark Greig,1,7,4,RW,1998
22592,2,30,Mark Greig,3,11,5,RW,1999
22593,1,31,Mark Greig,1,7,2,RW,2000
22594,1,33,Mark Greig,0,5,1,RW,2002
22595,0,23,Mark Hamway,0,2,0,RW,1984
22596,12,24,Mark Hamway,5,49,17,RW,1985
22597,1,25,Mark Hamway,0,2,1,RW,1986
22598,1,20,Mark Hardy,0,15,1,D,1979
22599,20,21,Mark Hardy,5,77,25,D,1980
22600,39,22,Mark Hardy,6,77,45,D,1981
22601,34,23,Mark Hardy,5,74,39,D,1982
22602,41,24,Mark Hardy,8,79,49,D,1983
22603,39,25,Mark Hardy,14,78,53,D,1984
22604,21,26,Mark Hardy,6,55,27,D,1985
22605,27,27,Mark Hardy,3,73,30,D,1986
22606,24,28,Mark Hardy,8,80,32,D,1987
22607,16,29,Mark Hardy,4,60,20,D,1988
22608,15,30,Mark Hardy,0,54,15,D,1989
22609,5,31,Mark Hardy,1,70,6,D,1990
22610,8,32,Mark Hardy,1,52,9,D,1991
22611,13,33,Mark Hardy,1,55,14,D,1992
22612,3,34,Mark Hardy,0,16,3,D,1993
22613,0,24,Mark Hartigan,0,2,0,C,2001
22614,2,25,Mark Hartigan,5,23,7,C,2002
22615,3,26,Mark Hartigan,1,9,4,C,2003
22616,3,28,Mark Hartigan,9,33,12,C,2005
22617,2,29,Mark Hartigan,1,12,3,C,2006
22618,1,30,Mark Hartigan,3,23,4,C,2007
22619,0,25,Mark Heaslip,1,19,1,RW,1976
22620,10,26,Mark Heaslip,5,29,15,RW,1977
22621,9,27,Mark Heaslip,4,69,13,RW,1978
22622,56,24,Mark Howe,24,74,80,D,1979
22623,46,25,Mark Howe,19,63,65,LW,1980
22624,45,26,Mark Howe,8,76,53,D,1981
22625,47,27,Mark Howe,20,76,67,D,1982
22626,34,28,Mark Howe,19,71,53,D,1983
22627,39,29,Mark Howe,18,73,57,D,1984
22628,58,30,Mark Howe,24,77,82,D,1985
22629,43,31,Mark Howe,15,69,58,D,1986
22630,43,32,Mark Howe,19,75,62,D,1987
22631,29,33,Mark Howe,9,52,38,D,1988
22632,21,34,Mark Howe,7,40,28,D,1989
22633,10,35,Mark Howe,0,19,10,D,1990
22634,18,36,Mark Howe,7,42,25,D,1991
22635,31,37,Mark Howe,3,60,34,D,1992
22636,20,38,Mark Howe,4,44,24,D,1993
22637,5,39,Mark Howe,1,18,6,D,1994
22638,41,18,Mark Howe*,38,76,79,LW,1973
22639,41,18,Mark Howe*,38,76,79,LW,1973
22640,40,19,Mark Howe*,36,74,76,LW,1974
22641,40,19,Mark Howe*,36,74,76,LW,1974
22642,37,20,Mark Howe*,39,72,76,LW,1975
22643,37,20,Mark Howe*,39,72,76,LW,1975
22644,52,21,Mark Howe*,23,57,75,LW,1976
22645,52,21,Mark Howe*,23,57,75,LW,1976
22646,61,22,Mark Howe*,30,70,91,LW,1977
22647,61,22,Mark Howe*,30,70,91,LW,1977
22648,65,23,Mark Howe*,42,77,107,LW,1978
22649,65,23,Mark Howe*,42,77,107,LW,1978
22650,11,19,Mark Hunter,18,71,29,RW,1981
22651,8,20,Mark Hunter,8,31,16,RW,1982
22652,4,21,Mark Hunter,6,22,10,RW,1983
22653,12,22,Mark Hunter,21,72,33,RW,1984
22654,30,23,Mark Hunter,44,78,74,RW,1985
22655,33,24,Mark Hunter,36,74,69,RW,1986
22656,31,25,Mark Hunter,32,66,63,RW,1987
22657,8,26,Mark Hunter,22,66,30,RW,1988
22658,3,27,Mark Hunter,2,10,5,RW,1989
22659,18,28,Mark Hunter,14,68,32,RW,1990
22660,13,29,Mark Hunter,10,63,23,RW,1991
22661,0,30,Mark Hunter,0,7,0,RW,1992
22662,0,22,Mark Jankowski,0,1,0,C,2016
22663,8,23,Mark Jankowski,17,72,25,C,2017
22664,0,19,Mark Janssens,0,1,0,C,1987
22665,0,20,Mark Janssens,0,5,0,C,1988
22666,8,21,Mark Janssens,5,80,13,C,1989
22667,7,22,Mark Janssens,9,67,16,C,1990
22668,0,23,Mark Janssens,0,7,0,C,1991
22669,17,24,Mark Janssens,12,76,29,C,1992
22670,10,25,Mark Janssens,2,84,12,C,1993
22671,5,26,Mark Janssens,2,46,7,C,1994
22672,7,27,Mark Janssens,2,81,9,C,1995
22673,6,28,Mark Janssens,2,66,8,C,1996
22674,7,29,Mark Janssens,5,74,12,C,1997
22675,0,30,Mark Janssens,1,60,1,C,1998
22676,6,31,Mark Janssens,0,36,6,C,1999
22677,0,32,Mark Janssens,0,28,0,C,2000
22678,5,22,Mark Johnson,3,17,8,C,1979
22679,23,23,Mark Johnson,10,73,33,LW,1980
22680,13,24,Mark Johnson,12,56,25,C,1981
22681,38,25,Mark Johnson,31,73,69,LW,1982
22682,52,26,Mark Johnson,35,79,87,LW,1983
22683,34,27,Mark Johnson,23,66,57,LW,1984
22684,41,28,Mark Johnson,21,80,62,LW,1985
22685,26,29,Mark Johnson,25,68,51,LW,1986
22686,19,30,Mark Johnson,14,54,33,LW,1987
22687,25,31,Mark Johnson,13,40,38,C,1988
22688,29,32,Mark Johnson,16,63,45,C,1989
22689,3,22,Mark Kachowski,5,38,8,LW,1987
22690,1,23,Mark Kachowski,1,12,2,LW,1988
22691,1,24,Mark Kachowski,0,14,1,LW,1989
22692,1,21,Mark Katic,0,11,1,D,2010
22693,0,21,Mark Kirton,1,2,1,C,1979
22694,13,22,Mark Kirton,18,61,31,C,1980
22695,28,23,Mark Kirton,14,74,42,C,1981
22696,7,24,Mark Kirton,5,41,12,C,1982
22697,3,25,Mark Kirton,2,26,5,C,1983
22698,5,26,Mark Kirton,17,62,22,C,1984
22699,2,23,Mark Kolesar,2,21,4,RW,1995
22700,0,24,Mark Kolesar,0,7,0,RW,1996
22701,7,23,Mark Kumpel,8,42,15,RW,1984
22702,12,24,Mark Kumpel,10,47,22,RW,1985
22703,9,25,Mark Kumpel,1,45,10,RW,1986
22704,6,26,Mark Kumpel,4,45,10,RW,1987
22705,9,28,Mark Kumpel,8,56,17,LW,1989
22706,3,29,Mark Kumpel,7,53,10,RW,1990
22710,0,21,Mark Lamb,0,1,0,C,1985
22711,1,22,Mark Lamb,2,22,3,C,1986
22712,0,23,Mark Lamb,0,2,0,C,1987
22713,8,24,Mark Lamb,2,20,10,C,1988
22714,16,25,Mark Lamb,12,58,28,C,1989
22715,8,26,Mark Lamb,4,37,12,C,1990
22716,22,27,Mark Lamb,6,59,28,C,1991
22717,19,28,Mark Lamb,7,71,26,C,1992
22718,24,29,Mark Lamb,12,85,36,C,1993
22719,2,30,Mark Lamb,1,47,3,C,1994
22720,0,31,Mark Lamb,0,1,0,C,1995
22707,0,20,Mark LaVarre,0,2,0,RW,1985
22708,15,21,Mark LaVarre,8,58,23,RW,1986
22709,1,22,Mark LaVarre,1,18,2,RW,1987
22721,0,23,Mark Lawrence,0,2,0,RW,1994
22722,1,24,Mark Lawrence,0,13,1,RW,1995
22723,0,26,Mark Lawrence,0,2,0,RW,1997
22724,16,27,Mark Lawrence,14,60,30,RW,1998
22725,5,28,Mark Lawrence,1,29,6,RW,1999
22726,4,29,Mark Lawrence,3,36,7,RW,2000
22727,0,24,Mark Letestu,1,10,1,C,2009
22728,13,25,Mark Letestu,14,64,27,C,2010
22729,14,26,Mark Letestu,11,62,25,C,2011
22730,14,27,Mark Letestu,13,46,27,C,2012
22731,22,28,Mark Letestu,12,82,34,C,2013
22732,6,29,Mark Letestu,7,54,13,C,2014
22733,15,30,Mark Letestu,10,82,25,C,2015
22734,19,31,Mark Letestu,16,78,35,C,2016
22735,3,32,Mark Letestu,1,20,4,C,2017
22736,1,20,Mark Lofthouse,2,18,3,RW,1977
22737,10,21,Mark Lofthouse,13,52,23,RW,1978
22738,18,22,Mark Lofthouse,15,68,33,RW,1979
22739,1,23,Mark Lofthouse,1,3,2,RW,1980
22740,4,24,Mark Lofthouse,3,12,7,RW,1981
22741,4,25,Mark Lofthouse,8,28,12,RW,1982
22742,33,20,Mark Lomenda,16,69,49,RW,1974
22743,33,20,Mark Lomenda,16,69,49,RW,1974
22744,16,21,Mark Lomenda,6,39,22,RW,1975
22745,16,21,Mark Lomenda,6,39,22,RW,1975
22746,12,22,Mark Lomenda,9,56,21,RW,1976
22747,12,22,Mark Lomenda,9,56,21,RW,1976
22748,0,26,Mark Major,0,2,0,LW,1996
22749,1,21,Mark Mancari,0,3,1,RW,2006
22750,1,23,Mark Mancari,1,7,2,RW,2008
22751,1,24,Mark Mancari,1,6,2,RW,2009
22752,7,25,Mark Mancari,1,20,8,RW,2010
22753,0,26,Mark Mancari,0,6,0,RW,2011
22754,0,22,Mark McNeill,0,1,0,RW,2015
22755,0,23,Mark McNeill,0,1,0,RW,2016
22756,21,19,Mark Messier,12,75,33,C,1979
22757,40,20,Mark Messier,23,72,63,LW,1980
22758,38,21,Mark Messier,50,78,88,LW,1981
22759,58,22,Mark Messier,48,77,106,LW,1982
22760,64,23,Mark Messier,37,73,101,LW,1983
22761,31,24,Mark Messier,23,55,54,C,1984
22762,49,25,Mark Messier,35,63,84,C,1985
22763,70,26,Mark Messier,37,77,107,C,1986
22764,74,27,Mark Messier,37,77,111,C,1987
22765,61,28,Mark Messier,33,72,94,C,1988
22766,84,29,Mark Messier,45,79,129,C,1989
22767,52,30,Mark Messier,12,53,64,C,1990
22768,72,31,Mark Messier,35,79,107,C,1991
22769,66,32,Mark Messier,25,75,91,C,1992
22770,58,33,Mark Messier,26,76,84,C,1993
22771,39,34,Mark Messier,14,46,53,C,1994
22772,52,35,Mark Messier,47,74,99,C,1995
22773,48,36,Mark Messier,36,71,84,C,1996
22774,38,37,Mark Messier,22,82,60,C,1997
22775,35,38,Mark Messier,13,59,48,C,1998
22776,37,39,Mark Messier,17,66,54,C,1999
22777,43,40,Mark Messier,24,82,67,C,2000
22778,16,41,Mark Messier,7,41,23,C,2001
22779,22,42,Mark Messier,18,78,40,C,2002
22780,25,43,Mark Messier,18,76,43,C,2003
22781,10,18,Mark Messier*,1,52,11,C,1978
22782,10,18,Mark Messier*,1,52,11,C,1978
22783,1,18,Mark Morrison,1,9,2,C,1981
22784,0,20,Mark Morrison,0,1,0,C,1983
22785,6,24,Mark Mowers,0,30,6,RW,1998
22786,5,25,Mark Mowers,4,41,9,RW,1999
22787,2,27,Mark Mowers,1,14,3,LW,2001
22788,8,29,Mark Mowers,3,52,11,LW,2003
22789,11,31,Mark Mowers,4,46,15,RW,2005
22790,12,32,Mark Mowers,5,78,17,RW,2006
22791,0,33,Mark Mowers,1,17,1,RW,2007
22792,50,19,Mark Napier,43,78,93,RW,1975
22793,50,19,Mark Napier,43,78,93,RW,1975
22794,36,20,Mark Napier,60,80,96,RW,1976
22795,36,20,Mark Napier,60,80,96,RW,1976
22796,32,21,Mark Napier,33,79,65,RW,1977
22797,32,21,Mark Napier,33,79,65,RW,1977
22798,20,22,Mark Napier,11,54,31,RW,1978
22799,33,23,Mark Napier,16,76,49,RW,1979
22800,36,24,Mark Napier,35,79,71,RW,1980
22801,41,25,Mark Napier,40,80,81,LW,1981
22802,27,26,Mark Napier,40,73,67,RW,1982
22803,30,27,Mark Napier,16,63,46,LW,1983
22804,44,28,Mark Napier,19,72,63,C,1984
22805,32,29,Mark Napier,24,80,56,RW,1985
22806,18,30,Mark Napier,13,77,31,RW,1986
22807,8,31,Mark Napier,10,47,18,RW,1987
22808,17,32,Mark Napier,11,66,28,LW,1988
22809,7,23,Mark Olver,2,18,9,C,2010
22810,3,24,Mark Olver,4,24,7,C,2011
22811,2,25,Mark Olver,4,32,6,C,2012
22812,41,20,Mark Osborne,26,80,67,LW,1981
22813,24,21,Mark Osborne,19,80,43,LW,1982
22814,28,22,Mark Osborne,23,73,51,LW,1983
22815,4,23,Mark Osborne,4,23,8,LW,1984
22816,24,24,Mark Osborne,16,62,40,LW,1985
22817,25,25,Mark Osborne,22,74,47,RW,1986
22818,37,26,Mark Osborne,23,79,60,LW,1987
22819,30,27,Mark Osborne,16,75,46,LW,1988
22820,50,28,Mark Osborne,23,78,73,LW,1989
22821,11,29,Mark Osborne,11,55,22,LW,1990
22822,13,30,Mark Osborne,7,54,20,LW,1991
22823,14,31,Mark Osborne,12,76,26,RW,1992
22824,15,32,Mark Osborne,9,73,24,RW,1993
22825,3,33,Mark Osborne,1,37,4,LW,1994
22826,7,23,Mark Osiecki,2,50,9,D,1991
22827,4,24,Mark Osiecki,1,43,5,D,1992
22828,13,21,Mark Parrish,24,73,37,LW,1998
22829,18,22,Mark Parrish,26,81,44,RW,1999
22830,13,23,Mark Parrish,17,70,30,RW,2000
22831,30,24,Mark Parrish,30,78,60,RW,2001
22832,25,25,Mark Parrish,23,81,48,RW,2002
22833,11,26,Mark Parrish,24,59,35,RW,2003
22834,20,28,Mark Parrish,29,76,49,RW,2005
22835,20,29,Mark Parrish,19,76,39,RW,2006
22836,14,30,Mark Parrish,16,66,30,RW,2007
22837,5,31,Mark Parrish,8,44,13,RW,2008
22838,2,32,Mark Parrish,0,16,2,RW,2009
22839,0,33,Mark Parrish,0,2,0,RW,2010
22840,0,18,Mark Paterson,0,2,0,D,1982
22841,0,19,Mark Paterson,2,9,2,D,1983
22842,3,20,Mark Paterson,1,13,4,D,1984
22843,0,21,Mark Paterson,0,5,0,D,1985
22844,43,23,Mark Pavelich,33,79,76,C,1981
22845,38,24,Mark Pavelich,37,78,75,C,1982
22846,53,25,Mark Pavelich,29,77,82,C,1983
22847,31,26,Mark Pavelich,14,48,45,C,1984
22848,20,27,Mark Pavelich,20,59,40,C,1985
22849,6,28,Mark Pavelich,4,12,10,C,1986
22850,1,33,Mark Pavelich,0,2,1,C,1991
22851,2,22,Mark Pederson,0,9,2,LW,1989
22852,16,23,Mark Pederson,10,59,26,LW,1990
22853,25,24,Mark Pederson,15,58,40,LW,1991
22854,7,25,Mark Pederson,10,41,17,LW,1992
22855,0,26,Mark Pederson,0,2,0,LW,1993
22856,5,21,Mark Plantery,1,25,6,D,1980
22857,0,21,Mark Popovic,0,1,0,D,2003
22858,0,23,Mark Popovic,0,7,0,D,2005
22859,1,24,Mark Popovic,0,3,1,D,2006
22860,2,25,Mark Popovic,0,33,2,D,2007
22861,2,27,Mark Popovic,2,37,4,D,2009
22862,4,21,Mark Pysyk,1,19,5,D,2012
22863,6,22,Mark Pysyk,1,44,7,D,2013
22864,1,23,Mark Pysyk,2,7,3,D,2014
22865,10,24,Mark Pysyk,1,55,11,D,2015
22866,13,25,Mark Pysyk,4,82,17,D,2016
22867,13,26,Mark Pysyk,3,82,16,D,2017
22868,1,20,Mark Recchi,1,15,2,RW,1988
22869,37,21,Mark Recchi,30,74,67,RW,1989
22870,73,22,Mark Recchi,40,78,113,RW,1990
22871,54,23,Mark Recchi,43,80,97,RW,1991
22872,70,24,Mark Recchi,53,84,123,RW,1992
22873,67,25,Mark Recchi,40,84,107,C,1993
22874,32,26,Mark Recchi,16,49,48,RW,1994
22875,50,27,Mark Recchi,28,82,78,RW,1995
22876,46,28,Mark Recchi,34,82,80,RW,1996
22877,42,29,Mark Recchi,32,82,74,RW,1997
22878,37,30,Mark Recchi,16,71,53,RW,1998
22879,63,31,Mark Recchi,28,82,91,RW,1999
22880,50,32,Mark Recchi,27,69,77,RW,2000
22881,42,33,Mark Recchi,22,80,64,RW,2001
22882,32,34,Mark Recchi,20,79,52,RW,2002
22883,49,35,Mark Recchi,26,82,75,LW,2003
22884,36,37,Mark Recchi,28,83,64,RW,2005
22885,44,38,Mark Recchi,24,82,68,RW,2006
22886,34,39,Mark Recchi,14,72,48,RW,2007
22887,38,40,Mark Recchi,23,80,61,RW,2008
22888,25,41,Mark Recchi,18,81,43,RW,2009
22889,34,42,Mark Recchi,14,81,48,RW,2010
22890,3,22,Mark Reeds,1,9,4,RW,1981
22891,14,23,Mark Reeds,5,20,19,RW,1982
22892,14,24,Mark Reeds,11,65,25,RW,1983
22893,30,25,Mark Reeds,9,80,39,RW,1984
22894,28,26,Mark Reeds,10,78,38,RW,1985
22895,16,27,Mark Reeds,9,68,25,RW,1986
22896,7,28,Mark Reeds,0,38,7,RW,1987
22897,2,29,Mark Reeds,0,7,2,RW,1988
22898,2,20,Mark Renaud,0,13,2,D,1979
22899,0,21,Mark Renaud,1,4,1,D,1980
22900,17,22,Mark Renaud,1,48,18,D,1981
22901,28,23,Mark Renaud,3,77,31,D,1982
22902,3,24,Mark Renaud,1,10,4,D,1983
22903,3,23,Mark Rycroft,0,9,3,LW,2001
22904,12,25,Mark Rycroft,9,71,21,RW,2003
22905,4,27,Mark Rycroft,6,80,10,LW,2005
22906,6,28,Mark Rycroft,6,66,12,RW,2006
22907,0,18,Mark Scheifele,1,7,1,C,2011
22908,0,19,Mark Scheifele,0,4,0,C,2012
22909,21,20,Mark Scheifele,13,63,34,C,2013
22910,34,21,Mark Scheifele,15,82,49,C,2014
22911,32,22,Mark Scheifele,29,71,61,C,2015
22912,50,23,Mark Scheifele,32,79,82,C,2016
22913,37,24,Mark Scheifele,23,60,60,C,2017
22914,2,23,Mark Smith,2,42,4,C,2000
22915,3,24,Mark Smith,3,49,6,C,2001
22916,11,25,Mark Smith,4,75,15,C,2002
22917,3,26,Mark Smith,1,36,4,C,2003
22918,15,28,Mark Smith,9,80,24,C,2005
22919,10,29,Mark Smith,3,41,13,C,2006
22920,3,30,Mark Smith,1,54,4,C,2007
22921,0,20,Mark Stone,0,4,0,RW,2012
22922,4,21,Mark Stone,4,19,8,RW,2013
22923,38,22,Mark Stone,26,80,64,RW,2014
22924,38,23,Mark Stone,23,75,61,RW,2015
22925,32,24,Mark Stone,22,71,54,RW,2016
22926,42,25,Mark Stone,20,58,62,RW,2017
22927,9,28,Mark Streit,2,48,11,D,2005
22928,26,29,Mark Streit,10,76,36,D,2006
22929,49,30,Mark Streit,13,81,62,D,2007
22930,40,31,Mark Streit,16,74,56,D,2008
22931,38,32,Mark Streit,11,82,49,D,2009
22932,40,34,Mark Streit,7,82,47,D,2011
22933,21,35,Mark Streit,6,48,27,D,2012
22934,34,36,Mark Streit,10,82,44,D,2013
22935,43,37,Mark Streit,9,81,52,D,2014
22936,17,38,Mark Streit,6,62,23,D,2015
22937,5,39,Mark Streit,1,19,6,D,2016
22938,0,40,Mark Streit,0,2,0,D,2017
22939,1,21,Mark Stuart,1,17,2,D,2005
22940,1,22,Mark Stuart,0,15,1,D,2006
22941,4,23,Mark Stuart,4,82,8,D,2007
22942,12,24,Mark Stuart,5,82,17,D,2008
22943,5,25,Mark Stuart,2,56,7,D,2009
22944,4,26,Mark Stuart,2,54,6,D,2010
22945,11,27,Mark Stuart,3,80,14,D,2011
22946,2,28,Mark Stuart,2,42,4,D,2012
22947,11,29,Mark Stuart,2,69,13,D,2013
22948,12,30,Mark Stuart,2,70,14,D,2014
22949,2,31,Mark Stuart,1,64,3,D,2015
22950,2,32,Mark Stuart,2,42,4,D,2016
22951,1,20,Mark Suzor,0,4,1,D,1976
22952,15,21,Mark Suzor,4,60,19,D,1977
22953,0,24,Mark Taylor,0,2,0,C,1981
22954,25,25,Mark Taylor,8,61,33,LW,1982
22955,31,26,Mark Taylor,24,60,55,LW,1983
22956,11,27,Mark Taylor,8,56,19,C,1984
22957,1,28,Mark Taylor,2,30,3,C,1985
22958,2,21,Mark Tinordi,1,24,3,D,1987
22959,3,22,Mark Tinordi,2,47,5,D,1988
22960,7,23,Mark Tinordi,3,66,10,D,1989
22961,27,24,Mark Tinordi,5,69,32,D,1990
22962,24,25,Mark Tinordi,4,63,28,D,1991
22963,27,26,Mark Tinordi,15,69,42,D,1992
22964,18,27,Mark Tinordi,6,61,24,D,1993
22965,9,28,Mark Tinordi,3,42,12,D,1994
22966,10,29,Mark Tinordi,3,71,13,D,1995
22967,6,30,Mark Tinordi,2,56,8,D,1996
22968,9,31,Mark Tinordi,8,47,17,D,1997
22969,6,32,Mark Tinordi,0,48,6,D,1998
22970,0,30,Mark Van Guilder,0,1,0,C,2013
22971,4,21,Mark Vermette,0,12,4,RW,1988
22972,5,22,Mark Vermette,1,11,6,RW,1989
22973,4,23,Mark Vermette,3,34,7,RW,1990
22974,0,24,Mark Vermette,1,10,1,RW,1991
22975,0,20,Mark Visheau,0,1,0,D,1993
22976,3,25,Mark Visheau,1,28,4,D,1998
22977,0,21,Mark Wotton,0,1,0,D,1994
22978,6,23,Mark Wotton,3,36,9,D,1996
22979,0,24,Mark Wotton,0,5,0,D,1997
22980,0,27,Mark Wotton,0,1,0,D,2000
22981,2,26,Markku Kyllonen,0,9,2,LW,1988
22982,13,20,Marko Dano,8,35,21,C,2014
22983,5,21,Marko Dano,5,34,10,C,2015
22984,7,22,Marko Dano,4,38,11,C,2016
22985,1,23,Marko Dano,2,23,3,C,2017
22986,0,25,Marko Jantunen,0,3,0,C,1996
22987,4,23,Marko Kiprusoff,0,24,4,D,1995
22988,6,29,Marko Kiprusoff,0,27,6,D,2001
22989,0,22,Marko Tuomainen,0,4,0,RW,1994
22990,8,27,Marko Tuomainen,9,63,17,RW,1999
22991,1,28,Marko Tuomainen,0,11,1,RW,2000
22992,0,29,Marko Tuomainen,0,1,0,RW,2001
22993,1,20,Markus Granlund,2,7,3,C,2013
22994,10,21,Markus Granlund,8,48,18,C,2014
22995,4,22,Markus Granlund,6,47,10,C,2015
22996,13,23,Markus Granlund,19,69,32,C,2016
22997,4,24,Markus Granlund,8,53,12,C,2017
22998,0,22,Markus Hannikainen,0,4,0,LW,2015
22999,1,23,Markus Hannikainen,1,10,2,LW,2016
23000,3,24,Markus Hannikainen,3,33,6,LW,2017
23001,7,20,Markus Naslund,4,71,11,RW,1993
23002,2,21,Markus Naslund,2,14,4,RW,1994
23003,33,22,Markus Naslund,22,76,55,LW,1995
23004,20,23,Markus Naslund,21,78,41,LW,1996
23005,20,24,Markus Naslund,14,76,34,LW,1997
23006,30,25,Markus Naslund,36,80,66,RW,1998
23007,38,26,Markus Naslund,27,82,65,LW,1999
23008,34,27,Markus Naslund,41,72,75,RW,2000
23009,50,28,Markus Naslund,40,81,90,LW,2001
23010,56,29,Markus Naslund,48,82,104,LW,2002
23011,49,30,Markus Naslund,35,78,84,LW,2003
23012,47,32,Markus Naslund,32,81,79,LW,2005
23013,36,33,Markus Naslund,24,82,60,RW,2006
23014,30,34,Markus Naslund,25,82,55,LW,2007
23015,22,35,Markus Naslund,24,82,46,LW,2008
23016,5,22,Markus Nutivaara,2,66,7,D,2016
23017,16,23,Markus Nutivaara,7,61,23,D,2017
23018,0,25,Marquis Mathieu,0,9,0,C,1998
23019,2,26,Marquis Mathieu,0,6,2,C,1999
23020,0,27,Marquis Mathieu,0,1,0,C,2000
23021,0,26,Marshall Johnston,0,7,0,D,1967
23022,0,27,Marshall Johnston,0,13,0,D,1968
23023,5,28,Marshall Johnston,0,28,5,D,1969
23024,0,29,Marshall Johnston,0,1,0,D,1970
23025,11,30,Marshall Johnston,2,74,13,D,1971
23026,20,31,Marshall Johnston,10,78,30,D,1972
23027,16,32,Marshall Johnston,2,50,18,D,1973
23028,5,21,Martin Cibak,1,26,6,C,2001
23029,7,23,Martin Cibak,2,63,9,C,2003
23030,6,25,Martin Cibak,2,65,8,C,2005
23031,2,23,Martin Desjardins,0,8,2,C,1989
23032,24,20,Martin Erat,9,80,33,LW,2001
23033,7,21,Martin Erat,1,27,8,LW,2002
23034,33,22,Martin Erat,16,76,49,LW,2003
23035,29,24,Martin Erat,20,80,49,LW,2005
23036,41,25,Martin Erat,16,68,57,LW,2006
23037,34,26,Martin Erat,23,76,57,RW,2007
23038,33,27,Martin Erat,17,71,50,RW,2008
23039,28,28,Martin Erat,21,74,49,LW,2009
23040,33,29,Martin Erat,17,64,50,LW,2010
23041,39,30,Martin Erat,19,71,58,LW,2011
23042,19,31,Martin Erat,5,45,24,LW,2012
23043,26,32,Martin Erat,3,70,29,RW,2013
23044,23,33,Martin Erat,9,79,32,RW,2014
23045,0,23,Martin Frk,0,2,0,RW,2016
23046,14,24,Martin Frk,11,68,25,RW,2017
23047,2,18,Martin Gelinas,1,6,3,LW,1988
23048,8,19,Martin Gelinas,17,46,25,LW,1989
23049,20,20,Martin Gelinas,20,73,40,LW,1990
23050,18,21,Martin Gelinas,11,68,29,RW,1991
23051,12,22,Martin Gelinas,11,65,23,LW,1992
23052,14,23,Martin Gelinas,14,64,28,RW,1993
23053,10,24,Martin Gelinas,13,46,23,RW,1994
23054,26,25,Martin Gelinas,30,81,56,LW,1995
23055,33,26,Martin Gelinas,35,74,68,LW,1996
23056,18,27,Martin Gelinas,16,64,34,LW,1997
23057,15,28,Martin Gelinas,13,76,28,LW,1998
23058,16,29,Martin Gelinas,14,81,30,LW,1999
23059,29,30,Martin Gelinas,23,79,52,LW,2000
23060,16,31,Martin Gelinas,13,72,29,LW,2001
23061,31,32,Martin Gelinas,21,81,52,LW,2002
23062,18,33,Martin Gelinas,17,76,35,LW,2003
23063,24,35,Martin Gelinas,17,82,41,LW,2005
23064,30,36,Martin Gelinas,14,82,44,LW,2006
23065,11,37,Martin Gelinas,9,57,20,LW,2007
23066,1,20,Martin Gendron,2,8,3,RW,1994
23067,1,21,Martin Gendron,2,20,3,RW,1995
23068,0,23,Martin Gendron,0,2,0,RW,1997
23069,0,21,Martin Grenier,0,5,0,D,2001
23070,0,22,Martin Grenier,0,3,0,D,2002
23071,0,23,Martin Grenier,1,7,1,D,2003
23072,0,26,Martin Grenier,0,3,0,D,2006
23073,27,20,Martin Hanzal,8,72,35,C,2007
23074,20,21,Martin Hanzal,11,74,31,C,2008
23075,22,22,Martin Hanzal,11,81,33,C,2009
23076,10,23,Martin Hanzal,16,61,26,C,2010
23077,26,24,Martin Hanzal,8,64,34,C,2011
23078,12,25,Martin Hanzal,11,39,23,C,2012
23079,25,26,Martin Hanzal,15,65,40,C,2013
23080,16,27,Martin Hanzal,8,37,24,C,2014
23081,28,28,Martin Hanzal,13,64,41,C,2015
23082,9,29,Martin Hanzal,4,20,13,C,2016
23083,5,30,Martin Hanzal,5,38,10,C,2017
23084,23,19,Martin Havlat,19,73,42,RW,2000
23085,28,20,Martin Havlat,22,72,50,LW,2001
23086,35,21,Martin Havlat,24,67,59,LW,2002
23087,37,22,Martin Havlat,31,68,68,RW,2003
23088,7,24,Martin Havlat,9,18,16,LW,2005
23089,32,25,Martin Havlat,25,56,57,RW,2006
23090,17,26,Martin Havlat,10,35,27,RW,2007
23091,48,27,Martin Havlat,29,81,77,RW,2008
23092,36,28,Martin Havlat,18,73,54,LW,2009
23093,40,29,Martin Havlat,22,78,62,LW,2010
23094,20,30,Martin Havlat,7,39,27,LW,2011
23095,10,31,Martin Havlat,8,40,18,LW,2012
23096,10,32,Martin Havlat,12,48,22,RW,2013
23097,9,33,Martin Havlat,5,40,14,LW,2014
23098,0,34,Martin Havlat,1,2,1,RW,2015
23099,10,23,Martin Hostak,3,50,13,C,1990
23100,1,24,Martin Hostak,0,5,1,C,1991
23101,1,18,Martin Lapointe,0,4,1,RW,1991
23102,0,19,Martin Lapointe,0,3,0,RW,1992
23103,8,20,Martin Lapointe,8,50,16,RW,1993
23104,6,21,Martin Lapointe,4,39,10,RW,1994
23105,3,22,Martin Lapointe,6,58,9,RW,1995
23106,17,23,Martin Lapointe,16,78,33,RW,1996
23107,19,24,Martin Lapointe,15,79,34,RW,1997
23108,13,25,Martin Lapointe,16,77,29,RW,1998
23109,25,26,Martin Lapointe,16,82,41,RW,1999
23110,30,27,Martin Lapointe,27,82,57,RW,2000
23111,23,28,Martin Lapointe,17,68,40,RW,2001
23112,10,29,Martin Lapointe,8,59,18,RW,2002
23113,10,30,Martin Lapointe,15,78,25,RW,2003
23114,17,32,Martin Lapointe,14,82,31,RW,2005
23115,11,33,Martin Lapointe,13,82,24,RW,2006
23116,7,34,Martin Lapointe,6,70,13,RW,2007
23117,1,21,Martin Lojek,0,3,1,D,2006
23118,0,22,Martin Lojek,0,2,0,D,2007
23119,6,21,Martin Marincin,0,44,6,D,2013
23120,4,22,Martin Marincin,1,41,5,D,2014
23121,6,23,Martin Marincin,1,65,7,D,2015
23122,6,24,Martin Marincin,1,25,7,D,2016
23123,0,25,Martin Marincin,0,2,0,D,2017
23124,0,19,Martin Necas,0,1,0,C,2017
23125,4,25,Martin Prochazka,2,29,6,LW,1997
23126,1,27,Martin Prochazka,0,3,1,RW,1999
23127,1,20,Martin Rucinsky,1,6,2,LW,1991
23128,30,21,Martin Rucinsky,18,77,48,LW,1992
23129,23,22,Martin Rucinsky,9,60,32,LW,1993
23130,6,23,Martin Rucinsky,3,20,9,LW,1994
23131,46,24,Martin Rucinsky,29,78,75,LW,1995
23132,27,25,Martin Rucinsky,28,70,55,LW,1996
23133,32,26,Martin Rucinsky,21,78,53,LW,1997
23134,17,27,Martin Rucinsky,17,73,34,LW,1998
23135,24,28,Martin Rucinsky,25,80,49,LW,1999
23136,22,29,Martin Rucinsky,16,57,38,LW,2000
23137,27,30,Martin Rucinsky,11,75,38,LW,2001
23138,14,31,Martin Rucinsky,16,61,30,LW,2002
23139,31,32,Martin Rucinsky,14,82,45,LW,2003
23140,39,34,Martin Rucinsky,16,52,55,LW,2005
23141,21,35,Martin Rucinsky,12,52,33,LW,2006
23142,11,36,Martin Rucinsky,5,40,16,LW,2007
23143,1,21,Martin Samuelsson,0,8,1,RW,2002
23144,0,22,Martin Samuelsson,0,6,0,RW,2003
23145,2,24,Martin Simard,0,16,2,RW,1990
23146,3,25,Martin Simard,1,21,4,RW,1991
23147,0,26,Martin Simard,0,7,0,RW,1992
23148,13,20,Martin Skoula,3,80,16,D,1999
23149,17,21,Martin Skoula,8,82,25,D,2000
23150,21,22,Martin Skoula,10,82,31,D,2001
23151,21,23,Martin Skoula,4,81,25,D,2002
23152,21,24,Martin Skoula,4,79,25,D,2003
23153,16,26,Martin Skoula,5,78,21,D,2005
23154,15,27,Martin Skoula,0,81,15,D,2006
23155,8,28,Martin Skoula,3,80,11,D,2007
23156,12,29,Martin Skoula,4,81,16,D,2008
23157,8,30,Martin Skoula,3,52,11,D,2009
23158,1,21,Martin Sonnenberg,1,44,2,LW,1998
23159,2,22,Martin Sonnenberg,1,14,3,LW,1999
23160,0,26,Martin Sonnenberg,0,5,0,LW,2003
23161,0,23,Martin Spanhel,1,6,1,LW,2000
23162,0,24,Martin Spanhel,1,4,1,LW,2001
23163,0,23,Martin St. Amour,0,1,0,LW,1992
23164,1,23,Martin St. Louis,1,13,2,C,1998
23165,15,24,Martin St. Louis,3,56,18,C,1999
23166,22,25,Martin St. Louis,18,78,40,LW,2000
23167,19,26,Martin St. Louis,16,53,35,RW,2001
23168,37,27,Martin St. Louis,33,82,70,RW,2002
23169,56,28,Martin St. Louis,38,82,94,RW,2003
23170,30,30,Martin St. Louis,31,80,61,RW,2005
23171,59,31,Martin St. Louis,43,82,102,RW,2006
23172,58,32,Martin St. Louis,25,82,83,RW,2007
23173,50,33,Martin St. Louis,30,82,80,RW,2008
23174,65,34,Martin St. Louis,29,82,94,RW,2009
23175,68,35,Martin St. Louis,31,82,99,RW,2010
23176,49,36,Martin St. Louis,25,77,74,RW,2011
23177,43,37,Martin St. Louis,17,48,60,RW,2012
23178,39,38,Martin St. Louis,30,81,69,RW,2013
23179,31,39,Martin St. Louis,21,74,52,RW,2014
23180,0,22,Martin St. Pierre,0,2,0,C,2005
23181,3,23,Martin St. Pierre,1,14,4,C,2006
23182,0,24,Martin St. Pierre,0,5,0,C,2007
23183,2,25,Martin St. Pierre,2,14,4,C,2008
23184,0,26,Martin St. Pierre,0,3,0,C,2009
23185,0,30,Martin St. Pierre,0,1,0,C,2013
23186,13,20,Martin Straka,3,42,16,C,1992
23187,34,21,Martin Straka,30,84,64,C,1993
23188,13,22,Martin Straka,5,37,18,RW,1994
23189,30,23,Martin Straka,13,77,43,LW,1995
23190,22,24,Martin Straka,7,55,29,C,1996
23191,23,25,Martin Straka,19,75,42,C,1997
23192,48,26,Martin Straka,35,80,83,C,1998
23193,39,27,Martin Straka,20,71,59,C,1999
23194,68,28,Martin Straka,27,82,95,LW,2000
23195,4,29,Martin Straka,5,13,9,LW,2001
23196,28,30,Martin Straka,18,60,46,LW,2002
23197,16,31,Martin Straka,10,54,26,LW,2003
23198,54,33,Martin Straka,22,82,76,LW,2005
23199,41,34,Martin Straka,29,77,70,C,2006
23200,27,35,Martin Straka,14,65,41,LW,2007
23201,11,29,Martin Strbak,5,49,16,D,2003
23202,5,22,Martins Karsums,1,24,6,RW,2008
23203,0,25,Martti Jarventie,0,1,0,D,2001
23204,1,24,Marty Dallman,0,2,1,RW,1987
23205,0,25,Marty Dallman,0,4,0,C,1988
23206,1,23,Marty Gateman,0,12,1,D,1975
23207,1,23,Marty Gateman,0,12,1,D,1975
23208,20,19,Marty Howe,4,73,24,D,1973
23209,20,19,Marty Howe,4,73,24,D,1973
23210,21,20,Marty Howe,13,75,34,D,1974
23211,21,20,Marty Howe,13,75,34,D,1974
23212,23,21,Marty Howe,14,80,37,D,1975
23213,23,21,Marty Howe,14,80,37,D,1975
23214,28,22,Marty Howe,17,80,45,D,1976
23215,28,22,Marty Howe,17,80,45,D,1976
23216,10,23,Marty Howe,10,75,20,D,1977
23217,10,23,Marty Howe,10,75,20,D,1977
23218,15,24,Marty Howe,9,66,24,D,1978
23219,15,24,Marty Howe,9,66,24,D,1978
23220,1,25,Marty Howe,0,6,1,D,1979
23221,1,26,Marty Howe,0,12,1,D,1980
23222,4,27,Marty Howe,0,13,4,D,1981
23223,11,28,Marty Howe,1,78,12,D,1982
23224,11,29,Marty Howe,0,69,11,D,1983
23225,1,30,Marty Howe,1,19,2,D,1984
23226,5,21,Marty McInnis,3,15,8,C,1991
23227,20,22,Marty McInnis,10,56,30,LW,1992
23228,31,23,Marty McInnis,25,81,56,LW,1993
23229,7,24,Marty McInnis,9,41,16,LW,1994
23230,34,25,Marty McInnis,12,74,46,C,1995
23231,26,26,Marty McInnis,23,80,49,C,1996
23232,25,27,Marty McInnis,19,75,44,LW,1997
23233,35,28,Marty McInnis,19,81,54,C,1998
23234,18,29,Marty McInnis,10,62,28,RW,1999
23235,22,30,Marty McInnis,20,75,42,RW,2000
23236,17,31,Marty McInnis,11,79,28,RW,2001
23237,10,32,Marty McInnis,9,77,19,RW,2002
23238,7,20,Marty McSorley,2,72,9,D,1983
23239,0,21,Marty McSorley,0,15,0,D,1984
23240,12,22,Marty McSorley,11,59,23,D,1985
23241,4,23,Marty McSorley,2,41,6,RW,1986
23242,17,24,Marty McSorley,9,60,26,RW,1987
23243,17,25,Marty McSorley,10,66,27,RW,1988
23244,21,26,Marty McSorley,15,75,36,D,1989
23245,32,27,Marty McSorley,7,61,39,D,1990
23246,22,28,Marty McSorley,7,71,29,D,1991
23247,26,29,Marty McSorley,15,81,41,D,1992
23248,24,30,Marty McSorley,7,65,31,D,1993
23249,18,31,Marty McSorley,3,41,21,D,1994
23250,23,32,Marty McSorley,10,68,33,D,1995
23251,12,33,Marty McSorley,4,57,16,D,1996
23252,10,34,Marty McSorley,2,56,12,D,1997
23253,3,35,Marty McSorley,2,46,5,D,1998
23254,3,36,Marty McSorley,2,27,5,D,1999
23255,3,20,Marty Murray,3,15,6,C,1995
23256,0,21,Marty Murray,0,2,0,C,1996
23257,0,22,Marty Murray,0,2,0,C,1997
23258,0,25,Marty Murray,0,7,0,C,2000
23259,15,26,Marty Murray,12,74,27,C,2001
23260,15,27,Marty Murray,11,76,26,C,2002
23261,7,28,Marty Murray,5,66,12,C,2003
23262,2,31,Marty Murray,0,19,2,C,2006
23263,7,21,Marty Reasoner,3,22,10,C,1998
23264,14,22,Marty Reasoner,10,32,24,C,1999
23265,9,23,Marty Reasoner,4,41,13,C,2000
23266,5,24,Marty Reasoner,6,52,11,C,2001
23267,20,25,Marty Reasoner,11,70,31,C,2002
23268,6,26,Marty Reasoner,2,17,8,C,2003
23269,23,28,Marty Reasoner,11,77,34,C,2005
23270,14,29,Marty Reasoner,6,72,20,C,2006
23271,14,30,Marty Reasoner,11,82,25,C,2007
23272,16,31,Marty Reasoner,14,79,30,C,2008
23273,13,32,Marty Reasoner,4,80,17,C,2009
23274,18,33,Marty Reasoner,14,82,32,C,2010
23275,5,34,Marty Reasoner,1,61,6,C,2011
23276,5,35,Marty Reasoner,0,31,5,C,2012
23277,0,21,Masi Marjamaki,0,1,0,RW,2005
23278,12,22,Mason Raymond,9,49,21,LW,2007
23279,12,23,Mason Raymond,11,72,23,LW,2008
23280,28,24,Mason Raymond,25,82,53,LW,2009
23281,24,25,Mason Raymond,15,70,39,LW,2010
23282,10,26,Mason Raymond,10,55,20,LW,2011
23283,12,27,Mason Raymond,10,46,22,LW,2012
23284,26,28,Mason Raymond,19,82,45,LW,2013
23285,11,29,Mason Raymond,12,57,23,LW,2014
23286,1,30,Mason Raymond,4,29,5,LW,2015
23287,0,31,Mason Raymond,0,4,0,LW,2016
23288,0,21,Mat Clark,0,2,0,D,2011
23289,1,24,Mat Clark,0,7,1,D,2014
23290,0,19,Mathew Barzal,0,2,0,C,2016
23291,63,20,Mathew Barzal,22,82,85,C,2017
23292,1,19,Mathew Dumba,1,13,2,D,2013
23293,16,21,Mathew Dumba,10,81,26,D,2015
23294,23,22,Mathew Dumba,11,76,34,D,2016
23295,36,23,Mathew Dumba,14,82,50,D,2017
23296,10,28,Mathias Johansson,5,58,15,C,2002
23297,1,24,Mathias Tjarnqvist,1,18,2,LW,2003
23298,4,26,Mathias Tjarnqvist,2,33,6,C,2005
23299,7,27,Mathias Tjarnqvist,6,44,13,LW,2006
23300,7,28,Mathias Tjarnqvist,4,78,11,LW,2007
23301,4,19,Mathieu Biron,4,60,8,D,1999
23302,1,20,Mathieu Biron,0,14,1,D,2000
23303,0,21,Mathieu Biron,0,36,0,D,2001
23304,8,22,Mathieu Biron,1,34,9,D,2002
23305,10,23,Mathieu Biron,3,57,13,D,2003
23306,9,25,Mathieu Biron,4,52,13,D,2005
23307,0,22,Mathieu Carle,0,3,0,D,2009
23308,7,19,Mathieu Dandenault,5,34,12,RW,1995
23309,9,20,Mathieu Dandenault,3,65,12,RW,1996
23310,12,21,Mathieu Dandenault,5,68,17,RW,1997
23311,10,22,Mathieu Dandenault,4,75,14,RW,1998
23312,12,23,Mathieu Dandenault,6,81,18,D,1999
23313,15,24,Mathieu Dandenault,10,73,25,D,2000
23314,12,25,Mathieu Dandenault,8,81,20,D,2001
23315,15,26,Mathieu Dandenault,4,74,19,D,2002
23316,9,27,Mathieu Dandenault,3,65,12,D,2003
23317,15,29,Mathieu Dandenault,5,82,20,D,2005
23318,6,30,Mathieu Dandenault,2,68,8,D,2006
23319,5,31,Mathieu Dandenault,9,61,14,RW,2007
23320,8,32,Mathieu Dandenault,4,41,12,RW,2008
23321,0,24,Mathieu Darche,0,9,0,LW,2000
23322,1,25,Mathieu Darche,1,14,2,LW,2001
23323,0,26,Mathieu Darche,0,1,0,LW,2002
23324,0,27,Mathieu Darche,0,2,0,LW,2003
23325,0,30,Mathieu Darche,0,2,0,LW,2006
23326,15,31,Mathieu Darche,7,73,22,LW,2007
23327,5,33,Mathieu Darche,5,29,10,LW,2009
23328,14,34,Mathieu Darche,12,59,26,LW,2010
23329,7,35,Mathieu Darche,5,61,12,LW,2011
23330,5,22,Mathieu Perreault,4,21,9,C,2009
23331,7,23,Mathieu Perreault,7,35,14,C,2010
23332,14,24,Mathieu Perreault,16,64,30,C,2011
23333,11,25,Mathieu Perreault,6,39,17,C,2012
23334,25,26,Mathieu Perreault,18,69,43,C,2013
23335,23,27,Mathieu Perreault,18,62,41,C,2014
23336,32,28,Mathieu Perreault,9,71,41,C,2015
23337,32,29,Mathieu Perreault,13,65,45,C,2016
23338,22,30,Mathieu Perreault,17,70,39,C,2017
23339,0,22,Mathieu Roy,0,1,0,D,2005
23340,0,23,Mathieu Roy,2,16,2,D,2006
23341,1,24,Mathieu Roy,0,13,1,D,2007
23342,10,26,Mathieu Roy,0,31,10,D,2009
23343,0,27,Mathieu Roy,0,4,0,D,2010
23344,0,29,Mathieu Roy,0,1,0,D,2012
23345,0,18,Mathieu Schneider,0,4,0,D,1987
23346,14,20,Mathieu Schneider,7,44,21,D,1989
23347,20,21,Mathieu Schneider,10,69,30,D,1990
23348,24,22,Mathieu Schneider,8,78,32,D,1991
23349,31,23,Mathieu Schneider,13,60,44,D,1992
23350,32,24,Mathieu Schneider,20,75,52,D,1993
23351,21,25,Mathieu Schneider,8,43,29,D,1994
23352,41,26,Mathieu Schneider,13,78,54,D,1995
23353,7,27,Mathieu Schneider,5,26,12,D,1996
23354,26,28,Mathieu Schneider,11,76,37,D,1997
23355,24,29,Mathieu Schneider,10,75,34,D,1998
23356,20,30,Mathieu Schneider,10,80,30,D,1999
23357,35,31,Mathieu Schneider,16,73,51,D,2000
23358,23,32,Mathieu Schneider,7,55,30,D,2001
23359,34,33,Mathieu Schneider,16,78,50,D,2002
23360,32,34,Mathieu Schneider,14,78,46,D,2003
23361,38,36,Mathieu Schneider,21,72,59,D,2005
23362,41,37,Mathieu Schneider,11,68,52,D,2006
23363,27,38,Mathieu Schneider,12,65,39,D,2007
23364,23,39,Mathieu Schneider,9,67,32,D,2008
23365,7,40,Mathieu Schneider,2,25,9,D,2009
23366,7,24,Mats Hallin,7,30,14,LW,1982
23367,5,25,Mats Hallin,2,40,7,LW,1983
23368,0,26,Mats Hallin,5,38,5,LW,1984
23369,2,27,Mats Hallin,3,38,5,LW,1985
23370,0,28,Mats Hallin,0,6,0,LW,1986
23371,14,22,Mats Lindgren,11,69,25,C,1996
23372,13,23,Mats Lindgren,13,82,26,C,1997
23373,15,24,Mats Lindgren,10,60,25,C,1998
23374,7,25,Mats Lindgren,9,43,16,C,1999
23375,4,26,Mats Lindgren,3,20,7,C,2000
23376,12,27,Mats Lindgren,3,59,15,LW,2001
23377,9,28,Mats Lindgren,5,54,14,C,2002
23378,15,28,Mats Lindh,19,65,34,C,1975
23379,15,28,Mats Lindh,19,65,34,C,1975
23380,17,29,Mats Lindh,14,73,31,C,1976
23381,17,29,Mats Lindh,14,73,31,C,1976
23382,45,23,Mats Naslund,26,74,71,LW,1982
23383,35,24,Mats Naslund,29,77,64,LW,1983
23384,37,25,Mats Naslund,42,80,79,LW,1984
23385,67,26,Mats Naslund,43,80,110,LW,1985
23386,55,27,Mats Naslund,25,79,80,LW,1986
23387,59,28,Mats Naslund,24,78,83,LW,1987
23388,51,29,Mats Naslund,33,77,84,LW,1988
23389,20,30,Mats Naslund,21,72,41,LW,1989
23390,14,35,Mats Naslund,8,34,22,LW,1994
23391,36,19,Mats Sundin,23,80,59,RW,1990
23392,43,20,Mats Sundin,33,80,76,RW,1991
23393,67,21,Mats Sundin,47,80,114,C,1992
23394,53,22,Mats Sundin,32,84,85,C,1993
23395,24,23,Mats Sundin,23,47,47,C,1994
23396,50,24,Mats Sundin,33,76,83,RW,1995
23397,53,25,Mats Sundin,41,82,94,C,1996
23398,41,26,Mats Sundin,33,82,74,C,1997
23399,52,27,Mats Sundin,31,82,83,C,1998
23400,41,28,Mats Sundin,32,73,73,C,1999
23401,46,29,Mats Sundin,28,82,74,C,2000
23402,39,30,Mats Sundin,41,82,80,C,2001
23403,35,31,Mats Sundin,37,75,72,C,2002
23404,44,32,Mats Sundin,31,81,75,C,2003
23405,47,34,Mats Sundin,31,70,78,C,2005
23406,49,35,Mats Sundin,27,75,76,C,2006
23407,46,36,Mats Sundin,32,74,78,C,2007
23408,19,37,Mats Sundin,9,41,28,C,2008
23409,13,23,Mats Thelin,5,73,18,D,1984
23410,3,24,Mats Thelin,2,31,5,D,1985
23411,3,25,Mats Thelin,1,59,4,D,1986
23412,17,23,Mats Zuccarello,6,42,23,LW,2010
23413,1,24,Mats Zuccarello,2,10,3,LW,2011
23414,5,25,Mats Zuccarello,3,15,8,LW,2012
23415,40,26,Mats Zuccarello,19,77,59,LW,2013
23416,34,27,Mats Zuccarello,15,78,49,RW,2014
23417,35,28,Mats Zuccarello,26,81,61,RW,2015
23418,44,29,Mats Zuccarello,15,80,59,RW,2016
23419,37,30,Mats Zuccarello,16,80,53,RW,2017
23420,1,30,Matt Anderson,0,2,1,RW,2012
23421,0,22,Matt Bartkowski,0,6,0,D,2010
23422,0,23,Matt Bartkowski,0,3,0,D,2011
23423,2,24,Matt Bartkowski,0,11,2,D,2012
23424,18,25,Matt Bartkowski,0,64,18,D,2013
23425,4,26,Matt Bartkowski,0,47,4,D,2014
23426,12,27,Matt Bartkowski,6,80,18,D,2015
23427,1,28,Matt Bartkowski,1,24,2,D,2016
23428,3,29,Matt Bartkowski,0,18,3,D,2017
23429,0,20,Matt Beleskey,0,2,0,LW,2008
23430,7,21,Matt Beleskey,11,60,18,LW,2009
23431,7,22,Matt Beleskey,3,35,10,LW,2010
23432,11,23,Matt Beleskey,4,70,15,LW,2011
23433,5,24,Matt Beleskey,8,42,13,LW,2012
23434,15,25,Matt Beleskey,9,55,24,LW,2013
23435,10,26,Matt Beleskey,22,65,32,LW,2014
23436,22,27,Matt Beleskey,15,80,37,LW,2015
23437,5,28,Matt Beleskey,3,49,8,LW,2016
23438,0,29,Matt Beleskey,0,1,0,LW,2017
23439,12,22,Matt Benning,3,62,15,D,2016
23440,15,23,Matt Benning,6,73,21,D,2017
23441,1,22,Matt Bradley,1,21,2,RW,2000
23442,13,23,Matt Bradley,9,54,22,RW,2001
23443,3,24,Matt Bradley,2,46,5,RW,2002
23444,9,25,Matt Bradley,7,82,16,RW,2003
23445,12,27,Matt Bradley,7,74,19,RW,2005
23446,9,28,Matt Bradley,4,57,13,RW,2006
23447,11,29,Matt Bradley,7,77,18,RW,2007
23448,6,30,Matt Bradley,5,81,11,RW,2008
23449,14,31,Matt Bradley,10,77,24,RW,2009
23450,7,32,Matt Bradley,4,61,11,RW,2010
23451,5,33,Matt Bradley,3,45,8,RW,2011
23452,9,21,Matt Calvert,11,42,20,LW,2010
23453,3,22,Matt Calvert,0,13,3,LW,2011
23454,7,23,Matt Calvert,9,42,16,LW,2012
23455,15,24,Matt Calvert,9,56,24,LW,2013
23456,10,25,Matt Calvert,13,56,23,LW,2014
23457,13,26,Matt Calvert,11,73,24,LW,2015
23458,5,27,Matt Calvert,10,65,15,LW,2016
23459,15,28,Matt Calvert,9,69,24,LW,2017
23460,0,22,Matt Campanale,0,1,0,D,2010
23461,0,21,Matt Carey,1,2,1,LW,2013
23462,1,25,Matt Carkner,0,1,1,D,2005
23463,0,28,Matt Carkner,0,1,0,RW,2008
23464,9,29,Matt Carkner,2,81,11,D,2009
23465,6,30,Matt Carkner,1,50,7,D,2010
23466,2,31,Matt Carkner,1,29,3,D,2011
23467,2,32,Matt Carkner,0,22,2,D,2012
23468,3,33,Matt Carkner,0,53,3,D,2013
23469,3,21,Matt Carle,3,12,6,D,2005
23470,31,22,Matt Carle,11,77,42,D,2006
23471,13,23,Matt Carle,2,62,15,D,2007
23472,21,24,Matt Carle,5,76,26,D,2008
23473,29,25,Matt Carle,6,80,35,D,2009
23474,39,26,Matt Carle,1,82,40,D,2010
23475,34,27,Matt Carle,4,82,38,D,2011
23476,17,28,Matt Carle,5,48,22,D,2012
23477,29,29,Matt Carle,2,82,31,D,2013
23478,7,31,Matt Carle,2,64,9,D,2015
23479,1,32,Matt Carle,0,6,1,D,2016
23480,2,20,Matt Cooke,0,30,2,LW,1998
23481,7,21,Matt Cooke,5,51,12,LW,1999
23482,13,22,Matt Cooke,14,81,27,RW,2000
23483,20,23,Matt Cooke,13,82,33,LW,2001
23484,27,24,Matt Cooke,15,82,42,LW,2002
23485,12,25,Matt Cooke,11,53,23,LW,2003
23486,10,27,Matt Cooke,8,45,18,LW,2005
23487,20,28,Matt Cooke,10,81,30,LW,2006
23488,13,29,Matt Cooke,10,78,23,LW,2007
23489,18,30,Matt Cooke,13,76,31,LW,2008
23490,15,31,Matt Cooke,15,79,30,LW,2009
23491,18,32,Matt Cooke,12,67,30,LW,2010
23492,19,33,Matt Cooke,19,82,38,LW,2011
23493,13,34,Matt Cooke,8,48,21,LW,2012
23494,18,35,Matt Cooke,10,82,28,LW,2013
23495,6,36,Matt Cooke,4,29,10,LW,2014
23496,21,21,Matt Cullen,6,61,27,C,1997
23497,14,22,Matt Cullen,11,75,25,C,1998
23498,26,23,Matt Cullen,13,80,39,C,1999
23499,30,24,Matt Cullen,10,82,40,C,2000
23500,30,25,Matt Cullen,18,79,48,C,2001
23501,20,26,Matt Cullen,13,80,33,C,2002
23502,13,27,Matt Cullen,6,56,19,C,2003
23503,24,29,Matt Cullen,25,78,49,C,2005
23504,25,30,Matt Cullen,16,80,41,C,2006
23505,36,31,Matt Cullen,13,59,49,C,2007
23506,21,32,Matt Cullen,22,69,43,C,2008
23507,32,33,Matt Cullen,16,81,48,C,2009
23508,27,34,Matt Cullen,12,78,39,C,2010
23509,21,35,Matt Cullen,14,73,35,C,2011
23510,20,36,Matt Cullen,7,42,27,C,2012
23511,29,37,Matt Cullen,10,77,39,C,2013
23512,18,38,Matt Cullen,7,62,25,C,2014
23513,16,39,Matt Cullen,16,82,32,C,2015
23514,18,40,Matt Cullen,13,72,31,C,2016
23515,11,41,Matt Cullen,11,79,22,C,2017
23516,1,22,Matt D Martin,0,12,1,D,1993
23517,0,23,Matt D Martin,0,15,0,D,1994
23518,0,24,Matt D Martin,0,13,0,D,1995
23519,4,25,Matt D Martin,0,36,4,D,1996
23520,0,21,Matt D'Agostini,0,1,0,RW,2007
23521,9,22,Matt D'Agostini,12,53,21,RW,2008
23522,2,23,Matt D'Agostini,2,47,4,RW,2009
23523,25,24,Matt D'Agostini,21,82,46,RW,2010
23524,9,25,Matt D'Agostini,9,55,18,RW,2011
23525,3,26,Matt D'Agostini,3,29,6,RW,2012
23526,7,27,Matt D'Agostini,5,57,12,RW,2013
23527,0,23,Matt Davidson,0,5,0,RW,2000
23528,2,24,Matt Davidson,1,17,3,RW,2001
23529,5,25,Matt Davidson,4,34,9,RW,2002
23530,0,21,Matt Donovan,0,3,0,D,2011
23531,14,23,Matt Donovan,2,52,16,D,2013
23532,3,24,Matt Donovan,0,12,3,D,2014
23533,31,19,Matt Duchene,24,81,55,C,2009
23534,40,20,Matt Duchene,27,80,67,C,2010
23535,14,21,Matt Duchene,14,58,28,C,2011
23536,26,22,Matt Duchene,17,47,43,C,2012
23537,47,23,Matt Duchene,23,71,70,C,2013
23538,34,24,Matt Duchene,21,82,55,C,2014
23539,29,25,Matt Duchene,30,76,59,C,2015
23540,23,26,Matt Duchene,18,77,41,C,2016
23541,6,27,Matt Duchene,4,14,10,C,2017
23542,8,20,Matt Dumba,8,58,16,D,2014
23543,1,20,Matt Elich,1,8,2,RW,1999
23544,0,21,Matt Elich,0,8,0,RW,2000
23545,0,25,Matt Ellis,0,16,0,LW,2006
23546,5,26,Matt Ellis,3,54,8,LW,2007
23547,5,27,Matt Ellis,7,45,12,LW,2008
23548,10,28,Matt Ellis,3,72,13,LW,2009
23549,0,29,Matt Ellis,0,14,0,LW,2010
23550,5,30,Matt Ellis,3,60,8,LW,2011
23551,0,31,Matt Ellis,0,6,0,LW,2012
23552,2,32,Matt Ellis,4,50,6,LW,2013
23553,1,33,Matt Ellis,1,39,2,LW,2014
23554,1,20,Matt Ellison,0,10,1,RW,2003
23555,10,22,Matt Ellison,3,31,13,RW,2005
23556,0,23,Matt Ellison,0,2,0,RW,2006
23557,3,22,Matt Foy,2,19,5,RW,2005
23558,0,23,Matt Foy,0,9,0,RW,2006
23559,4,24,Matt Foy,4,28,8,RW,2007
23560,0,21,Matt Fraser,0,1,0,LW,2011
23561,2,22,Matt Fraser,1,12,3,LW,2012
23562,0,23,Matt Fraser,2,14,2,RW,2013
23563,4,24,Matt Fraser,8,60,12,RW,2014
23564,0,23,Matt Frattin,0,1,0,RW,2010
23565,7,24,Matt Frattin,8,56,15,RW,2011
23566,6,25,Matt Frattin,7,25,13,RW,2012
23567,5,26,Matt Frattin,2,44,7,RW,2013
23568,0,27,Matt Frattin,0,9,0,RW,2014
23569,11,25,Matt Gilroy,4,69,15,D,2009
23570,8,26,Matt Gilroy,3,58,11,D,2010
23571,17,27,Matt Gilroy,3,67,20,D,2011
23572,0,28,Matt Gilroy,0,15,0,D,2012
23573,1,29,Matt Gilroy,1,16,2,D,2013
23574,0,23,Matt Glennon,0,3,0,LW,1991
23575,2,22,Matt Greene,0,27,2,D,2005
23576,9,23,Matt Greene,1,78,10,D,2006
23577,1,24,Matt Greene,0,46,1,D,2007
23578,12,25,Matt Greene,2,82,14,D,2008
23579,7,26,Matt Greene,2,75,9,D,2009
23580,9,27,Matt Greene,2,71,11,D,2010
23581,11,28,Matt Greene,4,82,15,D,2011
23582,1,29,Matt Greene,0,5,1,D,2012
23583,4,30,Matt Greene,2,38,6,D,2013
23584,6,31,Matt Greene,3,82,9,D,2014
23585,0,32,Matt Greene,0,3,0,D,2015
23586,1,33,Matt Greene,1,26,2,D,2016
23587,0,23,Matt Grzelcyk,0,2,0,D,2016
23588,12,24,Matt Grzelcyk,3,61,15,D,2017
23589,1,20,Matt Halischuk,0,1,1,RW,2008
23590,1,21,Matt Halischuk,1,20,2,RW,2009
23591,8,22,Matt Halischuk,4,27,12,RW,2010
23592,13,23,Matt Halischuk,15,73,28,RW,2011
23593,6,24,Matt Halischuk,5,36,11,RW,2012
23594,5,25,Matt Halischuk,5,46,10,RW,2013
23595,5,26,Matt Halischuk,3,47,8,RW,2014
23596,3,27,Matt Halischuk,0,30,3,RW,2015
23597,0,24,Matt Henderson,0,2,0,RW,1998
23598,1,27,Matt Henderson,0,4,1,RW,2001
23599,0,27,Matt Hendricks,0,4,0,C,2008
23600,7,28,Matt Hendricks,9,56,16,C,2009
23601,16,29,Matt Hendricks,9,77,25,C,2010
23602,5,30,Matt Hendricks,4,78,9,C,2011
23603,3,31,Matt Hendricks,5,48,8,C,2012
23604,2,32,Matt Hendricks,5,77,7,C,2013
23605,8,33,Matt Hendricks,8,71,16,LW,2014
23606,7,34,Matt Hendricks,5,68,12,LW,2015
23607,3,35,Matt Hendricks,4,42,7,LW,2016
23608,8,36,Matt Hendricks,5,60,13,LW,2017
23609,2,22,Matt Herr,2,30,4,C,1998
23610,3,24,Matt Herr,2,22,5,C,2000
23611,0,25,Matt Herr,0,3,0,C,2001
23612,0,26,Matt Herr,0,3,0,C,2002
23613,0,20,Matt Hervey,0,2,0,D,1988
23614,1,23,Matt Hervey,0,16,1,D,1991
23615,4,24,Matt Hervey,0,17,4,D,1992
23616,0,20,Matt Higgins,0,1,0,C,1997
23617,0,21,Matt Higgins,1,25,1,C,1998
23618,2,22,Matt Higgins,0,25,2,C,1999
23619,0,23,Matt Higgins,0,6,0,C,2000
23620,1,22,Matt Hunwick,0,13,1,D,2007
23621,21,23,Matt Hunwick,6,53,27,D,2008
23622,8,24,Matt Hunwick,6,76,14,D,2009
23623,12,25,Matt Hunwick,1,73,13,D,2010
23624,3,26,Matt Hunwick,3,33,6,D,2011
23625,6,27,Matt Hunwick,0,43,6,D,2012
23626,0,28,Matt Hunwick,0,1,0,D,2013
23627,9,29,Matt Hunwick,2,55,11,D,2014
23628,8,30,Matt Hunwick,2,60,10,D,2015
23629,18,31,Matt Hunwick,1,72,19,D,2016
23630,6,32,Matt Hunwick,4,42,10,D,2017
23631,1,24,Matt Hussey,2,3,3,C,2003
23632,1,26,Matt Hussey,0,13,1,C,2005
23633,0,27,Matt Hussey,0,5,0,C,2006
23634,6,25,Matt Irwin,6,38,12,D,2012
23635,18,26,Matt Irwin,2,62,20,D,2013
23636,11,27,Matt Irwin,8,53,19,D,2014
23637,0,28,Matt Irwin,0,2,0,D,2015
23638,11,29,Matt Irwin,3,74,14,D,2016
23639,6,30,Matt Irwin,2,50,8,D,2017
23640,0,19,Matt Johnson,1,14,1,LW,1994
23641,0,20,Matt Johnson,0,1,0,LW,1995
23642,3,21,Matt Johnson,1,52,4,LW,1996
23643,4,22,Matt Johnson,2,66,6,LW,1997
23644,1,23,Matt Johnson,2,49,3,LW,1998
23645,5,24,Matt Johnson,2,64,7,LW,1999
23646,1,25,Matt Johnson,1,50,2,LW,2000
23647,0,26,Matt Johnson,4,60,4,LW,2001
23648,5,27,Matt Johnson,3,60,8,LW,2002
23649,1,28,Matt Johnson,7,57,8,LW,2003
23650,2,22,Matt Jones,0,16,2,D,2005
23651,6,23,Matt Jones,1,45,7,D,2006
23652,2,24,Matt Jones,0,45,2,D,2007
23653,0,24,Matt Kassian,0,4,0,LW,2010
23654,0,25,Matt Kassian,2,24,2,LW,2011
23655,0,26,Matt Kassian,1,15,1,LW,2012
23656,1,27,Matt Kassian,1,33,2,LW,2013
23657,3,20,Matt Keith,2,20,5,RW,2003
23658,0,22,Matt Keith,0,2,0,RW,2005
23659,0,23,Matt Keith,0,2,0,RW,2006
23660,0,24,Matt Keith,0,3,0,RW,2007
23661,0,25,Matt Koalska,0,3,0,C,2005
23662,2,20,Matt L Martin,0,5,2,LW,2009
23663,9,21,Matt L Martin,5,68,14,LW,2010
23664,7,22,Matt L Martin,7,80,14,LW,2011
23665,7,23,Matt L Martin,4,48,11,LW,2012
23666,6,24,Matt L Martin,8,79,14,LW,2013
23667,6,25,Matt L Martin,8,78,14,LW,2014
23668,9,26,Matt L Martin,10,80,19,LW,2015
23669,2,20,Matt Lashoff,0,12,2,D,2006
23670,4,21,Matt Lashoff,1,18,5,D,2007
23671,8,22,Matt Lashoff,0,28,8,D,2008
23672,0,23,Matt Lashoff,0,5,0,D,2009
23673,1,24,Matt Lashoff,0,11,1,D,2010
23674,0,23,Matt Lindblad,0,2,0,C,2013
23675,0,24,Matt Lindblad,0,2,0,C,2014
23676,4,27,Matt Martin,5,82,9,LW,2016
23677,9,28,Matt Martin,3,50,12,LW,2017
23678,4,24,Matt Moulson,5,22,9,LW,2007
23679,0,25,Matt Moulson,1,7,1,LW,2008
23680,18,26,Matt Moulson,30,82,48,LW,2009
23681,22,27,Matt Moulson,31,82,53,LW,2010
23682,33,28,Matt Moulson,36,82,69,LW,2011
23683,29,29,Matt Moulson,15,47,44,LW,2012
23684,28,30,Matt Moulson,23,75,51,LW,2013
23685,28,31,Matt Moulson,13,77,41,LW,2014
23686,13,32,Matt Moulson,8,81,21,LW,2015
23687,18,33,Matt Moulson,14,81,32,LW,2016
23688,0,34,Matt Moulson,0,14,0,LW,2017
23689,1,24,Matt Murley,1,18,2,LW,2003
23690,5,26,Matt Murley,1,41,6,LW,2005
23691,1,28,Matt Murley,0,3,1,LW,2007
23692,17,22,Matt Nieto,10,72,27,LW,2014
23693,19,21,Matt Niskanen,7,78,26,D,2007
23694,29,22,Matt Niskanen,6,80,35,D,2008
23695,12,23,Matt Niskanen,3,74,15,D,2009
23696,9,24,Matt Niskanen,1,63,10,D,2010
23697,17,25,Matt Niskanen,4,75,21,D,2011
23698,10,26,Matt Niskanen,4,40,14,D,2012
23699,36,27,Matt Niskanen,10,81,46,D,2013
23700,27,28,Matt Niskanen,4,82,31,D,2014
23701,27,29,Matt Niskanen,5,82,32,D,2015
23702,34,30,Matt Niskanen,5,78,39,D,2016
23703,22,31,Matt Niskanen,7,68,29,D,2017
23704,3,21,Matt Pelech,0,5,3,D,2008
23705,0,25,Matt Pelech,0,2,0,D,2012
23706,0,26,Matt Pelech,1,6,1,RW,2013
23707,0,20,Matt Pettinger,0,10,0,LW,2000
23708,3,21,Matt Pettinger,7,61,10,LW,2001
23709,0,22,Matt Pettinger,0,1,0,LW,2002
23710,5,23,Matt Pettinger,7,71,12,LW,2003
23711,18,25,Matt Pettinger,20,71,38,LW,2005
23712,16,26,Matt Pettinger,16,64,32,LW,2006
23713,7,27,Matt Pettinger,6,76,13,LW,2007
23714,7,28,Matt Pettinger,8,59,15,LW,2008
23715,2,29,Matt Pettinger,1,9,3,LW,2009
23716,1,22,Matt Puempel,2,13,3,LW,2014
23717,1,23,Matt Puempel,2,26,3,LW,2015
23718,0,24,Matt Puempel,0,13,0,LW,2016
23719,12,30,Matt Ravlich,2,60,14,D,1968
23720,13,31,Matt Ravlich,3,67,16,D,1969
23721,16,32,Matt Ravlich,3,66,19,D,1970
23722,1,33,Matt Ravlich,0,25,1,D,1971
23723,1,34,Matt Ravlich,0,5,1,D,1972
23724,23,25,Matt Read,24,79,47,RW,2011
23725,13,26,Matt Read,11,42,24,RW,2012
23726,18,27,Matt Read,22,75,40,RW,2013
23727,22,28,Matt Read,8,80,30,RW,2014
23728,15,29,Matt Read,11,79,26,RW,2015
23729,9,30,Matt Read,10,63,19,RW,2016
23730,0,31,Matt Read,1,19,1,RW,2017
23731,1,22,Matt Ryan,0,12,1,C,2005
23732,0,23,Matt Smaby,0,14,0,D,2007
23733,4,24,Matt Smaby,0,43,4,D,2008
23734,2,25,Matt Smaby,0,33,2,D,2009
23735,0,26,Matt Smaby,0,32,0,D,2010
23736,0,19,Matt Stajan,1,1,1,C,2002
23737,13,20,Matt Stajan,14,69,27,C,2003
23738,12,22,Matt Stajan,15,80,27,C,2005
23739,29,23,Matt Stajan,10,82,39,C,2006
23740,17,24,Matt Stajan,16,82,33,C,2007
23741,40,25,Matt Stajan,15,76,55,C,2008
23742,38,26,Matt Stajan,19,82,57,C,2009
23743,25,27,Matt Stajan,6,76,31,C,2010
23744,10,28,Matt Stajan,8,61,18,C,2011
23745,18,29,Matt Stajan,5,43,23,C,2012
23746,19,30,Matt Stajan,14,63,33,C,2013
23747,10,31,Matt Stajan,7,59,17,C,2014
23748,11,32,Matt Stajan,6,80,17,C,2015
23749,17,33,Matt Stajan,6,81,23,C,2016
23750,8,34,Matt Stajan,4,68,12,C,2017
23751,2,24,Matt Taormina,3,17,5,D,2010
23752,6,25,Matt Taormina,1,30,7,D,2011
23753,0,26,Matt Taormina,0,2,0,D,2012
23754,0,27,Matt Taormina,0,7,0,D,2013
23755,0,29,Matt Taormina,0,3,0,D,2015
23756,2,22,Matt Tennyson,0,4,2,D,2012
23757,6,24,Matt Tennyson,2,27,8,D,2014
23758,3,25,Matt Tennyson,1,29,4,D,2015
23759,6,26,Matt Tennyson,0,45,6,D,2016
23760,0,27,Matt Tennyson,0,15,0,D,2017
23761,1,22,Matt Walker,0,16,1,D,2002
23762,1,23,Matt Walker,0,14,1,D,2003
23763,2,25,Matt Walker,0,54,2,D,2005
23764,5,26,Matt Walker,0,48,5,D,2006
23765,1,27,Matt Walker,1,43,2,D,2007
23766,13,28,Matt Walker,1,65,14,D,2008
23767,3,29,Matt Walker,2,66,5,D,2009
23768,0,30,Matt Walker,0,4,0,D,2010
23769,0,31,Matt Walker,0,4,0,D,2011
23770,0,25,Matt Watkins,0,1,0,RW,2011
23771,0,19,Matthew Barnaby,1,2,1,LW,1992
23772,4,20,Matthew Barnaby,2,35,6,LW,1993
23773,1,21,Matthew Barnaby,1,23,2,LW,1994
23774,16,22,Matthew Barnaby,15,73,31,RW,1995
23775,24,23,Matthew Barnaby,19,68,43,RW,1996
23776,20,24,Matthew Barnaby,5,72,25,RW,1997
23777,16,25,Matthew Barnaby,6,62,22,RW,1998
23778,12,26,Matthew Barnaby,12,64,24,LW,1999
23779,8,27,Matthew Barnaby,5,76,13,RW,2000
23780,13,28,Matthew Barnaby,8,77,21,LW,2001
23781,22,29,Matthew Barnaby,14,79,36,LW,2002
23782,25,30,Matthew Barnaby,16,82,41,RW,2003
23783,20,32,Matthew Barnaby,8,82,28,LW,2005
23784,6,33,Matthew Barnaby,1,39,7,RW,2006
23785,14,30,Matthew Carle,4,59,18,D,2014
23786,0,21,Matthew Corrente,0,12,0,D,2009
23787,6,22,Matthew Corrente,0,22,6,D,2010
23788,0,21,Matthew Highmore,2,13,2,LW,2017
23789,0,21,Matthew Konan,0,2,0,D,2012
23790,13,21,Matthew Lombardi,16,79,29,C,2003
23791,20,23,Matthew Lombardi,6,55,26,C,2005
23792,26,24,Matthew Lombardi,20,81,46,C,2006
23793,22,25,Matthew Lombardi,14,82,36,C,2007
23794,32,26,Matthew Lombardi,14,69,46,C,2008
23795,34,27,Matthew Lombardi,19,78,53,C,2009
23796,0,28,Matthew Lombardi,0,2,0,C,2010
23797,10,29,Matthew Lombardi,8,62,18,C,2011
23798,4,30,Matthew Lombardi,4,28,8,C,2012
23799,1,26,Matthew Lorito,0,2,1,LW,2016
23800,14,21,Matthew Nieto,10,66,24,LW,2013
23801,9,23,Matthew Nieto,8,67,17,LW,2015
23802,2,24,Matthew Nieto,0,16,2,LW,2016
23803,11,25,Matthew Nieto,15,74,26,LW,2017
23804,1,23,Matthew Peca,1,10,2,C,2016
23805,3,24,Matthew Peca,2,10,5,C,2017
23806,0,20,Matthew Spiller,0,51,0,D,2003
23807,1,22,Matthew Spiller,0,8,1,D,2005
23808,1,24,Matthew Spiller,0,9,1,D,2007
23809,35,19,Matthew Tkachuk,13,76,48,LW,2016
23810,25,20,Matthew Tkachuk,24,68,49,LW,2017
23811,1,23,Matthieu Descoteaux,1,5,2,D,2000
23812,17,21,Matti Hagman,11,75,28,C,1976
23813,1,22,Matti Hagman,4,15,5,C,1977
23814,31,22,Matti Hagman,25,53,56,C,1977
23815,31,22,Matti Hagman,25,53,56,C,1977
23816,1,23,Matti Hagman,0,1,1,RW,1978
23817,1,23,Matti Hagman,0,1,1,RW,1978
23818,33,25,Matti Hagman,20,75,53,C,1980
23819,38,26,Matti Hagman,21,72,59,C,1981
23820,0,28,Matti Kaario,0,1,0,RW,1978
23821,0,28,Matti Kaario,0,1,0,RW,1978
23822,0,21,Mattias Ekholm,0,2,0,D,2011
23823,0,22,Mattias Ekholm,0,1,0,D,2012
23824,8,23,Mattias Ekholm,1,62,9,D,2013
23825,11,24,Mattias Ekholm,7,80,18,D,2014
23826,27,25,Mattias Ekholm,8,82,35,D,2015
23827,20,26,Mattias Ekholm,3,82,23,D,2016
23828,24,27,Mattias Ekholm,10,81,34,D,2017
23829,14,23,Mattias Janmark,15,73,29,C,2015
23830,15,25,Mattias Janmark,19,81,34,C,2017
23831,2,22,Mattias Norstrom,0,9,2,D,1993
23832,3,23,Mattias Norstrom,0,9,3,D,1994
23833,2,24,Mattias Norstrom,2,36,4,D,1995
23834,21,25,Mattias Norstrom,1,80,22,D,1996
23835,12,26,Mattias Norstrom,1,73,13,D,1997
23836,5,27,Mattias Norstrom,2,78,7,D,1998
23837,13,28,Mattias Norstrom,1,82,14,D,1999
23838,18,29,Mattias Norstrom,0,82,18,D,2000
23839,9,30,Mattias Norstrom,2,79,11,D,2001
23840,6,31,Mattias Norstrom,0,82,6,D,2002
23841,13,32,Mattias Norstrom,1,74,14,D,2003
23842,23,34,Mattias Norstrom,4,77,27,D,2005
23843,9,35,Mattias Norstrom,2,76,11,D,2006
23844,11,36,Mattias Norstrom,2,66,13,D,2007
23845,23,21,Mattias Ohlund,7,77,30,D,1997
23846,26,22,Mattias Ohlund,9,74,35,D,1998
23847,16,23,Mattias Ohlund,4,42,20,D,1999
23848,20,24,Mattias Ohlund,8,65,28,D,2000
23849,26,25,Mattias Ohlund,10,81,36,D,2001
23850,27,26,Mattias Ohlund,2,59,29,D,2002
23851,20,27,Mattias Ohlund,14,82,34,D,2003
23852,20,29,Mattias Ohlund,13,78,33,D,2005
23853,20,30,Mattias Ohlund,11,77,31,D,2006
23854,15,31,Mattias Ohlund,9,53,24,D,2007
23855,19,32,Mattias Ohlund,6,82,25,D,2008
23856,13,33,Mattias Ohlund,0,67,13,D,2009
23857,5,34,Mattias Ohlund,0,72,5,D,2010
23858,1,20,Mattias Ritola,0,2,1,C,2007
23859,0,22,Mattias Ritola,0,5,0,C,2009
23860,4,23,Mattias Ritola,4,31,8,C,2010
23861,0,24,Mattias Ritola,0,5,0,C,2011
23862,14,20,Mattias Tedenby,8,58,22,LW,2010
23863,5,21,Mattias Tedenby,1,43,6,LW,2011
23864,1,22,Mattias Tedenby,0,4,1,LW,2012
23865,0,23,Mattias Tedenby,1,15,1,RW,2013
23866,8,22,Mattias Timander,1,41,9,D,1996
23867,1,23,Mattias Timander,1,23,2,D,1997
23868,6,24,Mattias Timander,0,22,6,D,1998
23869,8,25,Mattias Timander,0,60,8,D,1999
23870,9,26,Mattias Timander,2,76,11,D,2000
23871,7,27,Mattias Timander,4,78,11,D,2001
23872,13,28,Mattias Timander,3,80,16,D,2002
23873,5,29,Mattias Timander,2,39,7,D,2003
23874,17,22,Mattias Weinhandl,6,47,23,RW,2002
23875,12,23,Mattias Weinhandl,8,55,20,RW,2003
23876,7,25,Mattias Weinhandl,4,68,11,RW,2005
23877,1,26,Mattias Weinhandl,1,12,2,RW,2006
23878,34,20,Max Domi,18,81,52,LW,2015
23879,29,21,Max Domi,9,59,38,LW,2016
23880,36,22,Max Domi,9,82,45,LW,2017
23881,0,22,Max Friberg,0,1,0,LW,2014
23882,0,23,Max Friberg,0,5,0,LW,2015
23883,2,23,Max McCormick,2,20,4,LW,2015
23884,0,24,Max McCormick,0,7,0,RW,2016
23885,2,25,Max McCormick,3,30,5,LW,2017
23886,4,19,Max Middendorf,1,6,5,RW,1986
23887,0,20,Max Middendorf,0,1,0,RW,1987
23888,0,22,Max Middendorf,0,3,0,RW,1989
23889,0,23,Max Middendorf,1,3,1,RW,1990
23890,8,20,Max Pacioretty,3,34,11,LW,2008
23891,11,21,Max Pacioretty,3,52,14,LW,2009
23892,10,22,Max Pacioretty,14,37,24,LW,2010
23893,32,23,Max Pacioretty,33,79,65,LW,2011
23894,24,24,Max Pacioretty,15,44,39,LW,2012
23895,21,25,Max Pacioretty,39,73,60,LW,2013
23896,30,26,Max Pacioretty,37,80,67,LW,2014
23897,34,27,Max Pacioretty,30,82,64,LW,2015
23898,32,28,Max Pacioretty,35,81,67,LW,2016
23899,20,29,Max Pacioretty,17,64,37,LW,2017
23900,2,20,Max Reinhart,1,11,3,C,2012
23901,2,21,Max Reinhart,0,8,2,C,2013
23902,0,22,Max Reinhart,0,4,0,C,2014
23903,0,22,Max Sauve,0,1,0,C,2011
23904,13,30,Max Talbot,5,81,18,C,2014
23905,18,20,Maxim Afinogenov,16,65,34,RW,1999
23906,22,21,Maxim Afinogenov,14,78,36,RW,2000
23907,19,22,Maxim Afinogenov,21,81,40,RW,2001
23908,6,23,Maxim Afinogenov,5,35,11,RW,2002
23909,14,24,Maxim Afinogenov,17,73,31,RW,2003
23910,51,26,Maxim Afinogenov,22,77,73,RW,2005
23911,38,27,Maxim Afinogenov,23,56,61,RW,2006
23912,18,28,Maxim Afinogenov,10,56,28,RW,2007
23913,14,29,Maxim Afinogenov,6,48,20,RW,2008
23914,37,30,Maxim Afinogenov,24,82,61,RW,2009
23915,1,20,Maxim Balmochnykh,0,6,1,LW,1999
23916,0,20,Maxim Bets,0,3,0,RW,1993
23917,1,23,Maxim Galanov,0,6,1,D,1997
23918,3,24,Maxim Galanov,4,51,7,D,1998
23919,3,25,Maxim Galanov,4,40,7,D,1999
23920,5,26,Maxim Galanov,0,25,5,D,2000
23921,0,21,Maxim Kondratiev,0,7,0,D,2003
23922,2,23,Maxim Kondratiev,1,29,3,D,2005
23923,0,25,Maxim Kondratiev,0,4,0,D,2007
23924,2,23,Maxim Kuznetsov,1,25,3,D,2000
23925,2,24,Maxim Kuznetsov,1,39,3,D,2001
23926,3,25,Maxim Kuznetsov,0,56,3,D,2002
23927,1,26,Maxim Kuznetsov,0,16,1,D,2003
23928,0,20,Maxim Lapierre,0,1,0,C,2005
23929,6,21,Maxim Lapierre,6,46,12,C,2006
23930,11,22,Maxim Lapierre,7,53,18,C,2007
23931,13,23,Maxim Lapierre,15,79,28,C,2008
23932,7,24,Maxim Lapierre,7,76,14,C,2009
23933,6,25,Maxim Lapierre,6,78,12,C,2010
23934,10,26,Maxim Lapierre,9,82,19,C,2011
23935,6,27,Maxim Lapierre,4,48,10,C,2012
23936,6,28,Maxim Lapierre,9,71,15,C,2013
23937,9,29,Maxim Lapierre,2,80,11,C,2014
23938,1,23,Maxim Mamin,3,26,4,LW,2017
23939,0,22,Maxim Noreau,0,1,0,D,2009
23940,0,23,Maxim Noreau,0,5,0,D,2010
23941,4,26,Maxim Sushinsky,7,30,11,RW,2000
23942,0,26,Maxime Fortunus,0,8,0,D,2009
23943,1,30,Maxime Fortunus,0,1,1,D,2013
23944,3,23,Maxime Macenauer,1,29,4,C,2011
23945,3,21,Maxime Talbot,5,48,8,C,2005
23946,11,22,Maxime Talbot,13,75,24,C,2006
23947,14,23,Maxime Talbot,12,63,26,C,2007
23948,10,24,Maxime Talbot,12,75,22,C,2008
23949,5,25,Maxime Talbot,2,45,7,C,2009
23950,13,26,Maxime Talbot,8,82,21,C,2010
23951,15,27,Maxime Talbot,19,81,34,C,2011
23952,5,28,Maxime Talbot,5,35,10,C,2012
23953,19,29,Maxime Talbot,8,81,27,C,2013
23954,5,31,Maxime Talbot,2,38,7,C,2015
23955,0,22,Maynard Schurman,0,7,0,LW,1979
23956,0,31,Mel Angelstad,0,2,0,LW,2003
23957,27,20,Mel Bridgman,23,80,50,C,1975
23958,38,21,Mel Bridgman,19,70,57,C,1976
23959,32,22,Mel Bridgman,16,76,48,C,1977
23960,35,23,Mel Bridgman,24,76,59,C,1978
23961,31,24,Mel Bridgman,16,74,47,C,1979
23962,37,25,Mel Bridgman,14,77,51,C,1980
23963,54,26,Mel Bridgman,33,72,87,LW,1981
23964,31,27,Mel Bridgman,19,79,50,LW,1982
23965,38,28,Mel Bridgman,23,79,61,LW,1983
23966,39,29,Mel Bridgman,22,80,61,C,1984
23967,40,30,Mel Bridgman,23,78,63,LW,1985
23968,33,31,Mel Bridgman,10,64,43,C,1986
23969,11,32,Mel Bridgman,6,57,17,LW,1987
23970,3,33,Mel Bridgman,4,15,7,C,1988
23971,1,29,Mel Pearson,0,2,1,LW,1967
23972,12,34,Mel Pearson,8,70,20,LW,1972
23973,11,24,Melker Karlsson,13,53,24,C,2014
23974,9,25,Melker Karlsson,10,65,19,C,2015
23975,11,26,Melker Karlsson,11,67,22,C,2016
23976,11,27,Melker Karlsson,8,71,19,C,2017
23977,17,20,Merlin Malinowski,6,54,23,C,1978
23978,4,21,Merlin Malinowski,2,10,6,C,1979
23979,37,22,Merlin Malinowski,25,69,62,C,1980
23980,28,23,Merlin Malinowski,13,69,41,C,1981
23981,25,24,Merlin Malinowski,8,80,33,C,1982
23982,1,23,Merv Haney,0,7,1,D,1972
23983,4,24,Micah Aivazoff,4,59,8,LW,1993
23984,1,25,Micah Aivazoff,0,21,1,LW,1994
23985,1,26,Micah Aivazoff,0,12,1,C,1995
23986,4,21,Michael Amadio,4,37,8,C,2017
23987,7,21,Michael Bournival,7,60,14,LW,2013
23988,2,22,Michael Bournival,3,29,5,LW,2014
23989,1,24,Michael Bournival,2,19,3,LW,2016
23990,0,25,Michael Bournival,0,5,0,LW,2017
23991,0,24,Michael Caruso,0,2,0,D,2012
23992,1,21,Michael Chaput,0,17,1,C,2013
23993,4,22,Michael Chaput,1,33,5,C,2014
23994,1,23,Michael Chaput,1,8,2,C,2015
23995,5,24,Michael Chaput,4,68,9,C,2016
23996,0,25,Michael Chaput,0,9,0,C,2017
23997,1,23,Michael Colman,0,15,1,D,1991
23998,0,21,Michael Dal Colle,0,4,0,LW,2017
23999,0,23,Michael Dark,2,13,2,D,1986
24000,6,24,Michael Dark,3,30,9,RW,1987
24001,28,19,Michael Del Zotto,9,80,37,D,2009
24002,9,20,Michael Del Zotto,2,47,11,D,2010
24003,31,21,Michael Del Zotto,10,77,41,D,2011
24004,18,22,Michael Del Zotto,3,46,21,D,2012
24005,13,23,Michael Del Zotto,3,67,16,D,2013
24006,22,24,Michael Del Zotto,10,64,32,D,2014
24007,9,25,Michael Del Zotto,4,52,13,D,2015
24008,12,26,Michael Del Zotto,6,51,18,D,2016
24009,16,27,Michael Del Zotto,6,82,22,D,2017
24010,3,22,Michael Ferland,2,26,5,LW,2014
24011,24,20,Michael Frolik,21,79,45,C,2008
24012,22,21,Michael Frolik,21,82,43,C,2009
24013,27,22,Michael Frolik,11,80,38,C,2010
24014,10,23,Michael Frolik,5,63,15,C,2011
24015,7,24,Michael Frolik,3,45,10,C,2012
24016,27,25,Michael Frolik,15,81,42,RW,2013
24017,23,26,Michael Frolik,19,82,42,RW,2014
24018,17,27,Michael Frolik,15,64,32,RW,2015
24019,27,28,Michael Frolik,17,82,44,RW,2016
24020,15,29,Michael Frolik,10,70,25,RW,2017
24021,2,20,Michael Funk,0,5,2,D,2006
24022,0,21,Michael Funk,0,4,0,D,2007
24023,6,22,Michael Grabner,5,20,11,RW,2009
24024,18,23,Michael Grabner,34,76,52,RW,2010
24025,12,24,Michael Grabner,20,78,32,RW,2011
24026,5,25,Michael Grabner,16,45,21,RW,2012
24027,14,26,Michael Grabner,12,64,26,RW,2013
24028,5,27,Michael Grabner,8,34,13,RW,2014
24029,9,28,Michael Grabner,9,80,18,RW,2015
24030,13,29,Michael Grabner,27,76,40,RW,2016
24031,3,30,Michael Grabner,2,21,5,RW,2017
24032,0,24,Michael Holmqvist,2,21,2,RW,2003
24033,10,26,Michael Holmqvist,10,72,20,C,2005
24034,7,27,Michael Holmqvist,6,63,13,C,2006
24035,0,22,Michael Kapla,0,5,0,D,2016
24036,0,26,Michael Ker�nen,0,1,0,C,2015
24037,1,29,Michael Kostka,0,7,1,D,2014
24038,3,22,Michael Latta,1,17,4,C,2013
24039,6,23,Michael Latta,0,53,6,C,2014
24040,4,24,Michael Latta,3,43,7,C,2015
24041,0,21,Michael Matheson,0,3,0,D,2015
24042,1,20,Michael McCarron,1,20,2,RW,2015
24043,4,21,Michael McCarron,1,31,5,RW,2016
24044,1,22,Michael McCarron,0,18,1,RW,2017
24045,2,23,Michael Mersch,1,17,3,LW,2015
24046,22,20,Michael Nylander,11,59,33,C,1992
24047,42,21,Michael Nylander,13,73,55,LW,1993
24048,1,22,Michael Nylander,0,6,1,C,1994
24049,38,23,Michael Nylander,17,73,55,C,1995
24050,23,25,Michael Nylander,13,65,36,C,1997
24051,10,26,Michael Nylander,4,33,14,C,1998
24052,30,27,Michael Nylander,24,77,54,RW,1999
24053,39,28,Michael Nylander,25,82,64,C,2000
24054,46,29,Michael Nylander,15,82,61,C,2001
24055,43,30,Michael Nylander,17,80,60,C,2002
24056,13,31,Michael Nylander,1,18,14,C,2003
24057,56,33,Michael Nylander,23,81,79,C,2005
24058,57,34,Michael Nylander,26,79,83,C,2006
24059,26,35,Michael Nylander,11,40,37,C,2007
24060,24,36,Michael Nylander,9,72,33,C,2008
24061,1,21,Michael Paliotta,0,1,1,D,2014
24062,0,22,Michael Paliotta,0,1,0,D,2015
24063,0,19,Michael Peca,0,4,0,C,1993
24064,6,20,Michael Peca,6,33,12,C,1994
24065,20,21,Michael Peca,11,68,31,C,1995
24066,29,22,Michael Peca,20,79,49,C,1996
24067,22,23,Michael Peca,18,61,40,C,1997
24068,29,24,Michael Peca,27,82,56,C,1998
24069,21,25,Michael Peca,20,73,41,C,1999
24070,35,27,Michael Peca,25,80,60,C,2001
24071,29,28,Michael Peca,13,66,42,C,2002
24072,29,29,Michael Peca,11,76,40,C,2003
24073,14,31,Michael Peca,9,71,23,C,2005
24074,11,32,Michael Peca,4,35,15,C,2006
24075,26,33,Michael Peca,8,65,34,C,2007
24076,18,34,Michael Peca,4,71,22,C,2008
24077,13,25,Michael Raffl,9,68,22,LW,2013
24078,7,26,Michael Raffl,21,67,28,LW,2014
24079,18,27,Michael Raffl,13,82,31,LW,2015
24080,3,28,Michael Raffl,8,52,11,LW,2016
24081,9,29,Michael Raffl,13,76,22,LW,2017
24082,2,26,Michael Ryan,3,19,5,C,2006
24083,4,27,Michael Ryan,4,46,8,C,2007
24084,2,28,Michael Ryan,0,18,2,LW,2008
24085,38,23,Michael Ryder,25,81,63,RW,2003
24086,25,25,Michael Ryder,30,81,55,RW,2005
24087,28,26,Michael Ryder,30,82,58,RW,2006
24088,17,27,Michael Ryder,14,70,31,RW,2007
24089,26,28,Michael Ryder,27,74,53,RW,2008
24090,15,29,Michael Ryder,18,82,33,RW,2009
24091,23,30,Michael Ryder,18,79,41,RW,2010
24092,27,31,Michael Ryder,35,82,62,RW,2011
24093,19,32,Michael Ryder,16,46,35,RW,2012
24094,16,33,Michael Ryder,18,82,34,RW,2013
24095,13,34,Michael Ryder,6,47,19,RW,2014
24096,0,21,Michael Sauer,0,3,0,D,2008
24097,12,23,Michael Sauer,3,76,15,D,2010
24098,2,24,Michael Sauer,1,19,3,D,2011
24099,0,20,Michael Sgarbossa,0,6,0,C,2012
24100,1,22,Michael Sgarbossa,0,3,1,C,2014
24101,0,23,Michael Sgarbossa,0,1,0,C,2015
24102,2,24,Michael Sgarbossa,0,9,2,C,2016
24103,2,21,Michael Stone,1,13,3,D,2011
24104,4,22,Michael Stone,5,40,9,D,2012
24105,13,23,Michael Stone,8,70,21,D,2013
24106,15,24,Michael Stone,3,81,18,D,2014
24107,30,25,Michael Stone,6,75,36,D,2015
24108,4,26,Michael Stone,2,19,6,D,2016
24109,7,27,Michael Stone,3,82,10,D,2017
24110,20,25,Michael Thelven,6,60,26,D,1985
24111,15,26,Michael Thelven,5,34,20,D,1986
24112,25,27,Michael Thelven,6,67,31,D,1987
24113,18,28,Michael Thelven,3,40,21,D,1988
24114,2,29,Michael Thelven,0,6,2,D,1989
24115,1,21,Michael Ware,0,2,1,RW,1988
24116,0,22,Michael Ware,0,3,0,RW,1989
24117,1,21,Michael Zalewski,0,2,1,LW,2013
24118,1,23,Michael Zalewski,0,3,1,LW,2015
24119,0,24,Michael Zalewski,0,1,0,LW,2016
24120,1,19,Michal Barinka,0,9,1,D,2003
24121,1,21,Michal Barinka,0,25,1,D,2005
24122,0,18,Michal Grosek,1,3,1,LW,1993
24123,2,19,Michal Grosek,2,24,4,LW,1994
24124,4,20,Michal Grosek,6,23,10,LW,1995
24125,21,21,Michal Grosek,15,82,36,LW,1996
24126,20,22,Michal Grosek,10,67,30,LW,1997
24127,30,23,Michal Grosek,20,76,50,LW,1998
24128,27,24,Michal Grosek,13,75,40,LW,1999
24129,11,25,Michal Grosek,9,65,20,RW,2000
24130,2,26,Michal Grosek,3,15,5,RW,2001
24131,18,27,Michal Grosek,2,63,20,RW,2002
24132,2,28,Michal Grosek,3,33,5,RW,2003
24133,12,21,Michal Handzus,4,66,16,C,1998
24134,28,22,Michal Handzus,25,81,53,C,1999
24135,18,23,Michal Handzus,14,46,32,C,2000
24136,30,24,Michal Handzus,15,79,45,C,2001
24137,21,25,Michal Handzus,23,82,44,C,2002
24138,38,26,Michal Handzus,20,82,58,C,2003
24139,33,28,Michal Handzus,11,73,44,C,2005
24140,5,29,Michal Handzus,3,8,8,C,2006
24141,14,30,Michal Handzus,7,82,21,C,2007
24142,24,31,Michal Handzus,18,82,42,C,2008
24143,22,32,Michal Handzus,20,81,42,C,2009
24144,18,33,Michal Handzus,12,82,30,C,2010
24145,17,34,Michal Handzus,7,67,24,C,2011
24146,6,35,Michal Handzus,2,39,8,C,2012
24147,12,36,Michal Handzus,4,59,16,C,2013
24148,0,22,Michal Jordan,0,5,0,D,2012
24149,4,24,Michal Jordan,2,38,6,D,2014
24150,0,25,Michal Jordan,1,36,1,D,2015
24151,6,26,Michal Kempny,2,50,8,D,2016
24152,1,27,Michal Kempny,2,22,3,D,2017
24153,25,21,Michal Pivonka,18,73,43,C,1986
24154,23,22,Michal Pivonka,11,71,34,LW,1987
24155,19,23,Michal Pivonka,8,52,27,LW,1988
24156,39,24,Michal Pivonka,25,77,64,C,1989
24157,50,25,Michal Pivonka,20,79,70,C,1990
24158,57,26,Michal Pivonka,23,80,80,C,1991
24159,53,27,Michal Pivonka,21,69,74,C,1992
24160,36,28,Michal Pivonka,14,82,50,LW,1993
24161,23,29,Michal Pivonka,10,46,33,C,1994
24162,65,30,Michal Pivonka,16,73,81,C,1995
24163,16,31,Michal Pivonka,7,54,23,C,1996
24164,6,32,Michal Pivonka,3,33,9,LW,1997
24165,6,33,Michal Pivonka,5,36,11,C,1998
24166,0,20,Michal Repik,2,5,2,RW,2008
24167,2,21,Michal Repik,3,19,5,RW,2009
24168,6,22,Michal Repik,2,31,8,RW,2010
24169,3,23,Michal Repik,2,17,5,RW,2011
24170,17,21,Michal Rozsival,4,75,21,D,1999
24171,4,22,Michal Rozsival,1,30,5,D,2000
24172,20,23,Michal Rozsival,9,79,29,D,2001
24173,6,24,Michal Rozsival,4,53,10,D,2002
24174,25,27,Michal Rozsival,5,82,30,D,2005
24175,30,28,Michal Rozsival,10,80,40,D,2006
24176,25,29,Michal Rozsival,13,80,38,D,2007
24177,22,30,Michal Rozsival,8,76,30,D,2008
24178,20,31,Michal Rozsival,3,82,23,D,2009
24179,15,32,Michal Rozsival,6,65,21,D,2010
24180,12,33,Michal Rozsival,1,54,13,D,2011
24181,12,34,Michal Rozsival,0,27,12,D,2012
24182,7,35,Michal Rozsival,1,42,8,D,2013
24183,12,36,Michal Rozsival,1,65,13,D,2014
24184,12,37,Michal Rozsival,1,51,13,D,2015
24185,2,38,Michal Rozsival,1,22,3,D,2016
24186,3,22,Michal Sivek,3,38,6,C,2002
24187,4,20,Michal Sykora,1,22,5,D,1993
24188,4,21,Michal Sykora,0,16,4,D,1994
24189,16,22,Michal Sykora,4,79,20,D,1995
24190,14,23,Michal Sykora,3,63,17,D,1996
24191,3,24,Michal Sykora,1,28,4,D,1997
24192,2,25,Michal Sykora,1,10,3,D,1998
24193,11,27,Michal Sykora,5,49,16,D,2000
24194,14,23,Micheal Ferland,4,71,18,LW,2015
24195,10,24,Micheal Ferland,15,76,25,LW,2016
24196,20,25,Micheal Ferland,21,77,41,LW,2017
24197,0,23,Micheal Haley,0,2,0,C,2009
24198,1,24,Micheal Haley,2,27,3,C,2010
24199,0,25,Micheal Haley,0,14,0,C,2011
24200,0,26,Micheal Haley,0,9,0,C,2012
24201,0,28,Micheal Haley,0,4,0,C,2014
24202,0,29,Micheal Haley,1,16,1,C,2015
24203,10,30,Micheal Haley,2,58,12,C,2016
24204,6,31,Micheal Haley,3,75,9,LW,2017
24205,25,22,Michel Archambault,12,57,37,LW,1972
24206,25,22,Michel Archambault,12,57,37,LW,1972
24207,0,26,Michel Archambault,0,3,0,LW,1976
24208,7,20,Michel Bergeron,10,25,17,RW,1974
24209,27,21,Michel Bergeron,32,72,59,RW,1975
24210,12,22,Michel Bergeron,21,74,33,RW,1976
24211,6,23,Michel Bergeron,10,28,16,RW,1977
24212,6,24,Michel Bergeron,7,30,13,RW,1978
24213,0,20,Michel Bolduc,0,3,0,D,1981
24214,0,21,Michel Bolduc,0,7,0,D,1982
24215,7,20,Michel Boudreau,7,33,14,D,1972
24216,7,20,Michel Boudreau,7,33,14,D,1972
24217,0,21,Michel Boudreau,1,3,1,D,1973
24218,0,21,Michel Boudreau,1,3,1,D,1973
24219,32,20,Michel Briere,12,76,44,C,1969
24220,38,29,Michel Cormier,36,78,74,LW,1974
24221,38,29,Michel Cormier,36,78,74,LW,1974
24222,15,30,Michel Cormier,21,46,36,LW,1975
24223,15,30,Michel Cormier,21,46,36,LW,1975
24224,16,31,Michel Cormier,13,58,29,LW,1976
24225,16,31,Michel Cormier,13,58,29,LW,1976
24226,5,21,Michel Dubois,2,55,7,D,1975
24227,5,21,Michel Dubois,2,55,7,D,1975
24228,0,22,Michel Dubois,0,4,0,D,1976
24229,0,22,Michel Dubois,0,4,0,D,1976
24230,6,19,Michel Galarneau,2,30,8,C,1980
24231,0,20,Michel Galarneau,0,10,0,C,1981
24232,4,21,Michel Galarneau,5,38,9,C,1982
24233,32,19,Michel Goulet,22,77,54,LW,1979
24234,39,20,Michel Goulet,32,76,71,RW,1980
24235,42,21,Michel Goulet,42,80,84,LW,1981
24236,48,22,Michel Goulet,57,80,105,LW,1982
24237,65,23,Michel Goulet,56,75,121,LW,1983
24238,40,24,Michel Goulet,55,69,95,LW,1984
24239,51,25,Michel Goulet,53,75,104,LW,1985
24240,47,26,Michel Goulet,49,75,96,LW,1986
24241,58,27,Michel Goulet,48,80,106,LW,1987
24242,38,28,Michel Goulet,26,69,64,LW,1988
24243,30,29,Michel Goulet,20,65,50,LW,1989
24244,38,30,Michel Goulet,27,74,65,LW,1990
24245,41,31,Michel Goulet,22,75,63,LW,1991
24246,21,32,Michel Goulet,23,63,44,LW,1992
24247,14,33,Michel Goulet,16,56,30,LW,1993
24248,30,18,Michel Goulet*,28,78,58,RW,1978
24249,30,18,Michel Goulet*,28,78,58,RW,1978
24250,13,35,Michel Harvey,6,40,19,C,1972
24251,13,35,Michel Harvey,6,40,19,C,1972
24252,4,23,Michel Lachance,0,21,4,D,1978
24253,5,24,Michel Mongeau,1,7,6,C,1989
24254,1,25,Michel Mongeau,1,7,2,C,1990
24255,12,26,Michel Mongeau,3,36,15,C,1991
24256,1,27,Michel Mongeau,1,4,2,C,1992
24257,16,23,Michel Ouellet,16,50,32,LW,2005
24258,29,24,Michel Ouellet,19,73,48,RW,2006
24259,19,25,Michel Ouellet,17,64,36,RW,2007
24260,0,26,Michel Ouellet,0,3,0,RW,2008
24261,14,23,Michel Parizeau,3,58,17,LW,1971
24262,48,24,Michel Parizeau,25,75,73,LW,1972
24263,48,24,Michel Parizeau,25,75,73,LW,1972
24264,34,25,Michel Parizeau,26,78,60,LW,1973
24265,34,25,Michel Parizeau,26,78,60,LW,1973
24266,46,26,Michel Parizeau,28,78,74,C,1974
24267,46,26,Michel Parizeau,28,78,74,C,1974
24268,42,27,Michel Parizeau,25,81,67,C,1975
24269,37,28,Michel Parizeau,18,75,55,C,1976
24270,27,29,Michel Parizeau,13,70,40,C,1977
24271,27,29,Michel Parizeau,13,70,40,C,1977
24272,18,30,Michel Parizeau,7,52,25,C,1978
24273,18,30,Michel Parizeau,7,52,25,C,1978
24274,0,18,Michel Petit,0,2,0,D,1982
24275,9,19,Michel Petit,6,44,15,D,1983
24276,26,20,Michel Petit,5,69,31,D,1984
24277,6,21,Michel Petit,1,32,7,D,1985
24278,13,22,Michel Petit,12,69,25,D,1986
24279,27,23,Michel Petit,9,74,36,D,1987
24280,25,24,Michel Petit,8,69,33,D,1988
24281,24,25,Michel Petit,12,63,36,D,1989
24282,26,26,Michel Petit,13,73,39,D,1990
24283,23,27,Michel Petit,4,70,27,D,1991
24284,9,28,Michel Petit,3,35,12,D,1992
24285,21,29,Michel Petit,2,63,23,D,1993
24286,12,30,Michel Petit,5,40,17,D,1994
24287,8,31,Michel Petit,4,54,12,D,1995
24288,7,32,Michel Petit,2,38,9,D,1996
24289,2,33,Michel Petit,4,32,6,D,1997
24290,0,21,Michel Picard,1,5,1,LW,1990
24291,5,22,Michel Picard,3,25,8,LW,1991
24292,0,23,Michel Picard,4,25,4,LW,1992
24293,8,25,Michel Picard,5,24,13,LW,1994
24294,6,26,Michel Picard,2,17,8,LW,1995
24295,8,28,Michel Picard,1,16,9,LW,1997
24296,11,29,Michel Picard,11,45,22,LW,1998
24297,0,30,Michel Picard,0,2,0,LW,1999
24298,4,31,Michel Picard,1,7,5,LW,2000
24299,12,21,Michel Plante,13,70,25,C,1972
24300,12,21,Michel Plante,13,70,25,C,1972
24301,2,22,Michel Plante,3,22,5,LW,1973
24302,2,22,Michel Plante,3,22,5,LW,1973
24303,1,21,Michel Riesen,0,12,1,RW,2000
24304,15,28,Michel Rouleau,7,58,22,C,1972
24305,14,28,Michel Rouleau,7,52,21,C,1972
24306,1,28,Michel Rouleau,0,6,1,C,1972
24307,15,28,Michel Rouleau,7,58,22,C,1972
24308,14,28,Michel Rouleau,7,52,21,C,1972
24309,1,28,Michel Rouleau,0,6,1,C,1972
24310,4,29,Michel Rouleau,0,4,4,C,1973
24311,16,30,Michel Rouleau,6,53,22,C,1974
24312,6,30,Michel Rouleau,5,27,11,C,1974
24313,7,30,Michel Rouleau,1,19,8,C,1974
24314,3,30,Michel Rouleau,0,7,3,C,1974
24315,16,30,Michel Rouleau,6,53,22,C,1974
24316,6,30,Michel Rouleau,5,27,11,C,1974
24317,7,30,Michel Rouleau,1,19,8,C,1974
24318,0,21,Mick Vukota,1,17,1,RW,1987
24319,2,22,Mick Vukota,2,48,4,RW,1988
24320,8,23,Mick Vukota,4,76,12,RW,1989
24321,4,24,Mick Vukota,2,60,6,RW,1990
24322,6,25,Mick Vukota,0,74,6,RW,1991
24323,5,26,Mick Vukota,2,74,7,RW,1992
24324,1,27,Mick Vukota,3,72,4,RW,1993
24325,2,28,Mick Vukota,0,40,2,RW,1994
24326,1,29,Mick Vukota,1,32,2,RW,1995
24327,0,30,Mick Vukota,1,17,1,RW,1996
24328,0,31,Mick Vukota,1,64,1,RW,1997
24329,5,20,Mickey Redmond,6,41,11,RW,1967
24330,15,21,Mickey Redmond,9,65,24,RW,1968
24331,27,22,Mickey Redmond,27,75,54,RW,1969
24332,23,23,Mickey Redmond,20,61,43,RW,1970
24333,29,24,Mickey Redmond,42,78,71,RW,1971
24334,41,25,Mickey Redmond,52,76,93,RW,1972
24335,26,26,Mickey Redmond,51,76,77,RW,1973
24336,12,27,Mickey Redmond,15,29,27,RW,1974
24337,17,28,Mickey Redmond,11,37,28,RW,1975
24338,11,18,Mickey Volcan,2,49,13,D,1980
24339,5,19,Mickey Volcan,1,26,6,D,1981
24340,13,20,Mickey Volcan,4,68,17,D,1982
24341,4,21,Mickey Volcan,1,19,5,D,1983
24342,0,21,Micki DuPont,0,2,0,D,2001
24343,2,22,Micki DuPont,1,16,3,D,2002
24344,1,26,Micki DuPont,0,3,1,D,2006
24345,0,27,Micki DuPont,0,2,0,D,2007
24346,1,22,Miika Elomo,0,2,1,LW,1999
24347,0,21,Miikka Salomaki,1,1,1,RW,2014
24348,5,22,Miikka Salomaki,5,61,10,RW,2015
24349,0,23,Miikka Salomaki,0,5,0,RW,2016
24350,6,24,Miikka Salomaki,2,58,8,RW,2017
24351,17,28,Mika Alatalo,10,82,27,LW,1999
24352,12,29,Mika Alatalo,7,70,19,LW,2000
24353,2,28,Mika Pyorala,2,36,4,C,2009
24354,1,18,Mika Zibanejad,0,9,1,C,2011
24355,13,19,Mika Zibanejad,7,42,20,C,2012
24356,17,20,Mika Zibanejad,16,69,33,C,2013
24357,26,21,Mika Zibanejad,20,80,46,C,2014
24358,30,22,Mika Zibanejad,21,81,51,C,2015
24359,23,23,Mika Zibanejad,14,56,37,C,2016
24360,20,24,Mika Zibanejad,27,72,47,C,2017
24361,9,19,Mikael Andersson,1,32,10,LW,1985
24362,3,20,Mikael Andersson,0,16,3,LW,1986
24363,20,21,Mikael Andersson,3,37,23,LW,1987
24364,1,22,Mikael Andersson,0,14,1,LW,1988
24365,24,23,Mikael Andersson,13,50,37,LW,1989
24366,7,24,Mikael Andersson,4,41,11,LW,1990
24367,29,25,Mikael Andersson,18,74,47,RW,1991
24368,11,26,Mikael Andersson,16,77,27,LW,1992
24369,12,27,Mikael Andersson,13,76,25,RW,1993
24370,7,28,Mikael Andersson,4,36,11,RW,1994
24371,11,29,Mikael Andersson,8,64,19,RW,1995
24372,14,30,Mikael Andersson,5,70,19,RW,1996
24373,11,31,Mikael Andersson,6,72,17,LW,1997
24374,4,32,Mikael Andersson,2,47,6,RW,1998
24375,6,33,Mikael Andersson,2,55,8,LW,1999
24376,0,19,Mikael Backlund,0,1,0,C,2008
24377,9,20,Mikael Backlund,1,23,10,C,2009
24378,15,21,Mikael Backlund,10,73,25,C,2010
24379,7,22,Mikael Backlund,4,41,11,C,2011
24380,8,23,Mikael Backlund,8,32,16,C,2012
24381,21,24,Mikael Backlund,18,76,39,C,2013
24382,17,25,Mikael Backlund,10,52,27,C,2014
24383,26,26,Mikael Backlund,21,82,47,C,2015
24384,31,27,Mikael Backlund,22,81,53,C,2016
24385,31,28,Mikael Backlund,14,82,45,C,2017
24386,6,20,Mikael Granlund,2,27,8,C,2012
24387,33,21,Mikael Granlund,8,63,41,C,2013
24388,31,22,Mikael Granlund,8,68,39,C,2014
24389,31,23,Mikael Granlund,13,82,44,C,2015
24390,43,24,Mikael Granlund,26,81,69,C,2016
24391,46,25,Mikael Granlund,21,77,67,RW,2017
24392,2,25,Mikael Lindholm,2,18,4,C,1989
24393,44,21,Mikael Renberg,38,83,82,RW,1993
24394,31,22,Mikael Renberg,26,47,57,RW,1994
24395,20,23,Mikael Renberg,23,51,43,RW,1995
24396,37,24,Mikael Renberg,22,77,59,RW,1996
24397,22,25,Mikael Renberg,16,68,38,RW,1997
24398,23,26,Mikael Renberg,15,66,38,RW,1998
24399,25,27,Mikael Renberg,10,72,35,RW,1999
24400,38,29,Mikael Renberg,14,71,52,RW,2001
24401,21,30,Mikael Renberg,14,67,35,RW,2002
24402,13,31,Mikael Renberg,12,59,25,LW,2003
24403,0,24,Mikael Samuelsson,0,4,0,RW,2000
24404,10,25,Mikael Samuelsson,6,67,16,RW,2001
24405,14,26,Mikael Samuelsson,10,80,24,RW,2002
24406,6,27,Mikael Samuelsson,3,37,9,C,2003
24407,22,29,Mikael Samuelsson,23,71,45,RW,2005
24408,20,30,Mikael Samuelsson,14,53,34,RW,2006
24409,29,31,Mikael Samuelsson,11,73,40,RW,2007
24410,21,32,Mikael Samuelsson,19,81,40,RW,2008
24411,23,33,Mikael Samuelsson,30,74,53,RW,2009
24412,32,34,Mikael Samuelsson,18,75,50,RW,2010
24413,17,35,Mikael Samuelsson,14,54,31,RW,2011
24414,1,36,Mikael Samuelsson,0,4,1,RW,2012
24415,2,37,Mikael Samuelsson,1,26,3,RW,2013
24416,3,24,Mike A Green,1,24,4,C,2003
24417,38,19,Mike Allison,26,75,64,LW,1980
24418,15,20,Mike Allison,7,48,22,LW,1981
24419,9,21,Mike Allison,11,39,20,LW,1982
24420,12,22,Mike Allison,8,45,20,LW,1983
24421,15,23,Mike Allison,9,31,24,LW,1984
24422,13,24,Mike Allison,2,28,15,LW,1985
24423,16,25,Mike Allison,7,71,23,LW,1986
24424,15,26,Mike Allison,16,52,31,C,1987
24425,22,27,Mike Allison,14,55,36,RW,1988
24426,11,28,Mike Allison,2,55,13,C,1989
24427,14,20,Mike Amodeo,1,61,15,D,1972
24428,14,20,Mike Amodeo,1,61,15,D,1972
24429,11,21,Mike Amodeo,0,77,11,D,1973
24430,11,21,Mike Amodeo,0,77,11,D,1973
24431,13,22,Mike Amodeo,1,64,14,D,1974
24432,13,22,Mike Amodeo,1,64,14,D,1974
24433,8,23,Mike Amodeo,4,31,12,D,1975
24434,8,23,Mike Amodeo,4,31,12,D,1975
24435,1,25,Mike Amodeo,1,3,2,D,1977
24436,1,25,Mike Amodeo,1,3,2,D,1977
24437,18,26,Mike Amodeo,4,64,22,D,1978
24438,18,26,Mike Amodeo,4,64,22,D,1978
24439,0,27,Mike Amodeo,0,19,0,D,1979
24440,0,26,Mike Angelidis,1,6,1,C,2011
24441,0,27,Mike Angelidis,0,1,0,C,2012
24442,0,29,Mike Angelidis,0,3,0,LW,2014
24443,0,30,Mike Angelidis,1,4,1,LW,2015
24444,19,21,Mike Antonovich,20,75,39,C,1972
24445,19,21,Mike Antonovich,20,75,39,C,1972
24446,29,22,Mike Antonovich,21,68,50,C,1973
24447,29,22,Mike Antonovich,21,68,50,C,1973
24448,26,23,Mike Antonovich,24,67,50,C,1974
24449,26,23,Mike Antonovich,24,67,50,C,1974
24450,2,24,Mike Antonovich,0,12,2,C,1975
24451,21,24,Mike Antonovich,25,57,46,C,1975
24452,31,25,Mike Antonovich,40,75,71,C,1976
24453,21,25,Mike Antonovich,27,42,48,C,1976
24454,9,25,Mike Antonovich,12,26,21,C,1976
24455,1,25,Mike Antonovich,1,7,2,C,1976
24456,31,25,Mike Antonovich,40,75,71,C,1976
24457,21,25,Mike Antonovich,27,42,48,C,1976
24458,9,25,Mike Antonovich,12,26,21,C,1976
24459,35,26,Mike Antonovich,32,75,67,C,1977
24460,35,26,Mike Antonovich,32,75,67,C,1977
24461,27,27,Mike Antonovich,20,69,47,C,1978
24462,27,27,Mike Antonovich,20,69,47,C,1978
24463,1,28,Mike Antonovich,0,5,1,C,1979
24464,0,30,Mike Antonovich,0,2,0,C,1981
24465,7,31,Mike Antonovich,7,30,14,C,1982
24466,5,32,Mike Antonovich,3,38,8,C,1983
24467,2,27,Mike Backman,0,3,2,RW,1981
24468,3,28,Mike Backman,1,7,4,RW,1982
24469,1,29,Mike Backman,0,8,1,RW,1983
24470,0,26,Mike Baumgartner,0,17,0,D,1974
24471,1,20,Mike Berger,3,29,4,D,1987
24472,0,21,Mike Berger,0,1,0,D,1988
24473,2,24,Mike Bishai,0,14,2,C,2003
24474,6,21,Mike Blaisdell,3,32,9,RW,1980
24475,32,22,Mike Blaisdell,23,80,55,RW,1981
24476,23,23,Mike Blaisdell,18,80,41,RW,1982
24477,6,24,Mike Blaisdell,5,36,11,RW,1983
24478,0,25,Mike Blaisdell,1,12,1,RW,1984
24479,14,26,Mike Blaisdell,15,66,29,RW,1985
24480,1,27,Mike Blaisdell,1,10,2,RW,1986
24481,2,28,Mike Blaisdell,3,18,5,RW,1987
24482,0,29,Mike Blaisdell,1,9,1,RW,1988
24483,27,22,Mike Bloom,11,80,38,LW,1974
24484,17,23,Mike Bloom,13,76,30,LW,1975
24485,3,24,Mike Bloom,6,45,9,LW,1976
24486,0,20,Mike Blunden,0,9,0,RW,2006
24487,0,21,Mike Blunden,0,1,0,RW,2007
24488,2,23,Mike Blunden,2,40,4,RW,2009
24489,0,24,Mike Blunden,0,1,0,RW,2010
24490,2,25,Mike Blunden,2,39,4,RW,2011
24491,0,26,Mike Blunden,0,5,0,RW,2012
24492,0,27,Mike Blunden,0,7,0,RW,2013
24493,0,28,Mike Blunden,0,2,0,RW,2014
24494,2,29,Mike Blunden,3,20,5,RW,2015
24495,0,30,Mike Blunden,0,2,0,RW,2016
24496,0,31,Mike Blunden,0,1,0,RW,2017
24497,15,23,Mike Boland,1,41,16,RW,1972
24498,15,23,Mike Boland,1,41,16,RW,1972
24499,0,25,Mike Boland,0,2,0,RW,1974
24500,0,20,Mike Boland,0,1,0,D,1974
24501,2,24,Mike Boland,1,22,3,D,1978
24502,38,21,Mike Bossy,53,73,91,RW,1977
24503,57,22,Mike Bossy,69,80,126,RW,1978
24504,41,23,Mike Bossy,51,75,92,RW,1979
24505,51,24,Mike Bossy,68,79,119,RW,1980
24506,83,25,Mike Bossy,64,80,147,RW,1981
24507,58,26,Mike Bossy,60,79,118,RW,1982
24508,67,27,Mike Bossy,51,67,118,RW,1983
24509,59,28,Mike Bossy,58,76,117,RW,1984
24510,62,29,Mike Bossy,61,80,123,RW,1985
24511,37,30,Mike Bossy,38,63,75,RW,1986
24512,0,21,Mike Brown,0,1,0,LW,2000
24513,0,22,Mike Brown,0,15,0,LW,2001
24514,1,23,Mike Brown,1,16,2,LW,2002
24515,1,26,Mike Brown,0,2,1,LW,2005
24516,0,22,Mike Brown,1,19,1,RW,2007
24517,2,23,Mike Brown,2,48,4,RW,2008
24518,1,24,Mike Brown,6,75,7,RW,2009
24519,5,25,Mike Brown,3,50,8,RW,2010
24520,2,26,Mike Brown,2,50,4,RW,2011
24521,1,27,Mike Brown,1,39,2,RW,2012
24522,3,28,Mike Brown,2,56,5,RW,2013
24523,0,29,Mike Brown,0,12,0,RW,2014
24524,3,30,Mike Brown,2,58,5,RW,2015
24525,2,19,Mike Bullard,1,15,3,C,1980
24526,27,20,Mike Bullard,36,75,63,C,1981
24527,22,21,Mike Bullard,22,57,44,LW,1982
24528,41,22,Mike Bullard,51,76,92,C,1983
24529,31,23,Mike Bullard,32,68,63,C,1984
24530,42,24,Mike Bullard,41,77,83,C,1985
24531,36,25,Mike Bullard,30,71,66,C,1986
24532,55,26,Mike Bullard,48,79,103,C,1987
24533,38,27,Mike Bullard,27,74,65,C,1988
24534,37,28,Mike Bullard,27,70,64,C,1989
24535,14,30,Mike Bullard,14,65,28,C,1991
24536,18,28,Mike Busniuk,2,71,20,D,1979
24537,5,29,Mike Busniuk,1,72,6,D,1980
24538,2,21,Mike Byers,2,10,4,RW,1967
24539,2,22,Mike Byers,0,10,2,RW,1968
24540,18,24,Mike Byers,27,72,45,RW,1970
24541,12,25,Mike Byers,13,74,25,RW,1971
24542,21,26,Mike Byers,25,75,46,RW,1972
24543,17,26,Mike Byers,19,56,36,RW,1972
24544,4,26,Mike Byers,6,19,10,RW,1972
24545,21,26,Mike Byers,25,75,46,RW,1972
24546,17,26,Mike Byers,19,56,36,RW,1972
24547,4,26,Mike Byers,6,19,10,RW,1972
24548,21,27,Mike Byers,29,78,50,RW,1973
24549,21,27,Mike Byers,29,78,50,RW,1973
24550,26,28,Mike Byers,22,72,48,RW,1974
24551,26,28,Mike Byers,22,72,48,RW,1974
24552,6,29,Mike Byers,7,38,13,RW,1975
24553,6,29,Mike Byers,7,38,13,RW,1975
24554,0,22,Mike C Hoffman,0,1,0,C,2011
24555,0,23,Mike C Hoffman,0,3,0,C,2012
24556,3,24,Mike C Hoffman,3,25,6,C,2013
24557,21,25,Mike C Hoffman,27,79,48,D,2014
24558,30,26,Mike C Hoffman,29,78,59,LW,2015
24559,3,20,Mike Cammalleri,5,28,8,C,2002
24560,6,21,Mike Cammalleri,9,31,15,C,2003
24561,29,23,Mike Cammalleri,26,80,55,C,2005
24562,46,24,Mike Cammalleri,34,81,80,C,2006
24563,28,25,Mike Cammalleri,19,63,47,LW,2007
24564,43,26,Mike Cammalleri,39,81,82,LW,2008
24565,24,27,Mike Cammalleri,26,65,50,C,2009
24566,28,28,Mike Cammalleri,19,67,47,C,2010
24567,21,29,Mike Cammalleri,20,66,41,C,2011
24568,19,30,Mike Cammalleri,13,44,32,C,2012
24569,19,31,Mike Cammalleri,26,63,45,C,2013
24570,15,32,Mike Cammalleri,27,68,42,LW,2014
24571,24,33,Mike Cammalleri,14,42,38,LW,2015
24572,21,34,Mike Cammalleri,10,61,31,LW,2016
24573,4,35,Mike Cammalleri,3,15,7,LW,2017
24574,0,20,Mike Card,0,4,0,D,2006
24575,0,27,Mike Casselman,0,3,0,C,1995
24576,0,22,Mike Chernoff,0,1,0,LW,1968
24577,10,27,Mike Chernoff,11,36,21,LW,1973
24578,0,28,Mike Chernoff,0,3,0,LW,1974
24579,14,25,Mike Christie,0,34,14,D,1974
24580,18,26,Mike Christie,3,78,21,D,1975
24581,27,27,Mike Christie,6,79,33,D,1976
24582,14,28,Mike Christie,3,69,17,D,1977
24583,10,29,Mike Christie,1,68,11,D,1978
24584,17,30,Mike Christie,1,74,18,D,1979
24585,1,31,Mike Christie,1,10,2,D,1980
24586,4,21,Mike Commodore,1,20,5,D,2000
24587,1,22,Mike Commodore,0,37,1,D,2001
24588,1,23,Mike Commodore,0,6,1,D,2002
24589,0,24,Mike Commodore,0,12,0,D,2003
24590,10,26,Mike Commodore,3,72,13,D,2005
24591,22,27,Mike Commodore,7,82,29,D,2006
24592,11,28,Mike Commodore,3,67,14,D,2007
24593,19,29,Mike Commodore,5,81,24,D,2008
24594,9,30,Mike Commodore,2,57,11,D,2009
24595,4,31,Mike Commodore,2,20,6,D,2010
24596,2,32,Mike Commodore,0,30,2,D,2011
24597,14,20,Mike Comrie,8,41,22,C,2000
24598,27,21,Mike Comrie,33,82,60,C,2001
24599,31,22,Mike Comrie,20,69,51,C,2002
24600,12,23,Mike Comrie,12,49,24,C,2003
24601,30,25,Mike Comrie,30,80,60,C,2005
24602,25,26,Mike Comrie,20,65,45,C,2006
24603,28,27,Mike Comrie,21,76,49,C,2007
24604,17,28,Mike Comrie,10,63,27,C,2008
24605,8,29,Mike Comrie,13,43,21,C,2009
24606,5,30,Mike Comrie,1,21,6,C,2010
24607,0,22,Mike Connolly,0,2,0,LW,2011
24608,1,24,Mike Conroy,0,4,1,LW,1975
24609,1,24,Mike Conroy,0,4,1,LW,1975
24610,0,22,Mike Corrigan,0,5,0,RW,1967
24611,4,24,Mike Corrigan,6,36,10,RW,1969
24612,28,25,Mike Corrigan,21,76,49,RW,1970
24613,26,26,Mike Corrigan,15,75,41,RW,1971
24614,30,27,Mike Corrigan,37,78,67,RW,1972
24615,26,28,Mike Corrigan,16,75,42,RW,1973
24616,21,29,Mike Corrigan,13,80,34,RW,1974
24617,21,30,Mike Corrigan,22,71,43,LW,1975
24618,27,31,Mike Corrigan,14,73,41,LW,1976
24619,12,32,Mike Corrigan,8,25,20,LW,1977
24620,4,19,Mike Craig,8,39,12,RW,1990
24621,16,20,Mike Craig,15,67,31,RW,1991
24622,23,21,Mike Craig,15,70,38,RW,1992
24623,24,22,Mike Craig,13,72,37,RW,1993
24624,5,23,Mike Craig,5,37,10,RW,1994
24625,12,24,Mike Craig,8,70,20,LW,1995
24626,13,25,Mike Craig,7,65,20,RW,1996
24627,0,27,Mike Craig,0,1,0,RW,1998
24628,0,30,Mike Craig,0,2,0,RW,2001
24629,4,20,Mike Crombeen,3,48,7,C,1977
24630,8,21,Mike Crombeen,3,37,11,C,1978
24631,12,22,Mike Crombeen,10,71,22,C,1979
24632,14,23,Mike Crombeen,9,66,23,RW,1980
24633,8,24,Mike Crombeen,19,71,27,RW,1981
24634,11,25,Mike Crombeen,6,80,17,RW,1982
24635,4,26,Mike Crombeen,1,56,5,RW,1983
24636,7,27,Mike Crombeen,4,46,11,RW,1984
24637,2,22,Mike Crowley,2,8,4,D,1997
24638,3,23,Mike Crowley,2,20,5,D,1998
24639,10,25,Mike Crowley,1,39,11,D,2000
24640,2,20,Mike D Green,1,22,3,D,2005
24641,10,21,Mike D Green,2,70,12,D,2006
24642,38,22,Mike D Green,18,82,56,D,2007
24643,42,23,Mike D Green,31,68,73,D,2008
24644,57,24,Mike D Green,19,75,76,D,2009
24645,16,25,Mike D Green,8,49,24,D,2010
24646,4,26,Mike D Green,3,32,7,D,2011
24647,14,27,Mike D Green,12,35,26,D,2012
24648,29,28,Mike D Green,9,70,38,D,2013
24649,35,29,Mike D Green,10,72,45,D,2014
24650,28,30,Mike D Green,7,74,35,D,2015
24651,0,24,Mike D Peluso,0,2,0,D,1989
24652,1,25,Mike D Peluso,6,53,7,LW,1990
24653,3,26,Mike D Peluso,6,63,9,LW,1991
24654,10,27,Mike D Peluso,15,81,25,LW,1992
24655,16,28,Mike D Peluso,4,69,20,LW,1993
24656,9,29,Mike D Peluso,2,46,11,LW,1994
24657,8,30,Mike D Peluso,3,57,11,LW,1995
24658,5,31,Mike D Peluso,2,64,7,RW,1996
24659,0,32,Mike D Peluso,0,23,0,LW,1997
24660,0,20,Mike Danton,0,2,0,C,2000
24661,0,22,Mike Danton,2,17,2,C,2002
24662,5,23,Mike Danton,7,68,12,LW,2003
24663,1,23,Mike Donnelly,1,5,2,LW,1986
24664,10,24,Mike Donnelly,8,57,18,LW,1987
24665,6,25,Mike Donnelly,4,22,10,LW,1988
24666,2,26,Mike Donnelly,1,12,3,LW,1989
24667,5,27,Mike Donnelly,7,53,12,LW,1990
24668,16,28,Mike Donnelly,29,80,45,LW,1991
24669,40,29,Mike Donnelly,29,84,69,LW,1992
24670,21,30,Mike Donnelly,21,81,42,LW,1993
24671,15,31,Mike Donnelly,12,44,27,LW,1994
24672,5,32,Mike Donnelly,2,24,7,LW,1995
24673,0,33,Mike Donnelly,0,3,0,LW,1996
24674,0,22,Mike Duco,0,10,0,LW,2009
24675,0,23,Mike Duco,0,2,0,LW,2010
24676,2,24,Mike Duco,0,6,2,LW,2011
24677,3,21,Mike Dwyer,2,12,5,LW,1978
24678,0,22,Mike Dwyer,0,10,0,LW,1979
24679,1,23,Mike Dwyer,0,4,1,LW,1980
24680,2,24,Mike Dwyer,0,5,2,LW,1981
24681,0,19,Mike Eagles,0,2,0,C,1982
24682,12,22,Mike Eagles,11,73,23,LW,1985
24683,19,23,Mike Eagles,13,73,32,LW,1986
24684,10,24,Mike Eagles,10,76,20,LW,1987
24685,11,25,Mike Eagles,5,47,16,C,1988
24686,2,26,Mike Eagles,1,23,3,C,1989
24687,9,27,Mike Eagles,0,44,9,C,1990
24688,10,28,Mike Eagles,7,65,17,C,1991
24689,18,29,Mike Eagles,8,84,26,C,1992
24690,8,30,Mike Eagles,4,73,12,C,1993
24691,4,31,Mike Eagles,3,40,7,C,1994
24692,7,32,Mike Eagles,4,70,11,C,1995
24693,7,33,Mike Eagles,1,70,8,C,1996
24694,3,34,Mike Eagles,1,36,4,LW,1997
24695,2,35,Mike Eagles,4,52,6,C,1998
24696,0,36,Mike Eagles,2,25,2,LW,1999
24697,2,24,Mike Eastwood,0,9,2,C,1991
24698,6,25,Mike Eastwood,1,12,7,C,1992
24699,10,26,Mike Eastwood,8,54,18,C,1993
24700,11,27,Mike Eastwood,8,49,19,C,1994
24701,14,28,Mike Eastwood,14,80,28,C,1995
24702,10,29,Mike Eastwood,2,60,12,C,1996
24703,5,30,Mike Eastwood,6,58,11,C,1997
24704,21,31,Mike Eastwood,9,82,30,C,1998
24705,15,32,Mike Eastwood,19,79,34,C,1999
24706,17,33,Mike Eastwood,6,77,23,C,2000
24707,10,34,Mike Eastwood,7,71,17,C,2001
24708,13,35,Mike Eastwood,3,70,16,C,2002
24709,15,36,Mike Eastwood,4,82,19,C,2003
24710,0,22,Mike Eaves,0,3,0,C,1978
24711,28,23,Mike Eaves,18,56,46,C,1979
24712,24,24,Mike Eaves,10,48,34,C,1980
24713,10,25,Mike Eaves,11,25,21,RW,1981
24714,16,26,Mike Eaves,16,75,32,C,1982
24715,36,27,Mike Eaves,14,61,50,C,1983
24716,29,28,Mike Eaves,14,56,43,C,1984
24717,0,23,Mike Farrell,0,8,0,RW,2001
24718,0,24,Mike Farrell,0,4,0,RW,2002
24719,0,25,Mike Farrell,0,1,0,RW,2003
24720,0,20,Mike Fedorko,0,4,0,D,1976
24721,16,20,Mike Fidler,17,46,33,LW,1976
24722,28,21,Mike Fidler,23,78,51,LW,1977
24723,26,22,Mike Fidler,23,59,49,LW,1978
24724,4,23,Mike Fidler,5,24,9,LW,1979
24725,21,24,Mike Fidler,14,58,35,LW,1980
24726,1,25,Mike Fidler,0,2,1,LW,1981
24727,1,26,Mike Fidler,2,4,3,LW,1982
24728,5,19,Mike Fisher,4,32,9,C,1999
24729,12,20,Mike Fisher,7,60,19,C,2000
24730,9,21,Mike Fisher,15,58,24,C,2001
24731,20,22,Mike Fisher,18,74,38,C,2002
24732,6,23,Mike Fisher,4,24,10,C,2003
24733,22,25,Mike Fisher,22,68,44,C,2005
24734,26,26,Mike Fisher,22,68,48,C,2006
24735,24,27,Mike Fisher,23,79,47,C,2007
24736,19,28,Mike Fisher,13,78,32,C,2008
24737,28,29,Mike Fisher,25,79,53,C,2009
24738,17,30,Mike Fisher,19,82,36,C,2010
24739,27,31,Mike Fisher,24,72,51,C,2011
24740,11,32,Mike Fisher,10,38,21,C,2012
24741,29,33,Mike Fisher,20,75,49,C,2013
24742,20,34,Mike Fisher,19,59,39,C,2014
24743,10,35,Mike Fisher,13,70,23,C,2015
24744,24,36,Mike Fisher,18,72,42,C,2016
24745,2,37,Mike Fisher,2,16,4,C,2017
24746,35,21,Mike Foligno,36,80,71,RW,1979
24747,35,22,Mike Foligno,28,80,63,RW,1980
24748,44,23,Mike Foligno,33,82,77,RW,1981
24749,25,24,Mike Foligno,22,66,47,RW,1982
24750,31,25,Mike Foligno,32,70,63,RW,1983
24751,29,26,Mike Foligno,27,77,56,RW,1984
24752,39,27,Mike Foligno,41,79,80,RW,1985
24753,29,28,Mike Foligno,30,75,59,RW,1986
24754,28,29,Mike Foligno,29,74,57,RW,1987
24755,22,30,Mike Foligno,27,75,49,RW,1988
24756,25,31,Mike Foligno,15,61,40,RW,1989
24757,12,32,Mike Foligno,12,68,24,RW,1990
24758,8,33,Mike Foligno,6,33,14,RW,1991
24759,5,34,Mike Foligno,13,55,18,RW,1992
24760,5,35,Mike Foligno,4,43,9,RW,1993
24761,4,20,Mike Forbes,0,32,4,D,1977
24762,0,22,Mike Forbes,0,2,0,D,1979
24763,7,24,Mike Forbes,1,16,8,D,1981
24764,22,22,Mike Ford,12,73,34,D,1974
24765,22,22,Mike Ford,12,73,34,D,1974
24766,43,23,Mike Ford,13,81,56,D,1975
24767,43,23,Mike Ford,13,81,56,D,1975
24768,34,24,Mike Ford,8,76,42,D,1976
24769,20,24,Mike Ford,5,54,25,D,1976
24770,14,24,Mike Ford,3,22,17,D,1976
24771,34,24,Mike Ford,8,76,42,D,1976
24772,20,24,Mike Ford,5,54,25,D,1976
24773,14,24,Mike Ford,3,22,17,D,1976
24774,0,25,Mike Ford,0,3,0,D,1977
24775,32,20,Mike Gartner,36,77,68,RW,1979
24776,46,21,Mike Gartner,48,80,94,RW,1980
24777,45,22,Mike Gartner,35,80,80,RW,1981
24778,38,23,Mike Gartner,38,73,76,RW,1982
24779,45,24,Mike Gartner,40,80,85,RW,1983
24780,52,25,Mike Gartner,50,80,102,RW,1984
24781,40,26,Mike Gartner,35,74,75,RW,1985
24782,32,27,Mike Gartner,41,78,73,RW,1986
24783,33,28,Mike Gartner,48,80,81,RW,1987
24784,36,29,Mike Gartner,33,69,69,RW,1988
24785,41,30,Mike Gartner,45,79,86,RW,1989
24786,20,31,Mike Gartner,49,79,69,RW,1990
24787,41,32,Mike Gartner,40,76,81,RW,1991
24788,23,33,Mike Gartner,45,84,68,RW,1992
24789,30,34,Mike Gartner,34,81,64,RW,1993
24790,8,35,Mike Gartner,12,38,20,RW,1994
24791,19,36,Mike Gartner,35,82,54,RW,1995
24792,31,37,Mike Gartner,32,82,63,RW,1996
24793,15,38,Mike Gartner,12,60,27,RW,1997
24794,25,19,Mike Gartner*,27,78,52,RW,1978
24795,25,19,Mike Gartner*,27,78,52,RW,1978
24796,0,25,Mike Gaul,0,1,0,D,1998
24797,0,27,Mike Gaul,0,2,0,D,2000
24798,7,20,Mike Gillis,1,30,8,LW,1978
24799,5,21,Mike Gillis,4,40,9,LW,1979
24800,11,22,Mike Gillis,13,68,24,LW,1980
24801,8,23,Mike Gillis,9,53,17,LW,1981
24802,1,24,Mike Gillis,0,5,1,LW,1982
24803,11,25,Mike Gillis,6,50,17,LW,1983
24804,5,25,Mike Glumac,7,33,12,C,2005
24805,1,26,Mike Glumac,0,3,1,C,2006
24806,0,27,Mike Glumac,0,4,0,RW,2007
24807,22,31,Mike Green,14,72,36,D,2016
24808,25,32,Mike Green,8,66,33,D,2017
24809,17,22,Mike Grier,15,79,32,RW,1996
24810,6,23,Mike Grier,9,66,15,RW,1997
24811,24,24,Mike Grier,20,82,44,RW,1998
24812,22,25,Mike Grier,9,65,31,RW,1999
24813,16,26,Mike Grier,20,74,36,RW,2000
24814,17,27,Mike Grier,8,82,25,RW,2001
24815,17,28,Mike Grier,15,82,32,RW,2002
24816,20,29,Mike Grier,9,82,29,RW,2003
24817,16,31,Mike Grier,7,81,23,RW,2005
24818,17,32,Mike Grier,16,81,33,RW,2006
24819,13,33,Mike Grier,9,78,22,RW,2007
24820,13,34,Mike Grier,10,62,23,RW,2008
24821,12,35,Mike Grier,10,73,22,RW,2009
24822,11,36,Mike Grier,5,73,16,RW,2010
24823,0,22,Mike Halmo,1,20,1,LW,2013
24824,3,19,Mike Hartman,3,17,6,RW,1986
24825,1,20,Mike Hartman,3,18,4,LW,1987
24826,9,21,Mike Hartman,8,70,17,LW,1988
24827,10,22,Mike Hartman,11,60,21,LW,1989
24828,3,23,Mike Hartman,9,60,12,RW,1990
24829,4,24,Mike Hartman,4,75,8,LW,1991
24830,4,25,Mike Hartman,4,61,8,LW,1992
24831,1,26,Mike Hartman,1,35,2,LW,1993
24832,0,27,Mike Hartman,0,1,0,LW,1994
24833,1,20,Mike Heidt,0,6,1,D,1983
24834,1,21,Mike Hobin,1,9,2,C,1975
24835,1,21,Mike Hobin,1,9,2,C,1975
24836,18,22,Mike Hobin,17,68,35,C,1976
24837,18,22,Mike Hobin,17,68,35,C,1976
24838,35,27,Mike Hoffman,26,74,61,LW,2016
24839,34,28,Mike Hoffman,22,82,56,LW,2017
24840,0,22,Mike Hordy,0,2,0,D,1978
24841,0,23,Mike Hordy,0,9,0,D,1979
24842,8,23,Mike Hough,6,56,14,LW,1986
24843,2,24,Mike Hough,3,17,5,LW,1987
24844,10,25,Mike Hough,9,46,19,RW,1988
24845,13,26,Mike Hough,13,43,26,LW,1989
24846,20,27,Mike Hough,13,63,33,LW,1990
24847,22,28,Mike Hough,16,61,38,LW,1991
24848,22,29,Mike Hough,8,77,30,LW,1992
24849,23,30,Mike Hough,6,78,29,LW,1993
24850,7,31,Mike Hough,6,48,13,LW,1994
24851,16,32,Mike Hough,7,64,23,LW,1995
24852,6,33,Mike Hough,8,69,14,LW,1996
24853,7,34,Mike Hough,5,74,12,LW,1997
24854,0,35,Mike Hough,0,11,0,LW,1998
24855,16,21,Mike Hudson,7,41,23,C,1988
24856,12,22,Mike Hudson,9,49,21,C,1989
24857,9,23,Mike Hudson,7,55,16,C,1990
24858,15,24,Mike Hudson,14,76,29,C,1991
24859,7,25,Mike Hudson,1,41,8,C,1992
24860,7,26,Mike Hudson,4,48,11,C,1993
24861,9,27,Mike Hudson,2,40,11,LW,1994
24862,12,28,Mike Hudson,5,59,17,RW,1995
24863,0,29,Mike Hudson,0,7,0,C,1996
24864,8,26,Mike Hurlbut,1,23,9,D,1992
24865,0,27,Mike Hurlbut,0,1,0,D,1993
24866,0,31,Mike Hurlbut,0,3,0,D,1997
24867,0,32,Mike Hurlbut,0,1,0,D,1998
24868,0,33,Mike Hurlbut,0,1,0,D,1999
24869,21,27,Mike Hyndman,12,78,33,RW,1972
24870,14,27,Mike Hyndman,4,59,18,RW,1972
24871,7,27,Mike Hyndman,8,19,15,RW,1972
24872,21,27,Mike Hyndman,12,78,33,RW,1972
24873,14,27,Mike Hyndman,4,59,18,RW,1972
24874,7,27,Mike Hyndman,8,19,15,RW,1972
24875,1,28,Mike Hyndman,0,8,1,RW,1973
24876,1,28,Mike Hyndman,0,8,1,RW,1973
24877,0,25,Mike Iggulden,0,1,0,C,2007
24878,4,26,Mike Iggulden,1,11,5,C,2008
24879,1,22,Mike J Rucinski,0,9,1,D,1997
24880,1,23,Mike J Rucinski,0,15,1,D,1998
24881,0,25,Mike J Rucinski,0,2,0,D,2000
24882,0,25,Mike Jakubo,0,7,0,LW,1972
24883,0,25,Mike Jakubo,0,7,0,LW,1972
24884,2,22,Mike Johnson,2,13,4,RW,1996
24885,32,23,Mike Johnson,15,82,47,RW,1997
24886,24,24,Mike Johnson,20,79,44,RW,1998
24887,26,25,Mike Johnson,21,80,47,RW,1999
24888,30,26,Mike Johnson,13,76,43,RW,2000
24889,22,27,Mike Johnson,5,57,27,RW,2001
24890,40,28,Mike Johnson,23,82,63,RW,2002
24891,9,29,Mike Johnson,1,11,10,RW,2003
24892,38,31,Mike Johnson,16,80,54,RW,2005
24893,20,32,Mike Johnson,11,80,31,RW,2006
24894,3,33,Mike Johnson,2,21,5,RW,2007
24895,29,21,Mike Kaszycki,13,58,42,C,1977
24896,18,22,Mike Kaszycki,16,71,34,C,1978
24897,18,23,Mike Kaszycki,12,69,30,C,1979
24898,2,24,Mike Kaszycki,0,6,2,C,1980
24899,13,26,Mike Kaszycki,1,22,14,C,1982
24900,19,21,Mike Keane,16,69,35,RW,1988
24901,15,22,Mike Keane,9,74,24,RW,1989
24902,23,23,Mike Keane,13,73,36,RW,1990
24903,30,24,Mike Keane,11,67,41,RW,1991
24904,45,25,Mike Keane,15,77,60,RW,1992
24905,30,26,Mike Keane,16,80,46,RW,1993
24906,10,27,Mike Keane,10,48,20,C,1994
24907,17,28,Mike Keane,10,73,27,RW,1995
24908,17,29,Mike Keane,10,81,27,RW,1996
24909,13,30,Mike Keane,10,83,23,RW,1997
24910,23,31,Mike Keane,6,81,29,RW,1998
24911,21,32,Mike Keane,13,81,34,RW,1999
24912,14,33,Mike Keane,10,67,24,RW,2000
24913,11,34,Mike Keane,6,78,17,RW,2001
24914,5,35,Mike Keane,5,65,10,RW,2002
24915,9,36,Mike Keane,8,64,17,RW,2003
24916,0,21,Mike Keating,0,1,0,LW,1977
24917,0,23,Mike Keeler,0,1,0,D,1973
24918,0,23,Mike Keeler,0,1,0,D,1973
24919,12,22,Mike Kennedy,6,44,18,RW,1994
24920,17,23,Mike Kennedy,9,61,26,RW,1995
24921,6,24,Mike Kennedy,1,24,7,RW,1996
24922,1,25,Mike Kennedy,0,15,1,RW,1997
24923,0,26,Mike Kennedy,0,1,0,C,1998
24924,8,20,Mike Kitchen,1,60,9,D,1976
24925,17,21,Mike Kitchen,2,61,19,D,1977
24926,4,22,Mike Kitchen,1,53,5,D,1978
24927,6,23,Mike Kitchen,1,42,7,D,1979
24928,7,24,Mike Kitchen,1,75,8,D,1980
24929,8,25,Mike Kitchen,1,63,9,D,1981
24930,8,26,Mike Kitchen,4,77,12,D,1982
24931,4,27,Mike Kitchen,1,43,5,D,1983
24932,0,24,Mike Knuble,1,9,1,RW,1996
24933,6,25,Mike Knuble,7,53,13,RW,1997
24934,20,26,Mike Knuble,15,82,35,RW,1998
24935,8,27,Mike Knuble,12,73,20,RW,1999
24936,13,28,Mike Knuble,7,82,20,RW,2000
24937,6,29,Mike Knuble,8,54,14,RW,2001
24938,29,30,Mike Knuble,30,75,59,RW,2002
24939,25,31,Mike Knuble,21,82,46,LW,2003
24940,31,33,Mike Knuble,34,82,65,RW,2005
24941,30,34,Mike Knuble,24,64,54,RW,2006
24942,26,35,Mike Knuble,29,82,55,RW,2007
24943,20,36,Mike Knuble,27,82,47,RW,2008
24944,24,37,Mike Knuble,29,69,53,RW,2009
24945,16,38,Mike Knuble,24,79,40,RW,2010
24946,12,39,Mike Knuble,6,72,18,RW,2011
24947,4,40,Mike Knuble,4,28,8,RW,2012
24948,1,21,Mike Komisarek,0,21,1,D,2002
24949,4,22,Mike Komisarek,0,46,4,D,2003
24950,4,24,Mike Komisarek,2,71,6,D,2005
24951,15,25,Mike Komisarek,4,82,19,D,2006
24952,13,26,Mike Komisarek,4,75,17,D,2007
24953,9,27,Mike Komisarek,2,66,11,D,2008
24954,4,28,Mike Komisarek,0,34,4,D,2009
24955,9,29,Mike Komisarek,1,75,10,D,2010
24956,4,30,Mike Komisarek,1,45,5,D,2011
24957,0,31,Mike Komisarek,0,4,0,D,2012
24958,4,32,Mike Komisarek,0,32,4,D,2013
24959,0,20,Mike Korney,0,2,0,RW,1973
24960,2,21,Mike Korney,8,30,10,RW,1974
24961,7,22,Mike Korney,1,27,8,RW,1975
24962,1,25,Mike Korney,0,18,1,RW,1978
24963,8,27,Mike Kostka,0,35,8,D,2012
24964,7,28,Mike Kostka,4,28,11,D,2013
24965,1,30,Mike Kostka,0,15,1,D,2015
24966,3,21,Mike Krushelnyski,3,17,6,C,1981
24967,42,22,Mike Krushelnyski,23,79,65,LW,1982
24968,20,23,Mike Krushelnyski,25,66,45,LW,1983
24969,45,24,Mike Krushelnyski,43,80,88,LW,1984
24970,24,25,Mike Krushelnyski,16,54,40,LW,1985
24971,35,26,Mike Krushelnyski,16,80,51,LW,1986
24972,27,27,Mike Krushelnyski,20,76,47,LW,1987
24973,36,28,Mike Krushelnyski,26,78,62,LW,1988
24974,25,29,Mike Krushelnyski,16,63,41,LW,1989
24975,27,30,Mike Krushelnyski,18,74,45,LW,1990
24976,15,31,Mike Krushelnyski,9,72,24,LW,1991
24977,20,32,Mike Krushelnyski,19,84,39,LW,1992
24978,6,33,Mike Krushelnyski,5,54,11,C,1993
24979,3,34,Mike Krushelnyski,2,20,5,LW,1994
24980,1,19,Mike L Hoffman,0,2,1,LW,1982
24981,0,21,Mike L Hoffman,0,1,0,LW,1984
24982,2,22,Mike L Hoffman,1,6,3,LW,1985
24983,2,27,Mike L Peluso,4,37,6,RW,2001
24984,0,29,Mike L Peluso,0,1,0,RW,2003
24985,5,22,Mike Lalor,3,62,8,D,1985
24986,10,23,Mike Lalor,0,57,10,D,1986
24987,10,24,Mike Lalor,1,66,11,D,1987
24988,18,25,Mike Lalor,2,48,20,D,1988
24989,16,26,Mike Lalor,0,78,16,D,1989
24990,5,27,Mike Lalor,1,68,6,D,1990
24991,10,28,Mike Lalor,7,79,17,D,1991
24992,8,29,Mike Lalor,1,64,9,D,1992
24993,3,30,Mike Lalor,0,35,3,D,1993
24994,0,31,Mike Lalor,0,12,0,D,1994
24995,2,32,Mike Lalor,1,63,3,D,1995
24996,1,33,Mike Lalor,1,55,2,D,1996
24997,3,22,Mike Lampman,2,18,5,LW,1972
24998,0,23,Mike Lampman,2,29,2,LW,1973
24999,12,25,Mike Lampman,7,27,19,LW,1975
25000,5,26,Mike Lampman,6,22,11,LW,1976
25001,1,22,Mike Lauen,0,4,1,RW,1983
25002,6,23,Mike Laughton,2,35,8,C,1967
25003,23,24,Mike Laughton,20,53,43,C,1968
25004,19,25,Mike Laughton,16,76,35,C,1969
25005,0,26,Mike Laughton,1,25,1,C,1970
25006,20,28,Mike Laughton,16,67,36,C,1972
25007,20,28,Mike Laughton,16,67,36,C,1972
25008,18,29,Mike Laughton,20,71,38,C,1973
25009,18,29,Mike Laughton,20,71,38,C,1973
25010,9,30,Mike Laughton,8,65,17,C,1974
25011,9,30,Mike Laughton,8,65,17,C,1974
25012,1,20,Mike Leclerc,1,5,2,LW,1996
25013,0,21,Mike Leclerc,0,7,0,LW,1997
25014,0,22,Mike Leclerc,0,7,0,LW,1998
25015,11,23,Mike Leclerc,8,69,19,LW,1999
25016,20,24,Mike Leclerc,15,54,35,LW,2000
25017,24,25,Mike Leclerc,20,82,44,LW,2001
25018,19,26,Mike Leclerc,9,57,28,LW,2002
25019,3,27,Mike Leclerc,1,10,4,LW,2003
25020,16,29,Mike Leclerc,10,50,26,LW,2005
25021,0,27,Mike Liambas,0,1,0,LW,2016
25022,1,28,Mike Liambas,0,7,1,LW,2017
25023,6,23,Mike Lundin,0,81,6,D,2007
25024,2,24,Mike Lundin,0,25,2,D,2008
25025,10,25,Mike Lundin,3,49,13,D,2009
25026,11,26,Mike Lundin,1,69,12,D,2010
25027,2,27,Mike Lundin,0,17,2,D,2011
25028,1,28,Mike Lundin,0,11,1,D,2012
25029,0,28,Mike MacWilliam,0,6,0,C,1995
25030,9,25,Mike Maneluk,6,45,15,RW,1998
25031,0,26,Mike Maneluk,0,1,0,RW,1999
25032,1,27,Mike Maneluk,5,39,6,RW,2000
25033,12,19,Mike Marson,16,76,28,LW,1974
25034,7,20,Mike Marson,4,57,11,LW,1975
25035,1,21,Mike Marson,0,10,1,LW,1976
25036,4,22,Mike Marson,4,46,8,LW,1977
25037,0,23,Mike Marson,0,4,0,LW,1978
25038,0,24,Mike Marson,0,3,0,LW,1979
25039,10,22,Mike Matheson,7,81,17,D,2016
25040,17,23,Mike Matheson,10,81,27,D,2017
25041,0,29,Mike Matteucci,0,3,0,D,2000
25042,0,30,Mike Matteucci,0,3,0,D,2001
25043,1,21,Mike McBain,0,27,1,D,1997
25044,6,22,Mike McBain,0,37,6,D,1998
25045,0,20,Mike McDougal,0,1,0,RW,1978
25046,0,22,Mike McDougal,0,2,0,RW,1980
25047,0,23,Mike McDougal,0,3,0,RW,1981
25048,10,24,Mike McDougal,8,55,18,RW,1982
25049,29,20,Mike McEwen,14,80,43,D,1976
25050,13,21,Mike McEwen,5,57,18,D,1977
25051,38,22,Mike McEwen,20,80,58,D,1978
25052,47,23,Mike McEwen,12,76,59,D,1979
25053,38,24,Mike McEwen,11,78,49,D,1980
25054,39,25,Mike McEwen,10,73,49,D,1981
25055,11,26,Mike McEwen,2,42,13,D,1982
25056,26,27,Mike McEwen,10,62,36,D,1983
25057,27,28,Mike McEwen,11,56,38,D,1984
25058,17,29,Mike McEwen,5,55,22,D,1985
25059,8,30,Mike McEwen,8,48,16,D,1986
25060,3,31,Mike McEwen,0,9,3,D,1987
25061,0,23,Mike McHugh,0,3,0,LW,1988
25062,0,24,Mike McHugh,0,3,0,LW,1989
25063,0,25,Mike McHugh,0,6,0,LW,1990
25064,0,26,Mike McHugh,1,8,1,LW,1991
25065,12,24,Mike McKee,3,48,15,LW,1993
25066,33,26,Mike McMahon,14,74,47,D,1967
25067,19,27,Mike McMahon,0,63,19,D,1968
25068,3,28,Mike McMahon,1,14,4,D,1969
25069,0,29,Mike McMahon,0,12,0,D,1970
25070,0,30,Mike McMahon,0,1,0,D,1971
25071,39,31,Mike McMahon,12,75,51,D,1972
25072,39,31,Mike McMahon,12,75,51,D,1972
25073,35,32,Mike McMahon,10,71,45,D,1973
25074,35,32,Mike McMahon,10,71,45,D,1973
25075,15,33,Mike McMahon,5,64,20,D,1974
25076,15,33,Mike McMahon,5,64,20,D,1974
25077,12,34,Mike McMahon,2,69,14,D,1975
25078,12,34,Mike McMahon,2,69,14,D,1975
25079,0,23,Mike McNamara,0,19,0,LW,1972
25080,0,23,Mike McNamara,0,19,0,LW,1972
25081,7,24,Mike McNeill,4,37,11,C,1990
25082,4,25,Mike McNeill,1,26,5,LW,1991
25083,2,23,Mike McPhee,5,14,7,LW,1983
25084,22,24,Mike McPhee,17,70,39,LW,1984
25085,21,25,Mike McPhee,19,70,40,LW,1985
25086,21,26,Mike McPhee,18,79,39,LW,1986
25087,20,27,Mike McPhee,23,77,43,LW,1987
25088,22,28,Mike McPhee,19,73,41,LW,1988
25089,18,29,Mike McPhee,23,56,41,LW,1989
25090,21,30,Mike McPhee,22,64,43,LW,1990
25091,15,31,Mike McPhee,16,78,31,LW,1991
25092,22,32,Mike McPhee,18,84,40,LW,1992
25093,15,33,Mike McPhee,20,79,35,LW,1993
25094,0,20,Mike Meeker,0,4,0,RW,1978
25095,0,23,Mike Milbury,0,3,0,D,1975
25096,18,24,Mike Milbury,6,77,24,D,1976
25097,30,25,Mike Milbury,8,80,38,D,1977
25098,34,26,Mike Milbury,1,74,35,D,1978
25099,13,27,Mike Milbury,10,72,23,D,1979
25100,18,28,Mike Milbury,0,77,18,D,1980
25101,10,29,Mike Milbury,2,51,12,D,1981
25102,15,30,Mike Milbury,9,78,24,D,1982
25103,17,31,Mike Milbury,2,74,19,D,1983
25104,13,32,Mike Milbury,3,78,16,D,1984
25105,5,33,Mike Milbury,2,22,7,D,1985
25106,16,34,Mike Milbury,6,68,22,D,1986
25107,2,21,Mike Millar,2,10,4,RW,1986
25108,7,22,Mike Millar,7,28,14,RW,1987
25109,3,23,Mike Millar,6,18,9,RW,1988
25110,4,24,Mike Millar,1,15,5,RW,1989
25111,2,25,Mike Millar,2,7,4,RW,1990
25112,46,19,Mike Modano,29,80,75,RW,1989
25113,36,20,Mike Modano,28,79,64,RW,1990
25114,44,21,Mike Modano,33,76,77,RW,1991
25115,60,22,Mike Modano,33,82,93,C,1992
25116,43,23,Mike Modano,50,76,93,C,1993
25117,17,24,Mike Modano,12,30,29,C,1994
25118,45,25,Mike Modano,36,78,81,C,1995
25119,48,26,Mike Modano,35,80,83,C,1996
25120,38,27,Mike Modano,21,52,59,C,1997
25121,47,28,Mike Modano,34,77,81,C,1998
25122,43,29,Mike Modano,38,77,81,C,1999
25123,51,30,Mike Modano,33,81,84,C,2000
25124,43,31,Mike Modano,34,78,77,C,2001
25125,57,32,Mike Modano,28,79,85,C,2002
25126,30,33,Mike Modano,14,76,44,C,2003
25127,50,35,Mike Modano,27,78,77,C,2005
25128,21,36,Mike Modano,22,59,43,C,2006
25129,36,37,Mike Modano,21,82,57,C,2007
25130,31,38,Mike Modano,15,80,46,C,2008
25131,16,39,Mike Modano,14,59,30,C,2009
25132,11,40,Mike Modano,4,40,15,C,2010
25133,1,20,Mike Moher,0,9,1,LW,1982
25134,2,18,Mike Moller,2,5,4,RW,1980
25135,0,19,Mike Moller,0,9,0,RW,1981
25136,12,20,Mike Moller,6,49,18,RW,1982
25137,11,21,Mike Moller,5,59,16,RW,1983
25138,2,22,Mike Moller,0,5,2,RW,1984
25139,0,23,Mike Moller,0,1,0,RW,1985
25140,1,24,Mike Moller,2,6,3,RW,1986
25141,0,26,Mike Moore,1,6,1,D,2010
25142,3,22,Mike Mottau,0,18,3,D,2000
25143,0,23,Mike Mottau,0,1,0,D,2001
25144,0,24,Mike Mottau,0,4,0,D,2002
25145,13,29,Mike Mottau,4,76,17,D,2007
25146,14,30,Mike Mottau,1,80,15,D,2008
25147,16,31,Mike Mottau,2,79,18,D,2009
25148,3,32,Mike Mottau,0,20,3,D,2010
25149,2,33,Mike Mottau,0,35,2,D,2011
25150,0,35,Mike Mottau,0,8,0,D,2013
25151,23,21,Mike Murphy,20,63,43,RW,1971
25152,31,22,Mike Murphy,22,79,53,RW,1972
25153,17,23,Mike Murphy,15,69,32,RW,1973
25154,38,24,Mike Murphy,30,78,68,RW,1974
25155,42,25,Mike Murphy,26,80,68,RW,1975
25156,36,26,Mike Murphy,25,76,61,RW,1976
25157,36,27,Mike Murphy,20,72,56,RW,1977
25158,29,28,Mike Murphy,16,64,45,RW,1978
25159,22,29,Mike Murphy,27,80,49,RW,1979
25160,23,30,Mike Murphy,16,68,39,RW,1980
25161,10,31,Mike Murphy,5,28,15,RW,1981
25162,11,32,Mike Murphy,16,74,27,RW,1982
25163,0,21,Mike Murray,0,1,0,C,1987
25164,0,24,Mike Natyshak,0,4,0,RW,1987
25165,5,22,Mike Needham,8,56,13,RW,1992
25166,0,23,Mike Needham,1,30,1,RW,1993
25167,1,22,Mike O'Connell,1,6,2,D,1977
25168,22,23,Mike O'Connell,4,48,26,D,1978
25169,22,24,Mike O'Connell,8,78,30,D,1979
25170,38,25,Mike O'Connell,15,82,53,D,1980
25171,34,26,Mike O'Connell,5,80,39,D,1981
25172,39,27,Mike O'Connell,14,80,53,D,1982
25173,42,28,Mike O'Connell,18,75,60,D,1983
25174,40,29,Mike O'Connell,15,78,55,D,1984
25175,28,30,Mike O'Connell,9,76,37,D,1985
25176,26,31,Mike O'Connell,5,77,31,D,1986
25177,13,32,Mike O'Connell,6,48,19,D,1987
25178,15,33,Mike O'Connell,1,66,16,D,1988
25179,14,34,Mike O'Connell,4,66,18,D,1989
25180,0,24,Mike Pandolfo,0,3,0,LW,2003
25181,3,20,Mike Pelyk,0,24,3,D,1967
25182,9,21,Mike Pelyk,3,65,12,D,1968
25183,3,22,Mike Pelyk,1,36,4,D,1969
25184,21,23,Mike Pelyk,5,73,26,D,1970
25185,4,24,Mike Pelyk,1,46,5,D,1971
25186,16,25,Mike Pelyk,3,72,19,D,1972
25187,19,26,Mike Pelyk,12,71,31,D,1973
25188,26,27,Mike Pelyk,14,75,40,D,1974
25189,26,27,Mike Pelyk,14,75,40,D,1974
25190,23,28,Mike Pelyk,10,75,33,D,1975
25191,23,28,Mike Pelyk,10,75,33,D,1975
25192,2,29,Mike Pelyk,0,13,2,D,1976
25193,11,30,Mike Pelyk,1,41,12,D,1977
25194,0,25,Mike Polich,0,1,0,C,1977
25195,10,26,Mike Polich,6,73,16,C,1978
25196,14,27,Mike Polich,10,78,24,C,1979
25197,5,28,Mike Polich,8,74,13,LW,1980
25198,0,22,Mike Posavad,0,6,0,D,1985
25199,0,23,Mike Posavad,0,2,0,D,1986
25200,0,21,Mike Prokopec,0,9,0,RW,1995
25201,0,22,Mike Prokopec,0,6,0,RW,1996
25202,6,19,Mike Ramsey,1,13,7,D,1979
25203,14,20,Mike Ramsey,3,72,17,D,1980
25204,23,21,Mike Ramsey,7,80,30,D,1981
25205,30,22,Mike Ramsey,8,77,38,D,1982
25206,22,23,Mike Ramsey,9,72,31,D,1983
25207,22,24,Mike Ramsey,8,79,30,D,1984
25208,21,25,Mike Ramsey,7,76,28,D,1985
25209,31,26,Mike Ramsey,8,80,39,D,1986
25210,16,27,Mike Ramsey,5,63,21,D,1987
25211,14,28,Mike Ramsey,2,56,16,D,1988
25212,21,29,Mike Ramsey,4,73,25,D,1989
25213,14,30,Mike Ramsey,6,71,20,D,1990
25214,14,31,Mike Ramsey,3,66,17,D,1991
25215,10,32,Mike Ramsey,3,45,13,D,1992
25216,2,33,Mike Ramsey,2,65,4,D,1993
25217,2,34,Mike Ramsey,1,33,3,D,1994
25218,4,35,Mike Ramsey,2,47,6,D,1995
25219,0,36,Mike Ramsey,0,2,0,D,1996
25220,9,19,Mike Rathje,1,47,10,D,1993
25221,7,20,Mike Rathje,2,42,9,D,1994
25222,7,21,Mike Rathje,0,27,7,D,1995
25223,8,22,Mike Rathje,0,31,8,D,1996
25224,12,23,Mike Rathje,3,81,15,D,1997
25225,9,24,Mike Rathje,5,82,14,D,1998
25226,14,25,Mike Rathje,2,66,16,D,1999
25227,11,26,Mike Rathje,0,81,11,D,2000
25228,12,27,Mike Rathje,5,52,17,D,2001
25229,22,28,Mike Rathje,7,82,29,D,2002
25230,17,29,Mike Rathje,2,80,19,D,2003
25231,21,31,Mike Rathje,3,79,24,D,2005
25232,1,32,Mike Rathje,0,18,1,D,2006
25233,6,22,Mike Reilly,1,29,7,D,2015
25234,0,23,Mike Reilly,1,17,1,D,2016
25235,8,24,Mike Reilly,1,19,9,D,2017
25236,1,19,Mike Ribeiro,1,19,2,C,1999
25237,0,20,Mike Ribeiro,0,2,0,C,2000
25238,10,21,Mike Ribeiro,8,43,18,LW,2001
25239,12,22,Mike Ribeiro,5,52,17,LW,2002
25240,45,23,Mike Ribeiro,20,81,65,C,2003
25241,35,25,Mike Ribeiro,16,79,51,LW,2005
25242,41,26,Mike Ribeiro,18,81,59,C,2006
25243,56,27,Mike Ribeiro,27,76,83,C,2007
25244,56,28,Mike Ribeiro,22,82,78,C,2008
25245,34,29,Mike Ribeiro,19,66,53,C,2009
25246,52,30,Mike Ribeiro,19,82,71,C,2010
25247,45,31,Mike Ribeiro,18,74,63,C,2011
25248,36,32,Mike Ribeiro,13,48,49,C,2012
25249,31,33,Mike Ribeiro,16,80,47,C,2013
25250,47,34,Mike Ribeiro,15,82,62,C,2014
25251,43,35,Mike Ribeiro,7,81,50,C,2015
25252,21,36,Mike Ribeiro,4,46,25,C,2016
25253,20,19,Mike Ricci,21,68,41,C,1990
25254,36,20,Mike Ricci,20,78,56,C,1991
25255,51,21,Mike Ricci,27,77,78,C,1992
25256,21,22,Mike Ricci,30,83,51,C,1993
25257,21,23,Mike Ricci,15,48,36,C,1994
25258,21,24,Mike Ricci,6,62,27,C,1995
25259,19,25,Mike Ricci,13,63,32,C,1996
25260,18,26,Mike Ricci,9,65,27,C,1997
25261,26,27,Mike Ricci,13,82,39,C,1998
25262,24,28,Mike Ricci,20,82,44,C,1999
25263,22,29,Mike Ricci,22,81,44,C,2000
25264,34,30,Mike Ricci,19,79,53,C,2001
25265,23,31,Mike Ricci,11,75,34,C,2002
25266,19,32,Mike Ricci,7,71,26,C,2003
25267,6,34,Mike Ricci,10,78,16,C,2005
25268,1,35,Mike Ricci,0,7,1,C,2006
25269,0,21,Mike Richard,0,4,0,C,1987
25270,2,23,Mike Richard,0,3,2,C,1989
25271,23,20,Mike Richards,11,79,34,C,2005
25272,22,21,Mike Richards,10,59,32,C,2006
25273,47,22,Mike Richards,28,73,75,C,2007
25274,50,23,Mike Richards,30,79,80,C,2008
25275,31,24,Mike Richards,31,82,62,C,2009
25276,43,25,Mike Richards,23,81,66,C,2010
25277,26,26,Mike Richards,18,74,44,C,2011
25278,20,27,Mike Richards,12,48,32,C,2012
25279,30,28,Mike Richards,11,82,41,C,2013
25280,11,29,Mike Richards,5,53,16,C,2014
25281,3,30,Mike Richards,2,39,5,C,2015
25282,43,22,Mike Ridley,22,80,65,C,1985
25283,39,23,Mike Ridley,31,78,70,C,1986
25284,31,24,Mike Ridley,28,70,59,C,1987
25285,48,25,Mike Ridley,41,80,89,C,1988
25286,43,26,Mike Ridley,30,74,73,C,1989
25287,48,27,Mike Ridley,23,79,71,C,1990
25288,40,28,Mike Ridley,29,80,69,C,1991
25289,56,29,Mike Ridley,26,84,82,C,1992
25290,44,30,Mike Ridley,26,81,70,C,1993
25291,27,31,Mike Ridley,10,48,37,C,1994
25292,15,32,Mike Ridley,6,37,21,C,1995
25293,32,33,Mike Ridley,20,75,52,C,1996
25294,0,21,Mike Robitaille,0,4,0,D,1969
25295,9,22,Mike Robitaille,5,34,14,D,1970
25296,10,23,Mike Robitaille,2,31,12,D,1971
25297,17,24,Mike Robitaille,4,65,21,D,1972
25298,18,25,Mike Robitaille,2,71,20,D,1973
25299,23,26,Mike Robitaille,2,66,25,D,1974
25300,19,27,Mike Robitaille,8,71,27,D,1975
25301,9,28,Mike Robitaille,0,40,9,D,1976
25302,48,20,Mike Rogers,35,78,83,C,1974
25303,29,21,Mike Rogers,30,80,59,C,1975
25304,57,22,Mike Rogers,25,78,82,C,1976
25305,57,22,Mike Rogers,25,78,82,C,1976
25306,43,23,Mike Rogers,28,80,71,C,1977
25307,43,23,Mike Rogers,28,80,71,C,1977
25308,45,24,Mike Rogers,27,80,72,C,1978
25309,45,24,Mike Rogers,27,80,72,C,1978
25310,61,25,Mike Rogers,44,80,105,C,1979
25311,65,26,Mike Rogers,40,80,105,C,1980
25312,65,27,Mike Rogers,38,80,103,C,1981
25313,47,28,Mike Rogers,29,71,76,C,1982
25314,38,29,Mike Rogers,23,78,61,C,1983
25315,38,30,Mike Rogers,26,78,64,C,1984
25316,3,31,Mike Rogers,2,17,5,C,1985
25317,0,19,Mike Rowe,0,6,0,D,1984
25318,0,20,Mike Rowe,0,3,0,D,1985
25319,0,21,Mike Rowe,0,2,0,D,1986
25320,3,23,Mike Rupp,5,26,8,C,2002
25321,6,24,Mike Rupp,6,57,12,C,2003
25322,2,26,Mike Rupp,4,40,6,LW,2005
25323,3,27,Mike Rupp,6,76,9,RW,2006
25324,6,28,Mike Rupp,3,64,9,C,2007
25325,6,29,Mike Rupp,3,72,9,C,2008
25326,6,30,Mike Rupp,13,81,19,C,2009
25327,8,31,Mike Rupp,9,81,17,C,2010
25328,1,32,Mike Rupp,4,60,5,C,2011
25329,3,33,Mike Rupp,1,40,4,C,2012
25330,1,34,Mike Rupp,0,13,1,LW,2013
25331,0,25,Mike S Rucinski,0,1,0,C,1988
25332,0,23,Mike Santorelli,0,7,0,C,2008
25333,1,24,Mike Santorelli,2,25,3,C,2009
25334,21,25,Mike Santorelli,20,82,41,C,2010
25335,2,26,Mike Santorelli,9,60,11,C,2011
25336,2,27,Mike Santorelli,2,34,4,C,2012
25337,18,28,Mike Santorelli,10,49,28,C,2013
25338,21,29,Mike Santorelli,12,79,33,C,2014
25339,9,30,Mike Santorelli,9,70,18,C,2015
25340,0,23,Mike Siklenka,0,1,0,RW,2002
25341,0,24,Mike Siklenka,0,1,0,RW,2003
25342,1,19,Mike Sillinger,0,3,1,C,1990
25343,17,21,Mike Sillinger,4,51,21,C,1992
25344,21,22,Mike Sillinger,8,62,29,C,1993
25345,11,23,Mike Sillinger,4,28,15,C,1994
25346,24,24,Mike Sillinger,14,74,38,RW,1995
25347,20,25,Mike Sillinger,17,78,37,C,1996
25348,20,26,Mike Sillinger,21,75,41,C,1997
25349,5,27,Mike Sillinger,8,79,13,C,1998
25350,29,28,Mike Sillinger,23,80,52,RW,1999
25351,25,29,Mike Sillinger,16,68,41,C,2000
25352,23,30,Mike Sillinger,20,80,43,C,2001
25353,25,31,Mike Sillinger,18,75,43,C,2002
25354,11,32,Mike Sillinger,13,76,24,C,2003
25355,31,34,Mike Sillinger,32,79,63,C,2005
25356,33,35,Mike Sillinger,26,82,59,C,2006
25357,12,36,Mike Sillinger,14,52,26,C,2007
25358,0,37,Mike Sillinger,2,7,2,C,2008
25359,0,18,Mike Siltala,1,3,1,RW,1981
25360,0,23,Mike Siltala,0,1,0,RW,1986
25361,0,24,Mike Siltala,0,3,0,RW,1987
25362,0,26,Mike Sislo,0,14,0,RW,2013
25363,1,27,Mike Sislo,0,10,1,RW,2014
25364,1,28,Mike Sislo,3,18,4,RW,2015
25365,0,20,Mike Sleep,2,9,2,RW,1975
25366,0,20,Mike Sleep,2,9,2,RW,1975
25367,2,21,Mike Sleep,2,13,4,RW,1976
25368,2,21,Mike Sleep,2,13,4,RW,1976
25369,6,20,Mike Stapleton,3,39,9,C,1986
25370,9,21,Mike Stapleton,2,53,11,C,1987
25371,1,22,Mike Stapleton,0,7,1,C,1988
25372,1,24,Mike Stapleton,0,7,1,C,1990
25373,4,25,Mike Stapleton,4,19,8,C,1991
25374,9,26,Mike Stapleton,4,78,13,C,1992
25375,13,27,Mike Stapleton,12,81,25,C,1993
25376,11,28,Mike Stapleton,6,46,17,RW,1994
25377,14,29,Mike Stapleton,10,58,24,C,1995
25378,11,30,Mike Stapleton,4,55,15,C,1996
25379,5,31,Mike Stapleton,5,64,10,RW,1997
25380,9,32,Mike Stapleton,9,76,18,C,1998
25381,12,33,Mike Stapleton,10,62,22,C,1999
25382,6,34,Mike Stapleton,2,52,8,C,2000
25383,16,24,Mike Stevens,2,70,18,D,1974
25384,16,24,Mike Stevens,2,70,18,D,1974
25385,0,25,Mike Stevens,0,6,0,D,1975
25386,0,25,Mike Stevens,0,6,0,D,1975
25387,3,19,Mike Stevens,0,6,3,LW,1984
25388,1,22,Mike Stevens,0,7,1,RW,1987
25389,0,23,Mike Stevens,1,9,1,LW,1988
25390,0,24,Mike Stevens,0,1,0,LW,1989
25391,0,22,Mike Stothers,0,1,0,D,1984
25392,1,23,Mike Stothers,0,6,1,D,1985
25393,0,24,Mike Stothers,0,2,0,D,1986
25394,1,25,Mike Stothers,0,21,1,D,1987
25395,0,23,Mike Stuart,0,2,0,D,2003
25396,0,25,Mike Stuart,0,1,0,D,2005
25397,0,24,Mike Stutzel,0,9,0,LW,2003
25398,11,23,Mike Sullivan,8,64,19,C,1991
25399,8,24,Mike Sullivan,6,81,14,C,1992
25400,5,25,Mike Sullivan,4,45,9,LW,1993
25401,7,26,Mike Sullivan,4,38,11,LW,1994
25402,12,27,Mike Sullivan,9,81,21,LW,1995
25403,6,28,Mike Sullivan,5,67,11,RW,1996
25404,13,29,Mike Sullivan,5,77,18,C,1997
25405,4,30,Mike Sullivan,2,63,6,C,1998
25406,10,31,Mike Sullivan,5,79,15,C,1999
25407,4,32,Mike Sullivan,5,72,9,LW,2000
25408,2,33,Mike Sullivan,1,42,3,LW,2001
25409,0,20,Mike Toal,0,3,0,C,1979
25410,14,25,Mike Tomlak,7,70,21,C,1989
25411,8,26,Mike Tomlak,8,64,16,C,1990
25412,0,27,Mike Tomlak,0,6,0,C,1991
25413,0,29,Mike Tomlak,0,1,0,C,1993
25414,0,21,Mike Van Ryn,0,1,0,D,2000
25415,8,22,Mike Van Ryn,2,48,10,D,2001
25416,3,23,Mike Van Ryn,0,20,3,D,2002
25417,24,24,Mike Van Ryn,13,79,37,D,2003
25418,29,26,Mike Van Ryn,8,80,37,D,2005
25419,25,27,Mike Van Ryn,4,78,29,D,2006
25420,2,28,Mike Van Ryn,0,20,2,D,2007
25421,8,29,Mike Van Ryn,3,27,11,D,2008
25422,0,23,Mike Vecchione,0,2,0,RW,2016
25423,0,21,Mike Vellucci,0,2,0,D,1987
25424,0,22,Mike Vernace,0,12,0,D,2008
25425,1,24,Mike Vernace,0,10,1,D,2010
25426,0,25,Mike Walsh,0,1,0,LW,1987
25427,0,26,Mike Walsh,2,13,2,LW,1988
25428,29,23,Mike Walton,30,73,59,C,1967
25429,21,24,Mike Walton,22,66,43,C,1968
25430,34,25,Mike Walton,21,58,55,RW,1969
25431,15,26,Mike Walton,6,45,21,C,1970
25432,28,27,Mike Walton,28,76,56,C,1971
25433,22,28,Mike Walton,25,56,47,C,1972
25434,60,29,Mike Walton,57,78,117,LW,1973
25435,60,29,Mike Walton,57,78,117,LW,1973
25436,45,30,Mike Walton,48,75,93,RW,1974
25437,45,30,Mike Walton,48,75,93,RW,1974
25439,40,31,Mike Walton,31,58,71,RW,1975
25440,40,31,Mike Walton,31,58,71,RW,1975
25438,8,31,Mike Walton,8,10,16,C,1975
25441,24,32,Mike Walton,7,40,31,RW,1976
25442,37,33,Mike Walton,29,65,66,C,1977
25443,16,34,Mike Walton,17,62,33,C,1978
25444,2,21,Mike Watt,1,14,3,C,1997
25445,17,22,Mike Watt,8,75,25,LW,1998
25446,6,23,Mike Watt,5,45,11,LW,1999
25447,1,24,Mike Watt,1,18,2,RW,2000
25448,0,26,Mike Watt,0,5,0,LW,2002
25449,1,23,Mike Weaver,0,16,1,D,2001
25450,5,24,Mike Weaver,0,40,5,D,2002
25451,0,25,Mike Weaver,0,1,0,D,2003
25452,9,27,Mike Weaver,0,53,9,D,2005
25453,6,28,Mike Weaver,3,39,9,D,2006
25454,1,29,Mike Weaver,0,55,1,D,2007
25455,7,30,Mike Weaver,0,58,7,D,2008
25456,9,31,Mike Weaver,1,77,10,D,2009
25457,11,32,Mike Weaver,2,82,13,D,2010
25458,16,33,Mike Weaver,0,82,16,D,2011
25459,8,34,Mike Weaver,1,27,9,D,2012
25460,12,35,Mike Weaver,1,72,13,D,2013
25461,4,36,Mike Weaver,0,31,4,D,2014
25462,3,20,Mike Weber,0,16,3,D,2007
25463,0,21,Mike Weber,0,7,0,D,2008
25464,13,23,Mike Weber,4,58,17,D,2010
25465,4,24,Mike Weber,1,51,5,D,2011
25466,6,25,Mike Weber,1,42,7,D,2012
25467,8,26,Mike Weber,1,68,9,D,2013
25468,6,27,Mike Weber,1,64,7,D,2014
25469,4,28,Mike Weber,1,45,5,D,2015
25470,8,20,Mike Wilson,4,58,12,D,1995
25471,9,21,Mike Wilson,2,77,11,D,1996
25472,4,22,Mike Wilson,4,66,8,D,1997
25473,2,23,Mike Wilson,1,34,3,D,1998
25474,16,24,Mike Wilson,4,60,20,D,1999
25475,1,25,Mike Wilson,0,19,1,D,2000
25476,1,26,Mike Wilson,1,21,2,D,2001
25477,0,27,Mike Wilson,0,1,0,D,2002
25478,1,21,Mike Wong,1,22,2,C,1975
25479,24,22,Mike York,26,82,50,C,1999
25480,17,23,Mike York,14,79,31,C,2000
25481,41,24,Mike York,20,81,61,RW,2001
25482,29,25,Mike York,22,71,51,RW,2002
25483,26,26,Mike York,16,61,42,C,2003
25484,39,28,Mike York,13,75,52,C,2005
25485,11,29,Mike York,10,66,21,LW,2006
25486,8,30,Mike York,6,63,14,LW,2007
25487,0,31,Mike York,0,1,0,LW,2008
25488,1,22,Mike Zigomanis,2,19,3,C,2002
25489,3,23,Mike Zigomanis,0,17,3,C,2003
25490,0,25,Mike Zigomanis,1,23,1,C,2005
25491,9,26,Mike Zigomanis,14,75,23,C,2006
25492,1,27,Mike Zigomanis,2,33,3,C,2007
25493,4,28,Mike Zigomanis,2,22,6,C,2008
25494,1,30,Mike Zigomanis,0,8,1,C,2010
25495,4,22,Mike Zuke,3,15,7,C,1976
25496,4,22,Mike Zuke,3,15,7,C,1976
25497,34,23,Mike Zuke,23,71,57,C,1977
25498,34,23,Mike Zuke,23,71,57,C,1977
25499,17,24,Mike Zuke,9,34,26,C,1978
25500,42,25,Mike Zuke,22,69,64,C,1979
25501,44,26,Mike Zuke,24,74,68,C,1980
25502,40,27,Mike Zuke,13,76,53,C,1981
25503,16,28,Mike Zuke,8,43,24,C,1982
25504,23,29,Mike Zuke,6,75,29,C,1983
25505,12,30,Mike Zuke,4,67,16,C,1984
25506,2,31,Mike Zuke,0,17,2,C,1985
25507,0,23,Mikhail Grabovski,0,3,0,C,2006
25508,6,24,Mikhail Grabovski,3,24,9,C,2007
25509,28,25,Mikhail Grabovski,20,78,48,C,2008
25510,25,26,Mikhail Grabovski,10,59,35,C,2009
25511,29,27,Mikhail Grabovski,29,81,58,C,2010
25512,28,28,Mikhail Grabovski,23,74,51,C,2011
25513,7,29,Mikhail Grabovski,9,48,16,C,2012
25514,22,30,Mikhail Grabovski,13,58,35,C,2013
25515,10,31,Mikhail Grabovski,9,51,19,C,2014
25516,16,32,Mikhail Grabovski,9,58,25,C,2015
25517,4,18,Mikhail Grigorenko,1,25,5,C,2012
25518,1,19,Mikhail Grigorenko,2,18,3,C,2013
25519,3,20,Mikhail Grigorenko,3,25,6,C,2014
25520,21,21,Mikhail Grigorenko,6,74,27,C,2015
25521,13,22,Mikhail Grigorenko,10,75,23,C,2016
25522,0,28,Mikhail Kravets,0,1,0,LW,1991
25523,0,29,Mikhail Kravets,0,1,0,RW,1992
25524,0,23,Mikhail Kuleshov,0,3,0,LW,2003
25525,0,18,Mikhail Sergachev,0,4,0,D,2016
25526,31,19,Mikhail Sergachev,9,79,40,D,2017
25527,1,20,Mikhail Shostak,1,6,2,C,1977
25528,1,20,Mikhail Shostak,1,6,2,C,1977
25529,0,28,Mikhail Slitchenko,0,6,0,RW,1978
25530,0,28,Mikhail Slitchenko,0,6,0,RW,1978
25531,15,24,Mikhail Tatarinov,8,65,23,D,1990
25532,27,25,Mikhail Tatarinov,11,66,38,D,1991
25533,6,26,Mikhail Tatarinov,2,28,8,D,1992
25534,0,27,Mikhail Tatarinov,0,2,0,D,1993
25535,7,21,Mikhail Yakubov,1,30,8,C,2003
25536,3,23,Mikhail Yakubov,1,23,4,C,2005
25537,17,19,Mikkel Boedker,11,78,28,LW,2008
25538,2,20,Mikkel Boedker,1,14,3,LW,2009
25539,10,21,Mikkel Boedker,4,34,14,LW,2010
25540,13,22,Mikkel Boedker,11,82,24,LW,2011
25541,19,23,Mikkel Boedker,7,48,26,LW,2012
25542,32,24,Mikkel Boedker,19,82,51,LW,2013
25543,14,25,Mikkel Boedker,14,45,28,LW,2014
25544,34,26,Mikkel Boedker,17,80,51,LW,2015
25545,16,27,Mikkel Boedker,10,81,26,LW,2016
25546,22,28,Mikkel Boedker,15,74,37,LW,2017
25547,12,27,Mikko Eloranta,6,50,18,LW,1999
25548,11,28,Mikko Eloranta,12,62,23,LW,2000
25549,9,29,Mikko Eloranta,9,77,18,LW,2001
25550,12,30,Mikko Eloranta,5,75,17,LW,2002
25551,0,22,Mikko Jokela,0,1,0,D,2002
25552,0,21,Mikko K Lehtonen,0,1,0,RW,2008
25553,0,22,Mikko K Lehtonen,0,1,0,RW,2009
25554,15,22,Mikko Koivu,6,64,21,C,2005
25555,34,23,Mikko Koivu,20,82,54,C,2006
25556,31,24,Mikko Koivu,11,57,42,C,2007
25557,47,25,Mikko Koivu,20,79,67,C,2008
25558,49,26,Mikko Koivu,22,80,71,C,2009
25559,45,27,Mikko Koivu,17,71,62,C,2010
25560,32,28,Mikko Koivu,12,55,44,C,2011
25561,26,29,Mikko Koivu,11,48,37,C,2012
25562,43,30,Mikko Koivu,11,65,54,C,2013
25563,34,31,Mikko Koivu,14,80,48,C,2014
25564,39,32,Mikko Koivu,17,82,56,C,2015
25565,40,33,Mikko Koivu,18,80,58,C,2016
25566,31,34,Mikko Koivu,14,82,45,C,2017
25567,20,26,Mikko Leinonen,11,53,31,C,1981
25568,34,27,Mikko Leinonen,17,78,51,C,1982
25569,23,28,Mikko Leinonen,3,28,26,C,1983
25570,1,29,Mikko Leinonen,0,3,1,C,1984
25571,1,27,Mikko Luoma,0,3,1,D,2003
25572,20,20,Mikko Makela,16,58,36,C,1985
25573,33,21,Mikko Makela,24,80,57,LW,1986
25574,40,22,Mikko Makela,36,73,76,RW,1987
25575,28,23,Mikko Makela,17,76,45,LW,1988
25576,17,24,Mikko Makela,9,65,26,RW,1989
25577,7,25,Mikko Makela,15,60,22,LW,1990
25578,2,29,Mikko Makela,1,11,3,RW,1994
25579,0,19,Mikko Rantanen,0,9,0,RW,2015
25580,18,20,Mikko Rantanen,20,75,38,RW,2016
25581,55,21,Mikko Rantanen,29,81,84,RW,2017
25582,2,28,Mikko T Lehtonen,1,15,3,D,2006
25583,0,21,Milan Bartovic,1,3,1,RW,2002
25584,8,22,Milan Bartovic,1,23,9,RW,2003
25585,6,24,Milan Bartovic,1,24,7,RW,2005
25586,5,31,Milan Chalupa,0,14,5,D,1984
25587,0,,Milan Figala,0,4,0,D,1977
25588,34,22,Milan Hejduk,14,82,48,RW,1998
25589,36,23,Milan Hejduk,36,82,72,RW,1999
25590,38,24,Milan Hejduk,41,80,79,RW,2000
25591,23,25,Milan Hejduk,21,62,44,RW,2001
25592,48,26,Milan Hejduk,50,82,98,RW,2002
25593,40,27,Milan Hejduk,35,82,75,RW,2003
25594,34,29,Milan Hejduk,24,74,58,RW,2005
25595,35,30,Milan Hejduk,35,80,70,RW,2006
25596,25,31,Milan Hejduk,29,77,54,RW,2007
25597,32,32,Milan Hejduk,27,82,59,RW,2008
25598,21,33,Milan Hejduk,23,56,44,RW,2009
25599,34,34,Milan Hejduk,22,71,56,RW,2010
25600,23,35,Milan Hejduk,14,81,37,RW,2011
25601,7,36,Milan Hejduk,4,29,11,RW,2012
25602,5,22,Milan Jurcina,6,51,11,D,2005
25603,8,23,Milan Jurcina,4,70,12,D,2006
25604,8,24,Milan Jurcina,1,75,9,D,2007
25605,11,25,Milan Jurcina,3,79,14,D,2008
25606,6,26,Milan Jurcina,1,44,7,D,2009
25607,13,27,Milan Jurcina,4,46,17,D,2010
25608,8,28,Milan Jurcina,3,65,11,D,2011
25609,0,,Milan Kraft,0,4,0,C,1977
25610,7,21,Milan Kraft,7,42,14,C,2000
25611,8,22,Milan Kraft,8,68,16,C,2001
25612,5,23,Milan Kraft,7,31,12,C,2002
25613,21,24,Milan Kraft,19,66,40,C,2003
25614,0,22,Milan Kytnar,0,1,0,C,2011
25615,19,19,Milan Lucic,8,77,27,LW,2007
25616,25,20,Milan Lucic,17,72,42,LW,2008
25617,11,21,Milan Lucic,9,50,20,LW,2009
25618,32,22,Milan Lucic,30,79,62,LW,2010
25619,35,23,Milan Lucic,26,81,61,LW,2011
25620,20,24,Milan Lucic,7,46,27,LW,2012
25621,35,25,Milan Lucic,24,80,59,LW,2013
25622,26,26,Milan Lucic,18,81,44,LW,2014
25623,35,27,Milan Lucic,20,81,55,LW,2015
25624,27,28,Milan Lucic,23,82,50,LW,2016
25625,24,29,Milan Lucic,10,82,34,LW,2017
25626,13,31,Milan Marcetta,4,36,17,C,1967
25627,2,32,Milan Marcetta,3,18,5,C,1968
25628,0,19,Milan Michalek,1,2,1,RW,2003
25629,18,21,Milan Michalek,17,81,35,RW,2005
25630,40,22,Milan Michalek,26,78,66,RW,2006
25631,31,23,Milan Michalek,24,79,55,LW,2007
25632,34,24,Milan Michalek,23,77,57,LW,2008
25633,12,25,Milan Michalek,22,66,34,RW,2009
25634,15,26,Milan Michalek,18,66,33,RW,2010
25635,25,27,Milan Michalek,35,77,60,RW,2011
25636,10,28,Milan Michalek,4,23,14,RW,2012
25637,22,29,Milan Michalek,17,82,39,LW,2013
25638,21,30,Milan Michalek,13,66,34,LW,2014
25639,9,31,Milan Michalek,7,45,16,LW,2015
25640,1,32,Milan Michalek,1,5,2,LW,2016
25641,30,31,Milan Novy,18,73,48,C,1982
25642,1,23,Milan Tichy,0,13,1,D,1992
25643,0,25,Milan Tichy,0,2,0,D,1994
25644,4,26,Milan Tichy,0,8,4,D,1995
25645,0,20,Miles Wood,0,1,0,LW,2015
25646,9,21,Miles Wood,8,60,17,LW,2016
25647,13,22,Miles Wood,19,76,32,LW,2017
25648,19,20,Miles Zaharko,1,71,20,D,1977
25649,0,21,Miles Zaharko,0,1,0,D,1978
25650,11,23,Miles Zaharko,3,42,14,D,1980
25651,2,24,Miles Zaharko,1,15,3,D,1981
25652,1,22,Milos Holan,1,8,2,D,1993
25653,8,23,Milos Holan,2,25,10,D,1994
25654,2,24,Milos Holan,2,16,4,D,1995
25655,0,28,Milos Horan,1,5,1,RW,1978
25656,0,28,Milos Horan,1,5,1,RW,1978
25657,2,,Milos Novak,0,7,2,LW,1977
25658,2,,Milos Novak,0,7,2,LW,1977
25659,0,28,Milos Novak,2,5,2,RW,1978
25660,0,28,Milos Novak,2,5,2,RW,1978
25661,1,22,Miloslav Guren,0,12,1,D,1998
25662,2,23,Miloslav Guren,1,24,3,D,1999
25663,1,27,Miloslav Horava,0,6,1,D,1988
25664,10,28,Miloslav Horava,4,45,14,D,1989
25665,6,29,Miloslav Horava,1,29,7,D,1990
25666,1,,Milow Tarant,1,6,2,LW,1977
25667,1,,Milow Tarant,1,6,2,LW,1977
25668,16,23,Milt Black,18,75,34,RW,1972
25669,16,23,Milt Black,18,75,34,RW,1972
25670,9,24,Milt Black,6,47,15,RW,1973
25671,6,25,Milt Black,4,64,10,RW,1974
25672,3,19,Mirco Mueller,1,39,4,D,2014
25673,0,20,Mirco Mueller,0,11,0,D,2015
25674,1,21,Mirco Mueller,1,4,2,D,2016
25675,4,22,Mirco Mueller,0,28,4,D,2017
25676,33,31,Miroslav Dvorak,4,80,37,D,1982
25677,27,32,Miroslav Dvorak,4,66,31,D,1983
25678,14,33,Miroslav Dvorak,3,47,17,D,1984
25679,23,22,Miroslav Frycer,24,59,47,RW,1981
25680,30,23,Miroslav Frycer,25,67,55,RW,1982
25681,16,24,Miroslav Frycer,10,47,26,RW,1983
25682,30,25,Miroslav Frycer,25,65,55,RW,1984
25683,43,26,Miroslav Frycer,32,73,75,RW,1985
25684,8,27,Miroslav Frycer,7,29,15,RW,1986
25685,20,28,Miroslav Frycer,12,38,32,RW,1987
25686,13,29,Miroslav Frycer,12,37,25,RW,1988
25687,4,23,Miroslav Ihnacak,2,21,6,LW,1985
25688,5,24,Miroslav Ihnacak,6,34,11,RW,1986
25689,0,26,Miroslav Ihnacak,0,1,0,LW,1988
25690,17,21,Miroslav Satan,18,62,35,RW,1995
25691,13,22,Miroslav Satan,25,76,38,LW,1996
25692,24,23,Miroslav Satan,22,79,46,LW,1997
25693,26,24,Miroslav Satan,40,81,66,LW,1998
25694,34,25,Miroslav Satan,33,81,67,RW,1999
25695,33,26,Miroslav Satan,29,82,62,RW,2000
25696,36,27,Miroslav Satan,37,82,73,RW,2001
25697,49,28,Miroslav Satan,26,79,75,RW,2002
25698,28,29,Miroslav Satan,29,82,57,RW,2003
25699,31,31,Miroslav Satan,35,82,66,RW,2005
25700,32,32,Miroslav Satan,27,81,59,RW,2006
25701,25,33,Miroslav Satan,16,80,41,RW,2007
25702,19,34,Miroslav Satan,17,65,36,RW,2008
25703,5,35,Miroslav Satan,9,38,14,LW,2009
25704,2,23,Miroslav Zalesak,1,10,3,RW,2002
25705,0,24,Miroslav Zalesak,0,2,0,RW,2003
25706,0,21,Mitch Babin,0,8,0,C,1975
25707,0,22,Mitch Callahan,0,1,0,RW,2013
25708,0,25,Mitch Callahan,0,4,0,RW,2016
25709,0,28,Mitch Fritz,0,20,0,LW,2008
25710,1,21,Mitch Lamoureux,1,8,2,C,1983
25711,8,22,Mitch Lamoureux,10,62,18,C,1984
25712,0,25,Mitch Lamoureux,0,3,0,C,1987
25713,42,19,Mitch Marner,19,77,61,C,2016
25714,47,20,Mitch Marner,22,82,69,C,2017
25715,1,22,Mitch Messier,0,13,1,RW,1987
25716,1,23,Mitch Messier,0,3,1,C,1988
25717,0,24,Mitch Messier,0,2,0,C,1989
25718,0,25,Mitch Messier,0,2,0,C,1990
25719,0,23,Mitch Molloy,0,2,0,LW,1989
25720,0,21,Mitch Reinke,0,1,0,D,2017
25721,2,22,Mitch Wilson,0,9,2,RW,1984
25722,1,24,Mitch Wilson,2,17,3,C,1986
25723,1,25,Moe L'Abbe,0,5,1,RW,1972
25724,2,19,Moe Lemay,1,5,3,LW,1981
25725,9,20,Moe Lemay,11,44,20,LW,1982
25726,18,21,Moe Lemay,12,56,30,LW,1983
25727,31,22,Moe Lemay,21,74,52,LW,1984
25728,15,23,Moe Lemay,16,48,31,LW,1985
25729,19,24,Moe Lemay,10,62,29,LW,1986
25730,0,25,Moe Lemay,0,6,0,LW,1987
25731,0,26,Moe Lemay,1,22,1,LW,1988
25732,23,20,Moe Mantha,2,58,25,D,1980
25733,12,21,Moe Mantha,0,25,12,D,1981
25734,7,22,Moe Mantha,2,21,9,D,1982
25735,38,23,Moe Mantha,16,72,54,D,1983
25736,40,24,Moe Mantha,11,71,51,D,1984
25737,52,25,Moe Mantha,15,78,67,D,1985
25738,31,26,Moe Mantha,9,62,40,D,1986
25739,27,27,Moe Mantha,11,76,38,D,1987
25740,14,28,Moe Mantha,4,46,18,D,1988
25741,26,29,Moe Mantha,2,73,28,D,1989
25742,15,30,Moe Mantha,9,57,24,D,1990
25743,4,31,Moe Mantha,0,17,4,D,1991
25744,0,22,Moe Robinson,0,1,0,D,1979
25745,6,32,Moose Vasko,1,70,7,D,1967
25746,7,33,Moose Vasko,1,72,8,D,1968
25747,0,34,Moose Vasko,0,3,0,D,1969
25748,0,23,Morgan Ellis,0,3,0,D,2015
25749,0,22,Morgan Klimchuk,0,1,0,LW,2017
25750,25,19,Morgan Rielly,2,73,27,D,2013
25751,21,20,Morgan Rielly,8,81,29,D,2014
25752,27,21,Morgan Rielly,9,82,36,D,2015
25753,21,22,Morgan Rielly,6,76,27,D,2016
25754,46,23,Morgan Rielly,6,76,52,D,2017
25755,18,20,Morris Lukowich,27,68,45,LW,1976
25756,18,20,Morris Lukowich,27,68,45,LW,1976
25757,35,21,Morris Lukowich,40,80,75,LW,1977
25758,35,21,Morris Lukowich,40,80,75,LW,1977
25759,34,22,Morris Lukowich,65,80,99,LW,1978
25760,34,22,Morris Lukowich,65,80,99,LW,1978
25761,39,23,Morris Lukowich,35,78,74,LW,1979
25762,34,24,Morris Lukowich,33,80,67,LW,1980
25763,49,25,Morris Lukowich,43,77,92,LW,1981
25764,21,26,Morris Lukowich,22,69,43,LW,1982
25765,25,27,Morris Lukowich,30,80,55,LW,1983
25766,17,28,Morris Lukowich,10,69,27,LW,1984
25767,13,29,Morris Lukowich,12,69,25,LW,1985
25768,21,30,Morris Lukowich,14,60,35,LW,1986
25769,7,26,Morris Mott,6,70,13,RW,1972
25770,17,27,Morris Mott,9,77,26,RW,1973
25771,8,28,Morris Mott,3,52,11,RW,1974
25772,1,30,Morris Mott,0,2,1,RW,1976
25773,1,30,Morris Mott,0,2,1,RW,1976
25774,1,25,Morris Stefaniw,1,13,2,C,1972
25775,0,22,Morris Titanic,0,17,0,LW,1974
25776,0,23,Morris Titanic,0,2,0,LW,1975
25777,1,25,Murray Anderson,0,40,1,D,1974
25778,2,22,Murray Baron,2,16,4,D,1989
25779,8,23,Murray Baron,8,67,16,D,1990
25780,8,24,Murray Baron,3,67,11,D,1991
25781,2,25,Murray Baron,2,53,4,D,1992
25782,9,26,Murray Baron,5,77,14,D,1993
25783,5,27,Murray Baron,0,39,5,D,1994
25784,9,28,Murray Baron,2,82,11,D,1995
25785,7,29,Murray Baron,1,79,8,D,1996
25786,5,30,Murray Baron,1,45,6,D,1997
25787,6,31,Murray Baron,2,81,8,D,1998
25788,10,32,Murray Baron,2,81,12,D,1999
25789,8,33,Murray Baron,3,82,11,D,2000
25790,6,34,Murray Baron,1,61,7,D,2001
25791,4,35,Murray Baron,2,78,6,D,2002
25792,5,36,Murray Baron,1,80,6,D,2003
25793,0,20,Murray Brumwell,0,1,0,D,1980
25794,3,21,Murray Brumwell,0,21,3,D,1981
25795,14,22,Murray Brumwell,5,59,19,D,1982
25796,13,23,Murray Brumwell,7,42,20,D,1983
25797,0,25,Murray Brumwell,0,1,0,D,1985
25798,0,26,Murray Brumwell,0,1,0,D,1986
25799,1,27,Murray Brumwell,0,3,1,D,1987
25800,7,18,Murray Craven,4,31,11,LW,1982
25801,4,19,Murray Craven,0,15,4,LW,1983
25802,35,20,Murray Craven,26,80,61,LW,1984
25803,33,21,Murray Craven,21,78,54,LW,1985
25804,30,22,Murray Craven,19,77,49,LW,1986
25805,46,23,Murray Craven,30,72,76,LW,1987
25806,28,24,Murray Craven,9,51,37,LW,1988
25807,50,25,Murray Craven,25,76,75,LW,1989
25808,47,26,Murray Craven,19,77,66,LW,1990
25809,33,27,Murray Craven,27,73,60,C,1991
25810,52,28,Murray Craven,25,77,77,C,1992
25811,40,29,Murray Craven,15,78,55,C,1993
25812,3,30,Murray Craven,4,16,7,LW,1994
25813,29,31,Murray Craven,18,66,47,LW,1995
25814,27,32,Murray Craven,8,75,35,C,1996
25815,17,33,Murray Craven,12,67,29,LW,1997
25816,10,34,Murray Craven,4,43,14,LW,1998
25817,2,35,Murray Craven,0,19,2,C,1999
25818,2,20,Murray Eaves,1,12,3,C,1980
25819,0,21,Murray Eaves,0,2,0,C,1981
25820,7,22,Murray Eaves,2,26,9,C,1982
25821,0,23,Murray Eaves,0,2,0,C,1983
25822,3,24,Murray Eaves,0,3,3,C,1984
25823,0,25,Murray Eaves,1,4,1,C,1985
25824,1,27,Murray Eaves,0,7,1,C,1987
25825,0,29,Murray Eaves,0,1,0,C,1989
25826,1,27,Murray Hall,2,17,3,C,1967
25827,38,30,Murray Hall,21,77,59,RW,1970
25828,6,31,Murray Hall,6,32,12,C,1971
25829,42,32,Murray Hall,28,76,70,RW,1972
25830,42,32,Murray Hall,28,76,70,RW,1972
25831,28,33,Murray Hall,30,78,58,C,1973
25832,28,33,Murray Hall,30,78,58,C,1973
25833,29,34,Murray Hall,18,78,47,RW,1974
25834,29,34,Murray Hall,18,78,47,RW,1974
25835,26,35,Murray Hall,20,80,46,RW,1975
25836,26,35,Murray Hall,20,80,46,RW,1975
25837,32,25,Murray Heatley,26,71,58,LW,1973
25838,32,25,Murray Heatley,26,71,58,LW,1973
25839,17,26,Murray Heatley,20,51,37,LW,1974
25840,8,26,Murray Heatley,15,29,23,LW,1974
25841,9,26,Murray Heatley,5,22,14,LW,1974
25842,17,26,Murray Heatley,20,51,37,LW,1974
25843,8,26,Murray Heatley,15,29,23,LW,1974
25844,9,26,Murray Heatley,5,22,14,LW,1974
25845,5,27,Murray Heatley,2,34,7,RW,1975
25846,5,27,Murray Heatley,2,34,7,RW,1975
25847,17,22,Murray Kennett,5,78,22,D,1974
25848,14,22,Murray Kennett,4,50,18,D,1974
25849,3,22,Murray Kennett,1,28,4,D,1974
25850,17,22,Murray Kennett,5,78,22,D,1974
25851,14,22,Murray Kennett,4,50,18,D,1974
25852,4,23,Murray Kennett,3,28,7,D,1975
25853,4,23,Murray Kennett,3,28,7,D,1975
25854,29,25,Murray Keogan,35,78,64,C,1974
25855,29,25,Murray Keogan,35,78,64,C,1974
25856,13,26,Murray Keogan,7,46,20,C,1975
25857,2,29,Murray Kuntz,1,7,3,LW,1974
25858,0,20,Murray Myers,0,7,0,RW,1972
25859,20,21,Murray Myers,22,61,42,RW,1973
25860,1,22,Murray Myers,1,24,2,RW,1974
25861,1,22,Murray Myers,1,24,2,RW,1974
25862,15,23,Murray Myers,14,56,29,RW,1975
25863,15,23,Murray Myers,14,56,29,RW,1975
25864,21,30,Murray Oliver,16,74,37,C,1967
25865,36,31,Murray Oliver,14,76,50,C,1968
25866,33,32,Murray Oliver,14,76,47,C,1969
25867,23,33,Murray Oliver,9,61,32,C,1970
25868,29,34,Murray Oliver,27,77,56,C,1971
25869,31,35,Murray Oliver,11,75,42,C,1972
25870,20,36,Murray Oliver,17,78,37,C,1973
25871,15,37,Murray Oliver,19,80,34,C,1974
25872,9,21,Murray Wilson,18,52,27,LW,1972
25873,14,22,Murray Wilson,17,72,31,LW,1973
25874,18,23,Murray Wilson,24,73,42,LW,1974
25875,24,24,Murray Wilson,11,59,35,LW,1975
25876,14,25,Murray Wilson,13,60,27,LW,1976
25877,1,26,Murray Wilson,0,12,1,C,1977
25878,15,27,Murray Wilson,11,58,26,C,1978
25879,1,23,Murray Wing,0,1,1,D,1973
25880,1,23,Myles O'Connor,3,22,4,D,1990
25881,2,24,Myles O'Connor,0,9,2,D,1991
25882,0,25,Myles O'Connor,0,7,0,D,1992
25883,1,26,Myles O'Connor,0,5,1,D,1993
25884,7,33,Myron Stankiewicz,0,35,7,LW,1968
25885,14,19,Nail Yakupov,17,48,31,RW,2012
25886,13,20,Nail Yakupov,11,63,24,RW,2013
25887,19,21,Nail Yakupov,14,81,33,RW,2014
25888,15,22,Nail Yakupov,8,60,23,RW,2015
25889,6,23,Nail Yakupov,3,40,9,RW,2016
25890,7,24,Nail Yakupov,9,58,16,RW,2017
25891,2,24,Nate Guenin,0,9,2,D,2006
25892,0,25,Nate Guenin,0,2,0,D,2007
25893,0,26,Nate Guenin,0,1,0,D,2008
25894,0,27,Nate Guenin,0,2,0,D,2009
25895,0,28,Nate Guenin,0,3,0,D,2010
25896,0,29,Nate Guenin,2,15,2,D,2011
25897,8,31,Nate Guenin,1,68,9,D,2013
25898,13,32,Nate Guenin,2,76,15,D,2014
25899,0,33,Nate Guenin,0,29,0,D,2015
25900,1,23,Nate Prosser,0,3,1,D,2009
25901,0,24,Nate Prosser,0,2,0,D,2010
25902,11,25,Nate Prosser,1,51,12,D,2011
25903,0,26,Nate Prosser,0,17,0,D,2012
25904,6,27,Nate Prosser,2,53,8,D,2013
25905,5,28,Nate Prosser,2,63,7,D,2014
25906,3,29,Nate Prosser,0,54,3,D,2015
25907,5,30,Nate Prosser,2,39,7,D,2016
25908,0,31,Nate Prosser,0,1,0,D,2017
25909,0,24,Nate Raduns,0,1,0,C,2008
25910,4,22,Nate Schmidt,2,29,6,D,2013
25911,3,23,Nate Schmidt,1,39,4,D,2014
25912,14,24,Nate Schmidt,2,72,16,D,2015
25913,14,25,Nate Schmidt,3,60,17,D,2016
25914,31,26,Nate Schmidt,5,76,36,D,2017
25915,0,22,Nate Thompson,0,4,0,C,2006
25916,2,24,Nate Thompson,2,43,4,C,2008
25917,8,25,Nate Thompson,2,71,10,C,2009
25918,15,26,Nate Thompson,10,79,25,C,2010
25919,6,27,Nate Thompson,9,68,15,C,2011
25920,8,28,Nate Thompson,7,45,15,C,2012
25921,7,29,Nate Thompson,9,81,16,C,2013
25922,13,30,Nate Thompson,5,80,18,C,2014
25923,3,31,Nate Thompson,3,49,6,C,2015
25924,1,32,Nate Thompson,1,30,2,C,2016
25925,5,33,Nate Thompson,1,26,6,C,2017
25926,2,20,Nathan Beaulieu,0,6,2,D,2012
25927,2,21,Nathan Beaulieu,0,17,2,D,2013
25928,8,22,Nathan Beaulieu,1,64,9,D,2014
25929,17,23,Nathan Beaulieu,2,64,19,D,2015
25930,24,24,Nathan Beaulieu,4,74,28,D,2016
25931,8,25,Nathan Beaulieu,1,59,9,D,2017
25932,1,22,Nathan Dempsey,1,14,2,LW,1996
25933,2,25,Nathan Dempsey,0,6,2,LW,1999
25934,9,26,Nathan Dempsey,1,25,10,D,2000
25935,0,27,Nathan Dempsey,0,3,0,D,2001
25936,23,28,Nathan Dempsey,5,67,28,D,2002
25937,20,29,Nathan Dempsey,12,75,32,D,2003
25938,11,31,Nathan Dempsey,2,53,13,D,2005
25939,1,32,Nathan Dempsey,0,17,1,D,2006
25940,1,21,Nathan Gerbe,0,10,1,C,2008
25941,3,22,Nathan Gerbe,2,10,5,C,2009
25942,15,23,Nathan Gerbe,16,64,31,C,2010
25943,19,24,Nathan Gerbe,6,62,25,C,2011
25944,5,25,Nathan Gerbe,5,42,10,C,2012
25945,15,26,Nathan Gerbe,16,81,31,C,2013
25946,18,27,Nathan Gerbe,10,78,28,LW,2014
25947,4,28,Nathan Gerbe,3,47,7,LW,2015
25948,0,30,Nathan Gerbe,0,2,0,LW,2017
25949,8,18,Nathan Horton,14,55,22,RW,2003
25950,19,20,Nathan Horton,28,71,47,C,2005
25951,31,21,Nathan Horton,31,82,62,C,2006
25952,35,22,Nathan Horton,27,82,62,RW,2007
25953,23,23,Nathan Horton,22,67,45,C,2008
25954,37,24,Nathan Horton,20,65,57,C,2009
25955,27,25,Nathan Horton,26,80,53,C,2010
25956,15,26,Nathan Horton,17,46,32,C,2011
25957,9,27,Nathan Horton,13,43,22,C,2012
25958,14,28,Nathan Horton,4,35,18,RW,2013
25959,4,20,Nathan LaFayette,3,49,7,C,1993
25960,4,21,Nathan LaFayette,4,39,8,C,1994
25961,4,22,Nathan LaFayette,2,17,6,C,1995
25962,3,23,Nathan LaFayette,1,15,4,C,1996
25963,3,24,Nathan LaFayette,5,34,8,C,1997
25964,2,25,Nathan LaFayette,2,33,4,RW,1998
25965,39,18,Nathan MacKinnon,24,82,63,C,2013
25966,24,19,Nathan MacKinnon,14,64,38,C,2014
25967,31,20,Nathan MacKinnon,21,72,52,C,2015
25968,37,21,Nathan MacKinnon,16,82,53,C,2016
25969,58,22,Nathan MacKinnon,39,74,97,C,2017
25970,0,22,Nathan McIver,0,1,0,D,2006
25971,0,23,Nathan McIver,0,17,0,D,2007
25972,1,24,Nathan McIver,0,18,1,D,2008
25973,8,26,Nathan Oystrick,4,53,12,D,2008
25974,0,27,Nathan Oystrick,0,3,0,D,2009
25975,2,28,Nathan Oystrick,1,9,3,D,2010
25976,1,22,Nathan Paetsch,0,1,1,D,2005
25977,22,23,Nathan Paetsch,2,63,24,D,2006
25978,7,24,Nathan Paetsch,2,59,9,D,2007
25979,4,25,Nathan Paetsch,2,23,6,D,2008
25980,1,26,Nathan Paetsch,1,21,2,D,2009
25981,2,25,Nathan Perrott,1,22,3,RW,2001
25982,0,26,Nathan Perrott,0,1,0,RW,2002
25983,2,27,Nathan Perrott,1,40,3,RW,2003
25984,1,29,Nathan Perrott,2,26,3,RW,2005
25985,0,22,Nathan Robinson,0,5,0,C,2003
25986,0,24,Nathan Robinson,0,2,0,C,2005
25987,0,21,Nathan Smith,0,2,0,C,2003
25988,0,23,Nathan Smith,0,1,0,C,2005
25989,0,24,Nathan Smith,0,1,0,C,2006
25990,0,25,Nathan Smith,0,13,0,C,2007
25991,0,27,Nathan Smith,0,9,0,C,2009
25992,0,23,Nathan Walker,0,2,0,LW,2017
25993,0,19,Nazem Kadri,0,1,0,C,2009
25994,9,20,Nazem Kadri,3,29,12,C,2010
25995,2,21,Nazem Kadri,5,21,7,C,2011
25996,26,22,Nazem Kadri,18,48,44,C,2012
25997,30,23,Nazem Kadri,20,78,50,C,2013
25998,21,24,Nazem Kadri,18,73,39,C,2014
25999,28,25,Nazem Kadri,17,76,45,C,2015
26000,29,26,Nazem Kadri,32,82,61,C,2016
26001,23,27,Nazem Kadri,32,80,55,C,2017
26002,0,21,Neal Broten,2,3,2,C,1980
26003,60,22,Neal Broten,38,73,98,C,1981
26004,45,23,Neal Broten,32,79,77,C,1982
26005,61,24,Neal Broten,28,76,89,C,1983
26006,37,25,Neal Broten,19,80,56,C,1984
26007,76,26,Neal Broten,29,80,105,C,1985
26008,35,27,Neal Broten,18,46,53,C,1986
26009,30,28,Neal Broten,9,54,39,C,1987
26010,38,29,Neal Broten,18,68,56,C,1988
26011,62,30,Neal Broten,23,80,85,C,1989
26012,56,31,Neal Broten,13,79,69,C,1990
26013,26,32,Neal Broten,8,76,34,C,1991
26014,21,33,Neal Broten,12,82,33,C,1992
26015,35,34,Neal Broten,17,79,52,C,1993
26016,24,35,Neal Broten,8,47,32,C,1994
26017,16,36,Neal Broten,7,55,23,C,1995
26018,12,37,Neal Broten,8,42,20,C,1996
26019,4,23,Neal Coulter,3,16,7,RW,1985
26020,1,24,Neal Coulter,2,9,3,RW,1986
26021,0,25,Neal Coulter,0,1,0,RW,1987
26022,13,22,Neal Pionk,1,28,14,D,2017
26023,6,20,Neil Belland,3,28,9,D,1981
26024,4,21,Neil Belland,2,14,6,D,1982
26025,13,22,Neil Belland,7,44,20,D,1983
26026,6,23,Neil Belland,0,13,6,D,1984
26027,2,24,Neil Belland,1,7,3,D,1985
26028,1,25,Neil Belland,0,3,1,D,1986
26029,4,21,Neil Brady,1,19,5,C,1989
26030,0,22,Neil Brady,0,3,0,C,1990
26031,0,23,Neil Brady,1,7,1,C,1991
26032,17,24,Neil Brady,7,55,24,C,1992
26033,1,25,Neil Brady,0,5,1,C,1993
26034,3,26,Neil Eisenhut,1,13,4,C,1993
26035,0,27,Neil Eisenhut,0,3,0,C,1994
26036,0,26,Neil Hawryliw,0,1,0,RW,1981
26037,8,21,Neil Komadoski,1,62,9,D,1972
26038,4,22,Neil Komadoski,2,68,6,D,1973
26039,12,23,Neil Komadoski,4,75,16,D,1974
26040,15,24,Neil Komadoski,3,80,18,D,1975
26041,9,25,Neil Komadoski,3,68,12,D,1976
26042,14,26,Neil Komadoski,2,58,16,D,1977
26043,2,27,Neil Komadoski,1,42,3,D,1978
26044,12,28,Neil Komadoski,0,49,12,D,1979
26045,2,21,Neil Labatte,0,22,2,D,1978
26046,0,24,Neil Labatte,0,4,0,D,1981
26047,1,23,Neil Nicholson,3,30,4,D,1972
26048,0,24,Neil Nicholson,0,8,0,D,1973
26049,0,28,Neil Nicholson,0,1,0,D,1977
26050,0,23,Neil Sheehy,1,1,1,D,1983
26051,4,24,Neil Sheehy,3,31,7,D,1984
26052,16,25,Neil Sheehy,2,65,18,D,1985
26053,6,26,Neil Sheehy,4,54,10,D,1986
26054,10,27,Neil Sheehy,3,62,13,D,1987
26055,4,28,Neil Sheehy,3,72,7,D,1988
26056,5,29,Neil Sheehy,1,59,6,D,1989
26057,2,31,Neil Sheehy,1,35,3,D,1991
26058,5,22,Neil Wilkinson,0,36,5,D,1989
26059,9,23,Neil Wilkinson,2,50,11,D,1990
26060,15,24,Neil Wilkinson,4,60,19,D,1991
26061,7,25,Neil Wilkinson,1,59,8,D,1992
26062,9,26,Neil Wilkinson,3,72,12,D,1993
26063,4,27,Neil Wilkinson,1,40,5,D,1994
26064,14,28,Neil Wilkinson,3,62,17,D,1995
26065,0,29,Neil Wilkinson,0,23,0,D,1996
26066,4,30,Neil Wilkinson,2,34,6,D,1997
26067,0,31,Neil Wilkinson,0,24,0,D,1998
26068,0,20,Nelson Burton,1,5,1,LW,1977
26069,0,21,Nelson Burton,0,3,0,LW,1978
26070,1,26,Nelson Debenedet,4,15,5,LW,1973
26071,3,27,Nelson Debenedet,6,31,9,LW,1974
26072,3,23,Nelson Emerson,0,4,3,C,1990
26073,36,24,Nelson Emerson,23,79,59,C,1991
26074,51,25,Nelson Emerson,22,82,73,RW,1992
26075,41,26,Nelson Emerson,33,83,74,RW,1993
26076,23,27,Nelson Emerson,14,48,37,C,1994
26077,29,28,Nelson Emerson,29,81,58,RW,1995
26078,29,29,Nelson Emerson,9,66,38,RW,1996
26079,24,30,Nelson Emerson,21,81,45,RW,1997
26080,24,31,Nelson Emerson,13,65,37,RW,1998
26081,20,32,Nelson Emerson,15,63,35,RW,1999
26082,11,33,Nelson Emerson,11,78,22,RW,2000
26083,2,34,Nelson Emerson,5,41,7,RW,2001
26084,0,20,Nelson Nogier,0,10,0,D,2016
26085,0,20,Nelson Pyatt,0,5,0,C,1973
26086,4,21,Nelson Pyatt,6,25,10,C,1974
26087,23,22,Nelson Pyatt,26,77,49,C,1975
26088,22,23,Nelson Pyatt,23,77,45,C,1976
26089,12,24,Nelson Pyatt,9,71,21,C,1977
26090,2,25,Nelson Pyatt,2,28,4,C,1978
26091,0,26,Nelson Pyatt,5,13,5,C,1979
26092,16,19,Nevin Markwart,14,70,30,LW,1983
26093,4,20,Nevin Markwart,0,26,4,LW,1984
26094,15,21,Nevin Markwart,7,65,22,LW,1985
26095,9,22,Nevin Markwart,10,64,19,LW,1986
26096,12,23,Nevin Markwart,1,25,13,LW,1987
26097,2,25,Nevin Markwart,1,8,3,LW,1989
26098,3,26,Nevin Markwart,3,23,6,LW,1990
26099,7,27,Nevin Markwart,5,28,12,LW,1991
26100,0,25,Nic Dowd,0,5,0,C,2015
26101,16,26,Nic Dowd,6,70,22,C,2016
26102,1,27,Nic Dowd,0,16,1,C,2017
26103,4,20,Nic Petan,2,26,6,LW,2015
26104,12,21,Nic Petan,1,54,13,LW,2016
26105,0,22,Nic Petan,2,15,2,LW,2017
26106,1,21,Nicholas Baptiste,3,14,4,RW,2016
26107,2,22,Nicholas Baptiste,4,33,6,RW,2017
26108,0,20,Nicholas Merkley,0,1,0,RW,2017
26109,0,23,Nicholas Petrecki,0,1,0,D,2012
26110,0,22,Nick Beverley,0,2,0,D,1969
26111,0,24,Nick Beverley,0,1,0,D,1971
26112,10,25,Nick Beverley,1,76,11,D,1972
26113,14,26,Nick Beverley,2,68,16,D,1973
26114,15,27,Nick Beverley,3,67,18,D,1974
26115,8,28,Nick Beverley,1,63,9,D,1975
26116,17,29,Nick Beverley,2,61,19,D,1976
26117,14,30,Nick Beverley,7,57,21,D,1977
26118,7,31,Nick Beverley,2,59,9,D,1978
26119,9,32,Nick Beverley,0,46,9,D,1979
26120,0,20,Nick Bjugstad,1,11,1,C,2012
26121,22,21,Nick Bjugstad,16,76,38,C,2013
26122,19,22,Nick Bjugstad,24,72,43,C,2014
26123,19,23,Nick Bjugstad,15,67,34,C,2015
26124,7,24,Nick Bjugstad,7,54,14,C,2016
26125,30,25,Nick Bjugstad,19,82,49,C,2017
26126,1,21,Nick Bonino,1,9,2,C,2009
26127,0,22,Nick Bonino,0,26,0,C,2010
26128,13,23,Nick Bonino,5,50,18,C,2011
26129,8,24,Nick Bonino,5,27,13,C,2012
26130,27,25,Nick Bonino,22,77,49,C,2013
26131,24,26,Nick Bonino,15,75,39,C,2014
26132,20,27,Nick Bonino,9,63,29,C,2015
26133,19,28,Nick Bonino,18,80,37,C,2016
26134,13,29,Nick Bonino,12,71,25,C,2017
26135,0,21,Nick Boynton,0,5,0,D,1999
26136,0,22,Nick Boynton,0,1,0,D,2000
26137,14,23,Nick Boynton,4,80,18,D,2001
26138,17,24,Nick Boynton,7,78,24,D,2002
26139,24,25,Nick Boynton,6,81,30,D,2003
26140,7,27,Nick Boynton,5,54,12,D,2005
26141,9,28,Nick Boynton,2,59,11,D,2006
26142,9,29,Nick Boynton,3,79,12,D,2007
26143,16,30,Nick Boynton,5,68,21,D,2008
26144,7,31,Nick Boynton,1,49,8,D,2009
26145,7,32,Nick Boynton,1,51,8,D,2010
26146,0,21,Nick Cousins,0,11,0,C,2014
26147,5,22,Nick Cousins,6,36,11,C,2015
26148,10,23,Nick Cousins,6,60,16,C,2016
26149,7,24,Nick Cousins,12,71,19,C,2017
26150,0,24,Nick Drazenovic,0,3,0,C,2010
26151,0,26,Nick Drazenovic,0,8,0,C,2012
26152,0,27,Nick Drazenovic,0,1,0,C,2013
26153,3,20,Nick Foligno,6,45,9,LW,2007
26154,15,21,Nick Foligno,17,81,32,LW,2008
26155,17,22,Nick Foligno,9,61,26,LW,2009
26156,20,23,Nick Foligno,14,82,34,LW,2010
26157,32,24,Nick Foligno,15,82,47,LW,2011
26158,13,25,Nick Foligno,6,45,19,LW,2012
26159,21,26,Nick Foligno,18,70,39,LW,2013
26160,42,27,Nick Foligno,31,79,73,LW,2014
26161,25,28,Nick Foligno,12,72,37,LW,2015
26162,25,29,Nick Foligno,26,79,51,LW,2016
26163,18,30,Nick Foligno,15,72,33,LW,2017
26164,2,22,Nick Fotiu,2,61,4,LW,1974
26165,2,22,Nick Fotiu,2,61,4,LW,1974
26166,2,23,Nick Fotiu,3,49,5,LW,1975
26167,2,23,Nick Fotiu,3,49,5,LW,1975
26168,8,24,Nick Fotiu,4,70,12,LW,1976
26169,7,25,Nick Fotiu,2,59,9,LW,1977
26170,5,26,Nick Fotiu,3,71,8,LW,1978
26171,8,27,Nick Fotiu,10,74,18,LW,1979
26172,9,28,Nick Fotiu,9,69,18,LW,1980
26173,10,29,Nick Fotiu,8,70,18,LW,1981
26174,13,30,Nick Fotiu,8,72,21,LW,1982
26175,6,31,Nick Fotiu,7,40,13,LW,1983
26176,7,32,Nick Fotiu,4,46,11,LW,1984
26177,1,33,Nick Fotiu,0,9,1,LW,1985
26178,3,34,Nick Fotiu,5,42,8,LW,1986
26179,0,35,Nick Fotiu,0,23,0,LW,1987
26180,0,36,Nick Fotiu,0,1,0,LW,1988
26181,17,26,Nick Harbaruk,5,74,22,RW,1969
26182,12,27,Nick Harbaruk,13,78,25,RW,1970
26183,17,28,Nick Harbaruk,12,78,29,RW,1971
26184,15,29,Nick Harbaruk,10,78,25,RW,1972
26185,14,30,Nick Harbaruk,5,56,19,RW,1973
26186,23,31,Nick Harbaruk,20,78,43,RW,1974
26187,19,32,Nick Harbaruk,23,76,42,RW,1975
26188,19,32,Nick Harbaruk,23,76,42,RW,1975
26189,2,33,Nick Harbaruk,2,27,4,RW,1976
26190,2,33,Nick Harbaruk,2,27,4,RW,1976
26191,0,23,Nick Holden,0,5,0,D,2010
26192,0,25,Nick Holden,0,2,0,D,2012
26193,15,26,Nick Holden,10,54,25,D,2013
26194,9,27,Nick Holden,5,78,14,D,2014
26195,16,28,Nick Holden,6,82,22,D,2015
26196,23,29,Nick Holden,11,80,34,D,2016
26197,4,30,Nick Holden,1,18,5,D,2017
26198,9,26,Nick Jensen,4,49,13,D,2016
26199,15,27,Nick Jensen,0,81,15,D,2017
26200,1,24,Nick Johnson,1,6,2,RW,2009
26201,2,25,Nick Johnson,1,4,3,RW,2010
26202,18,26,Nick Johnson,8,77,26,RW,2011
26203,2,27,Nick Johnson,4,17,6,RW,2012
26204,0,28,Nick Johnson,0,9,0,RW,2013
26205,4,23,Nick Kypreos,5,31,9,LW,1989
26206,9,24,Nick Kypreos,9,79,18,LW,1990
26207,6,25,Nick Kypreos,4,65,10,RW,1991
26208,10,26,Nick Kypreos,17,75,27,LW,1992
26209,5,27,Nick Kypreos,3,56,8,RW,1993
26210,3,28,Nick Kypreos,1,40,4,LW,1994
26211,5,29,Nick Kypreos,4,61,9,LW,1995
26212,2,30,Nick Kypreos,3,35,5,LW,1996
26213,3,24,Nick Lappin,4,43,7,RW,2016
26214,0,25,Nick Lappin,1,6,1,RW,2017
26215,3,19,Nick Leddy,4,46,7,D,2010
26216,34,20,Nick Leddy,3,82,37,D,2011
26217,12,21,Nick Leddy,6,48,18,D,2012
26218,24,22,Nick Leddy,7,82,31,D,2013
26219,27,23,Nick Leddy,10,78,37,D,2014
26220,35,24,Nick Leddy,5,81,40,D,2015
26221,35,25,Nick Leddy,11,81,46,D,2016
26222,32,26,Nick Leddy,10,80,42,D,2017
26223,1,22,Nick Libett,2,22,3,LW,1967
26224,14,23,Nick Libett,10,75,24,LW,1968
26225,20,24,Nick Libett,20,76,40,LW,1969
26226,13,25,Nick Libett,16,78,29,LW,1970
26227,22,26,Nick Libett,31,77,53,LW,1971
26228,34,27,Nick Libett,19,78,53,LW,1972
26229,24,28,Nick Libett,24,67,48,LW,1973
26230,28,29,Nick Libett,23,80,51,LW,1974
26231,26,30,Nick Libett,20,80,46,LW,1975
26232,27,31,Nick Libett,14,80,41,LW,1976
26233,22,32,Nick Libett,23,80,45,LW,1977
26234,19,33,Nick Libett,15,68,34,LW,1978
26235,12,34,Nick Libett,14,78,26,LW,1979
26236,6,35,Nick Libett,6,43,12,LW,1980
26237,1,20,Nick Palmieri,0,6,1,RW,2009
26238,8,21,Nick Palmieri,9,43,17,RW,2010
26239,3,22,Nick Palmieri,4,38,7,RW,2011
26240,3,20,Nick Paul,2,24,5,LW,2015
26241,0,21,Nick Paul,0,1,0,LW,2016
26242,0,22,Nick Paul,1,11,1,LW,2017
26243,3,31,Nick Polano,0,17,3,D,1972
26244,2,20,Nick Ritchie,2,33,4,LW,2015
26245,14,21,Nick Ritchie,14,77,28,LW,2016
26246,17,22,Nick Ritchie,10,76,27,LW,2017
26247,22,20,Nick Schmaltz,6,61,28,LW,2016
26248,31,21,Nick Schmaltz,21,78,52,LW,2017
26249,6,19,Nick Schultz,4,52,10,D,2001
26250,7,20,Nick Schultz,3,75,10,D,2002
26251,10,21,Nick Schultz,6,79,16,D,2003
26252,12,23,Nick Schultz,2,79,14,D,2005
26253,10,24,Nick Schultz,2,82,12,D,2006
26254,13,25,Nick Schultz,2,81,15,D,2007
26255,9,26,Nick Schultz,2,79,11,D,2008
26256,19,27,Nick Schultz,1,80,20,D,2009
26257,14,28,Nick Schultz,3,74,17,D,2010
26258,6,29,Nick Schultz,1,82,7,D,2011
26259,8,30,Nick Schultz,1,48,9,D,2012
26260,5,31,Nick Schultz,0,69,5,D,2013
26261,13,32,Nick Schultz,2,80,15,D,2014
26262,9,33,Nick Schultz,1,81,10,D,2015
26263,4,34,Nick Schultz,0,28,4,D,2016
26264,4,24,Nick Seeler,0,22,4,D,2017
26265,6,22,Nick Shore,1,34,7,C,2014
26266,7,23,Nick Shore,3,68,10,C,2015
26267,11,24,Nick Shore,6,70,17,C,2016
26268,1,25,Nick Shore,0,6,1,C,2017
26269,0,22,Nick Smith,0,15,0,C,2001
26270,1,22,Nick Sorensen,0,5,1,RW,2016
26271,3,21,Nick Spaling,0,28,3,C,2009
26272,6,22,Nick Spaling,8,74,14,C,2010
26273,12,23,Nick Spaling,10,77,22,C,2011
26274,4,24,Nick Spaling,9,47,13,C,2012
26275,18,25,Nick Spaling,13,71,31,LW,2013
26276,18,26,Nick Spaling,9,82,27,C,2014
26277,10,27,Nick Spaling,3,58,13,C,2015
26278,0,21,Nick Stajduhar,0,2,0,D,1995
26279,1,21,Nick Tarnasky,0,12,1,C,2005
26280,4,22,Nick Tarnasky,5,77,9,C,2006
26281,4,23,Nick Tarnasky,6,80,10,C,2007
26282,6,24,Nick Tarnasky,1,45,7,LW,2008
26283,2,25,Nick Tarnasky,1,31,3,C,2009
26284,0,24,Nick Vachon,0,1,0,C,1996
26285,55,20,Nicklas Backstrom,14,82,69,C,2007
26286,66,21,Nicklas Backstrom,22,82,88,C,2008
26287,68,22,Nicklas Backstrom,33,82,101,C,2009
26288,47,23,Nicklas Backstrom,18,77,65,C,2010
26289,30,24,Nicklas Backstrom,14,42,44,C,2011
26290,40,25,Nicklas Backstrom,8,48,48,C,2012
26291,61,26,Nicklas Backstrom,18,82,79,C,2013
26292,60,27,Nicklas Backstrom,18,82,78,C,2014
26293,50,28,Nicklas Backstrom,20,75,70,C,2015
26294,63,29,Nicklas Backstrom,23,82,86,C,2016
26295,50,30,Nicklas Backstrom,21,81,71,C,2017
26296,0,22,Nicklas Grossmann,0,8,0,D,2006
26297,7,23,Nicklas Grossmann,0,62,7,D,2007
26298,10,24,Nicklas Grossmann,2,81,12,D,2008
26299,7,25,Nicklas Grossmann,0,71,7,D,2009
26300,9,26,Nicklas Grossmann,1,59,10,D,2010
26301,11,27,Nicklas Grossmann,0,74,11,D,2011
26302,3,28,Nicklas Grossmann,1,30,4,D,2012
26303,13,29,Nicklas Grossmann,1,78,14,D,2013
26304,9,30,Nicklas Grossmann,5,68,14,D,2014
26305,4,31,Nicklas Grossmann,3,58,7,D,2015
26306,0,32,Nicklas Grossmann,0,3,0,D,2016
26307,0,19,Nicklas Jensen,0,2,0,LW,2012
26308,3,20,Nicklas Jensen,3,17,6,LW,2013
26309,0,21,Nicklas Jensen,0,5,0,LW,2014
26310,0,23,Nicklas Jensen,0,7,0,RW,2016
26311,49,21,Nicklas Lidstrom,11,80,60,D,1991
26312,34,22,Nicklas Lidstrom,7,84,41,D,1992
26313,46,23,Nicklas Lidstrom,10,84,56,D,1993
26314,16,24,Nicklas Lidstrom,10,43,26,D,1994
26315,50,25,Nicklas Lidstrom,17,81,67,D,1995
26316,42,26,Nicklas Lidstrom,15,79,57,D,1996
26317,42,27,Nicklas Lidstrom,17,80,59,D,1997
26318,43,28,Nicklas Lidstrom,14,81,57,D,1998
26319,53,29,Nicklas Lidstrom,20,81,73,D,1999
26320,56,30,Nicklas Lidstrom,15,82,71,D,2000
26321,50,31,Nicklas Lidstrom,9,78,59,D,2001
26322,44,32,Nicklas Lidstrom,18,82,62,D,2002
26323,28,33,Nicklas Lidstrom,10,81,38,D,2003
26324,64,35,Nicklas Lidstrom,16,80,80,D,2005
26325,49,36,Nicklas Lidstrom,13,80,62,D,2006
26326,60,37,Nicklas Lidstrom,10,76,70,D,2007
26327,43,38,Nicklas Lidstrom,16,78,59,D,2008
26328,40,39,Nicklas Lidstrom,9,82,49,D,2009
26329,46,40,Nicklas Lidstrom,16,82,62,D,2010
26330,23,41,Nicklas Lidstrom,11,70,34,D,2011
26331,0,20,Niclas Bergfors,0,1,0,RW,2007
26332,0,21,Niclas Bergfors,1,8,1,RW,2008
26333,23,22,Niclas Bergfors,21,81,44,RW,2009
26334,24,23,Niclas Bergfors,12,72,36,RW,2010
26335,1,24,Niclas Bergfors,1,11,2,RW,2011
26336,7,26,Niclas Havelid,2,50,9,D,1999
26337,10,27,Niclas Havelid,4,47,14,D,2000
26338,2,28,Niclas Havelid,1,52,3,D,2001
26339,22,29,Niclas Havelid,11,82,33,D,2002
26340,20,30,Niclas Havelid,6,79,26,D,2003
26341,28,32,Niclas Havelid,4,82,32,D,2005
26342,18,33,Niclas Havelid,3,77,21,D,2006
26343,13,34,Niclas Havelid,1,81,14,D,2007
26344,17,35,Niclas Havelid,2,78,19,D,2008
26345,3,25,Niclas Wallin,2,37,5,D,2000
26346,2,26,Niclas Wallin,1,52,3,D,2001
26347,8,27,Niclas Wallin,2,77,10,D,2002
26348,7,28,Niclas Wallin,3,57,10,D,2003
26349,4,30,Niclas Wallin,4,50,8,D,2005
26350,8,31,Niclas Wallin,2,67,10,D,2006
26351,6,32,Niclas Wallin,2,66,8,D,2007
26352,8,33,Niclas Wallin,2,64,10,D,2008
26353,7,34,Niclas Wallin,0,70,7,D,2009
26354,5,35,Niclas Wallin,3,74,8,D,2010
26355,32,19,Nico Hischier,20,82,52,C,2017
26356,3,,Nicolai Makarov,1,7,4,D,1977
26357,3,,Nicolai Makarov,1,7,4,D,1977
26358,0,28,Nicolai Makarov,1,4,1,RW,1978
26359,0,28,Nicolai Makarov,1,4,1,RW,1978
26360,0,25,Nicolas Blanchard,0,9,0,C,2012
26361,0,24,Nicolas Deschamps,0,3,0,C,2013
26362,0,22,Nicolas Deslauriers,1,17,1,LW,2013
26363,10,23,Nicolas Deslauriers,5,82,15,LW,2014
26364,6,24,Nicolas Deslauriers,6,70,12,LW,2015
26365,2,25,Nicolas Deslauriers,0,42,2,LW,2016
26366,4,26,Nicolas Deslauriers,10,58,14,LW,2017
26367,0,23,Nicolas Kerdiles,0,1,0,LW,2016
26368,0,24,Nicolas Kerdiles,0,2,0,LW,2017
26369,0,20,Nicolas Roy,0,1,0,C,2017
26370,0,21,Nigel Dawes,1,8,1,LW,2006
26371,15,22,Nigel Dawes,14,61,29,LW,2007
26372,11,23,Nigel Dawes,10,64,21,LW,2008
26373,18,24,Nigel Dawes,14,66,32,LW,2009
26374,1,25,Nigel Dawes,0,13,1,LW,2010
26375,18,19,Nik Antropov,12,66,30,C,1999
26376,11,20,Nik Antropov,6,52,17,C,2000
26377,1,21,Nik Antropov,1,11,2,RW,2001
26378,29,22,Nik Antropov,16,72,45,RW,2002
26379,18,23,Nik Antropov,13,62,31,C,2003
26380,19,25,Nik Antropov,12,57,31,RW,2005
26381,15,26,Nik Antropov,18,54,33,C,2006
26382,30,27,Nik Antropov,26,72,56,C,2007
26383,31,28,Nik Antropov,28,81,59,RW,2008
26384,43,29,Nik Antropov,24,76,67,C,2009
26385,25,30,Nik Antropov,16,76,41,C,2010
26386,20,31,Nik Antropov,15,69,35,C,2011
26387,12,32,Nik Antropov,6,40,18,C,2012
26388,4,20,Nikita Alexeev,4,44,8,LW,2001
26389,2,21,Nikita Alexeev,4,37,6,RW,2002
26390,11,25,Nikita Alexeev,12,78,23,RW,2006
26391,0,18,Nikita Filatov,4,8,4,LW,2008
26392,0,19,Nikita Filatov,2,13,2,LW,2009
26393,7,20,Nikita Filatov,0,23,7,LW,2010
26394,1,21,Nikita Filatov,0,9,1,LW,2011
26395,9,20,Nikita Kucherov,9,52,18,RW,2013
26396,36,21,Nikita Kucherov,29,82,65,RW,2014
26397,36,22,Nikita Kucherov,30,77,66,RW,2015
26398,45,23,Nikita Kucherov,40,74,85,RW,2016
26399,61,24,Nikita Kucherov,39,80,100,RW,2017
26400,5,21,Nikita Nesterov,2,27,7,D,2014
26401,6,22,Nikita Nesterov,3,57,9,D,2015
26402,4,23,Nikita Nesterov,1,13,5,D,2016
26403,8,24,Nikita Nikitin,1,41,9,D,2010
26404,25,25,Nikita Nikitin,7,61,32,D,2011
26405,6,26,Nikita Nikitin,3,38,9,D,2012
26406,13,27,Nikita Nikitin,2,66,15,D,2013
26407,6,28,Nikita Nikitin,4,42,10,D,2014
26408,1,29,Nikita Nikitin,0,11,1,D,2015
26409,0,21,Nikita Scherbak,1,3,1,RW,2016
26410,2,22,Nikita Scherbak,4,26,6,RW,2017
26411,3,22,Nikita Soshnikov,2,11,5,RW,2015
26412,4,23,Nikita Soshnikov,5,56,9,RW,2016
26413,0,24,Nikita Soshnikov,0,3,0,RW,2017
26414,1,21,Nikita Tryamkin,1,13,2,D,2015
26415,7,22,Nikita Tryamkin,2,66,9,D,2016
26416,0,18,Nikita Zadorov,1,7,1,D,2013
26417,12,19,Nikita Zadorov,3,60,15,D,2014
26418,2,20,Nikita Zadorov,0,22,2,D,2015
26419,10,21,Nikita Zadorov,0,56,10,D,2016
26420,13,22,Nikita Zadorov,7,77,20,D,2017
26421,32,25,Nikita Zaitsev,4,82,36,D,2016
26422,8,26,Nikita Zaitsev,5,60,13,D,2017
26423,1,21,Niklas Andersson,0,3,1,LW,1992
26424,12,24,Niklas Andersson,14,47,26,LW,1995
26425,31,25,Niklas Andersson,12,74,43,LW,1996
26426,0,26,Niklas Andersson,0,5,0,LW,1997
26427,8,28,Niklas Andersson,3,24,11,LW,1999
26428,1,29,Niklas Andersson,0,11,1,LW,2000
26429,18,22,Niklas Hagman,10,78,28,RW,2001
26430,15,23,Niklas Hagman,8,80,23,RW,2002
26431,13,24,Niklas Hagman,10,75,23,LW,2003
26432,13,26,Niklas Hagman,8,84,21,RW,2005
26433,12,27,Niklas Hagman,17,82,29,LW,2006
26434,14,28,Niklas Hagman,27,82,41,LW,2007
26435,20,29,Niklas Hagman,22,65,42,LW,2008
26436,19,30,Niklas Hagman,25,82,44,LW,2009
26437,16,31,Niklas Hagman,11,71,27,LW,2010
26438,14,32,Niklas Hagman,9,71,23,LW,2011
26439,1,20,Niklas Hjalmarsson,0,13,1,D,2007
26440,2,21,Niklas Hjalmarsson,1,21,3,D,2008
26441,15,22,Niklas Hjalmarsson,2,77,17,D,2009
26442,7,23,Niklas Hjalmarsson,3,80,10,D,2010
26443,14,24,Niklas Hjalmarsson,1,69,15,D,2011
26444,8,25,Niklas Hjalmarsson,2,46,10,D,2012
26445,22,26,Niklas Hjalmarsson,4,81,26,D,2013
26446,16,27,Niklas Hjalmarsson,3,82,19,D,2014
26447,22,28,Niklas Hjalmarsson,2,81,24,D,2015
26448,13,29,Niklas Hjalmarsson,5,73,18,D,2016
26449,8,30,Niklas Hjalmarsson,1,48,9,D,2017
26450,4,23,Niklas Kronwall,1,20,5,D,2003
26451,8,25,Niklas Kronwall,1,27,9,D,2005
26452,21,26,Niklas Kronwall,1,68,22,D,2006
26453,28,27,Niklas Kronwall,7,65,35,D,2007
26454,45,28,Niklas Kronwall,6,80,51,D,2008
26455,15,29,Niklas Kronwall,7,48,22,D,2009
26456,26,30,Niklas Kronwall,11,77,37,D,2010
26457,21,31,Niklas Kronwall,15,82,36,D,2011
26458,24,32,Niklas Kronwall,5,48,29,D,2012
26459,41,33,Niklas Kronwall,8,79,49,D,2013
26460,35,34,Niklas Kronwall,9,80,44,D,2014
26461,23,35,Niklas Kronwall,3,64,26,D,2015
26462,11,36,Niklas Kronwall,2,57,13,D,2016
26463,23,37,Niklas Kronwall,4,79,27,D,2017
26464,2,26,Niklas Nordgren,4,58,6,LW,2005
26465,0,23,Niklas Sundblad,0,2,0,RW,1995
26466,12,20,Niklas Sundstrom,9,82,21,C,1995
26467,28,21,Niklas Sundstrom,24,82,52,RW,1996
26468,28,22,Niklas Sundstrom,19,70,47,RW,1997
26469,30,23,Niklas Sundstrom,13,81,43,LW,1998
26470,25,24,Niklas Sundstrom,12,79,37,LW,1999
26471,39,25,Niklas Sundstrom,10,82,49,RW,2000
26472,30,26,Niklas Sundstrom,9,73,39,RW,2001
26473,19,27,Niklas Sundstrom,7,80,26,LW,2002
26474,12,28,Niklas Sundstrom,8,66,20,RW,2003
26475,9,30,Niklas Sundstrom,6,55,15,RW,2005
26476,7,23,Niko Dimitrakos,6,21,13,RW,2002
26477,15,24,Niko Dimitrakos,9,68,24,RW,2003
26478,16,26,Niko Dimitrakos,9,64,25,RW,2005
26479,0,27,Niko Dimitrakos,0,5,0,RW,2006
26480,1,23,Niko Kapanen,0,9,1,C,2001
26481,29,24,Niko Kapanen,5,82,34,C,2002
26482,5,25,Niko Kapanen,1,67,6,C,2003
26483,21,27,Niko Kapanen,14,81,35,C,2005
26484,16,28,Niko Kapanen,6,79,22,C,2006
26485,18,29,Niko Kapanen,10,79,28,C,2007
26486,40,28,Nikolai Borschevsky,34,78,74,RW,1992
26487,20,29,Nikolai Borschevsky,14,45,34,RW,1993
26488,10,30,Nikolai Borschevsky,0,27,10,RW,1994
26489,3,31,Nikolai Borschevsky,1,12,4,RW,1995
26490,16,22,Nikolai Kulemin,15,73,31,LW,2008
26491,20,23,Nikolai Kulemin,16,78,36,LW,2009
26492,27,24,Nikolai Kulemin,30,82,57,LW,2010
26493,21,25,Nikolai Kulemin,7,70,28,LW,2011
26494,16,26,Nikolai Kulemin,7,48,23,LW,2012
26495,11,27,Nikolai Kulemin,9,70,20,LW,2013
26496,13,29,Nikolai Kulemin,9,81,22,LW,2015
26497,11,30,Nikolai Kulemin,12,72,23,LW,2016
26498,2,31,Nikolai Kulemin,1,13,3,LW,2017
26499,1,21,Nikolai Tsulygin,0,22,1,D,1996
26500,21,19,Nikolai Zherdev,13,57,34,RW,2003
26501,27,21,Nikolai Zherdev,27,73,54,RW,2005
26502,22,22,Nikolai Zherdev,10,71,32,RW,2006
26503,35,23,Nikolai Zherdev,26,82,61,RW,2007
26504,35,24,Nikolai Zherdev,23,82,58,RW,2008
26505,6,26,Nikolai Zherdev,16,56,22,RW,2010
26506,23,19,Nikolaj Ehlers,15,72,38,RW,2015
26507,39,20,Nikolaj Ehlers,25,82,64,LW,2016
26508,31,21,Nikolaj Ehlers,29,82,60,LW,2017
26509,1,20,Nikolay Goldobin,1,9,2,LW,2015
26510,0,21,Nikolay Goldobin,0,2,0,LW,2016
26511,6,22,Nikolay Goldobin,8,38,14,RW,2017
26512,16,28,Nikolay Kulemin,15,82,31,LW,2014
26513,0,23,Nikos Tselios,0,2,0,D,2001
26514,2,23,Nils Ekman,2,28,4,RW,1999
26515,11,24,Nils Ekman,9,43,20,LW,2000
26516,33,27,Nils Ekman,22,82,55,RW,2003
26517,36,29,Nils Ekman,21,77,57,RW,2005
26518,9,30,Nils Ekman,6,34,15,RW,2006
26519,1,18,Nino Niederreiter,1,9,2,RW,2010
26520,0,19,Nino Niederreiter,1,55,1,RW,2011
26521,22,21,Nino Niederreiter,14,81,36,RW,2013
26522,13,22,Nino Niederreiter,24,80,37,RW,2014
26523,23,23,Nino Niederreiter,20,82,43,RW,2015
26524,32,24,Nino Niederreiter,25,82,57,RW,2016
26525,14,25,Nino Niederreiter,18,63,32,RW,2017
26526,1,24,Noah Clarke,0,2,1,LW,2003
26527,0,26,Noah Clarke,0,5,0,LW,2005
26528,0,27,Noah Clarke,2,13,2,LW,2006
26529,0,28,Noah Clarke,1,1,1,LW,2007
26530,18,19,Noah Hanifin,4,79,22,D,2015
26531,25,20,Noah Hanifin,4,81,29,D,2016
26532,22,21,Noah Hanifin,10,79,32,D,2017
26533,2,20,Noah Juulsen,1,23,3,D,2017
26534,3,23,Noah Welch,1,5,4,D,2005
26535,1,24,Noah Welch,2,24,3,D,2006
26536,0,25,Noah Welch,0,4,0,D,2007
26537,1,26,Noah Welch,1,40,2,D,2008
26538,0,28,Noah Welch,0,2,0,D,2010
26539,1,24,Noel Acciari,0,19,1,C,2015
26540,3,25,Noel Acciari,2,29,5,C,2016
26541,1,26,Noel Acciari,10,60,11,C,2017
26542,10,29,Noel Picard,1,66,11,D,1967
26543,19,30,Noel Picard,5,67,24,D,1968
26544,4,31,Noel Picard,1,39,5,D,1969
26545,8,32,Noel Picard,3,75,11,D,1970
26546,5,33,Noel Picard,1,15,6,D,1971
26547,10,34,Noel Picard,1,57,11,D,1972
26548,27,32,Noel Price,6,70,33,D,1967
26549,18,33,Noel Price,2,73,20,D,1968
26550,19,35,Noel Price,1,62,20,D,1970
26551,13,37,Noel Price,1,54,14,D,1972
26552,13,38,Noel Price,0,62,13,D,1973
26553,14,39,Noel Price,4,80,18,D,1974
26554,0,40,Noel Price,0,3,0,D,1975
26555,0,19,Nolan Baumgartner,0,1,0,D,1995
26556,1,21,Nolan Baumgartner,0,4,1,D,1997
26557,0,22,Nolan Baumgartner,0,5,0,D,1998
26558,1,23,Nolan Baumgartner,0,8,1,D,1999
26559,0,24,Nolan Baumgartner,0,8,0,D,2000
26560,2,26,Nolan Baumgartner,1,8,3,D,2002
26561,3,27,Nolan Baumgartner,0,14,3,D,2003
26562,29,29,Nolan Baumgartner,5,70,34,D,2005
26563,3,30,Nolan Baumgartner,0,13,3,D,2006
26564,1,33,Nolan Baumgartner,1,12,2,D,2009
26565,17,19,Nolan Patrick,13,73,30,C,2017
26566,2,21,Nolan Pratt,0,9,2,D,1996
26567,2,22,Nolan Pratt,0,23,2,D,1997
26568,14,23,Nolan Pratt,1,61,15,D,1998
26569,1,24,Nolan Pratt,3,64,4,D,1999
26570,2,25,Nolan Pratt,1,46,3,D,2000
26571,3,26,Nolan Pratt,0,46,3,D,2001
26572,7,27,Nolan Pratt,1,67,8,D,2002
26573,3,28,Nolan Pratt,1,58,4,D,2003
26574,9,30,Nolan Pratt,0,82,9,D,2005
26575,7,31,Nolan Pratt,1,81,8,D,2006
26576,6,32,Nolan Pratt,1,55,7,D,2007
26577,0,20,Nolan Yonkman,1,11,1,D,2001
26578,0,22,Nolan Yonkman,0,1,0,D,2003
26579,7,24,Nolan Yonkman,0,38,7,D,2005
26580,1,29,Nolan Yonkman,0,16,1,D,2010
26581,0,30,Nolan Yonkman,0,1,0,D,2011
26582,0,31,Nolan Yonkman,0,7,0,D,2012
26583,1,32,Nolan Yonkman,0,2,1,D,2013
26584,12,21,Norm Aubin,14,43,26,C,1981
26585,1,22,Norm Aubin,4,26,5,C,1982
26586,0,23,Norm Barnes,0,1,0,D,1976
26587,21,26,Norm Barnes,4,59,25,D,1979
26588,13,27,Norm Barnes,1,76,14,D,1980
26589,4,28,Norm Barnes,1,20,5,D,1981
26590,1,26,Norm Beaudin,1,13,2,RW,1967
26591,1,29,Norm Beaudin,0,12,1,RW,1970
26592,65,31,Norm Beaudin,38,78,103,RW,1972
26593,28,32,Norm Beaudin,27,74,55,RW,1973
26594,31,33,Norm Beaudin,16,77,47,RW,1974
26595,31,33,Norm Beaudin,16,77,47,RW,1974
26596,31,34,Norm Beaudin,16,80,47,RW,1975
26597,31,34,Norm Beaudin,16,80,47,RW,1975
26598,5,22,Norm Cournoyer,3,13,8,C,1973
26599,5,22,Norm Cournoyer,3,13,8,C,1973
26600,2,25,Norm Cournoyer,1,19,3,C,1976
26601,2,25,Norm Cournoyer,1,19,3,C,1976
26602,0,26,Norm Dennis,0,2,0,C,1968
26603,0,27,Norm Dennis,3,5,3,C,1969
26604,0,28,Norm Dennis,0,4,0,C,1970
26605,0,29,Norm Dennis,0,1,0,C,1971
26606,1,25,Norm Descoteaux,0,2,1,D,1972
26607,1,25,Norm Descoteaux,0,2,1,D,1972
26608,6,26,Norm Descoteaux,1,35,7,D,1973
26609,6,26,Norm Descoteaux,1,35,7,D,1973
26610,10,23,Norm Dube,8,56,18,LW,1974
26611,0,24,Norm Dube,0,1,0,LW,1975
26612,18,25,Norm Dube,15,39,33,LW,1976
26613,18,25,Norm Dube,15,39,33,LW,1976
26614,31,26,Norm Dube,16,73,47,LW,1977
26615,31,26,Norm Dube,16,73,47,LW,1977
26616,13,27,Norm Dube,2,36,15,LW,1978
26617,13,27,Norm Dube,2,36,15,LW,1978
26618,3,22,Norm Dupont,1,35,4,LW,1979
26619,26,23,Norm Dupont,27,80,53,LW,1980
26620,25,24,Norm Dupont,13,62,38,LW,1981
26621,16,25,Norm Dupont,7,39,23,LW,1982
26622,15,26,Norm Dupont,7,40,22,LW,1983
26623,20,23,Norm Ferguson,34,76,54,RW,1968
26624,9,24,Norm Ferguson,11,72,20,RW,1969
26625,17,25,Norm Ferguson,14,54,31,C,1970
26626,20,26,Norm Ferguson,14,77,34,RW,1971
26627,40,27,Norm Ferguson,28,56,68,RW,1972
26628,40,27,Norm Ferguson,28,56,68,RW,1972
26629,21,28,Norm Ferguson,15,75,36,RW,1973
26630,21,28,Norm Ferguson,15,75,36,RW,1973
26631,33,29,Norm Ferguson,36,78,69,LW,1974
26632,33,29,Norm Ferguson,36,78,69,LW,1974
26633,37,30,Norm Ferguson,37,79,74,RW,1975
26634,37,30,Norm Ferguson,37,79,74,RW,1975
26635,32,31,Norm Ferguson,39,77,71,RW,1976
26636,32,31,Norm Ferguson,39,77,71,RW,1976
26637,21,32,Norm Ferguson,26,71,47,RW,1977
26638,21,32,Norm Ferguson,26,71,47,RW,1977
26639,1,21,Norm Gratton,0,3,1,LW,1971
26640,11,22,Norm Gratton,9,50,20,LW,1972
26641,11,23,Norm Gratton,6,57,17,LW,1973
26642,18,24,Norm Gratton,17,59,35,LW,1974
26643,3,25,Norm Gratton,7,32,10,LW,1975
26644,1,22,Norm Maciver,0,3,1,D,1986
26645,15,23,Norm Maciver,9,37,24,D,1987
26646,32,24,Norm Maciver,1,63,33,D,1988
26647,0,25,Norm Maciver,0,1,0,D,1989
26648,5,26,Norm Maciver,2,21,7,D,1990
26649,34,27,Norm Maciver,6,57,40,D,1991
26650,46,28,Norm Maciver,17,80,63,D,1992
26651,20,29,Norm Maciver,3,53,23,D,1993
26652,16,30,Norm Maciver,4,41,20,D,1994
26653,46,31,Norm Maciver,7,71,53,D,1995
26654,9,32,Norm Maciver,4,32,13,D,1996
26655,6,33,Norm Maciver,2,41,8,D,1997
26656,1,21,Norm Milley,0,5,1,RW,2001
26657,2,22,Norm Milley,0,8,2,RW,2002
26658,0,23,Norm Milley,0,2,0,RW,2003
26659,1,25,Norm Milley,2,14,3,RW,2005
26660,12,21,Norm Schmidt,6,34,18,D,1983
26661,14,23,Norm Schmidt,15,66,29,D,1985
26662,5,24,Norm Schmidt,1,20,6,D,1986
26663,2,25,Norm Schmidt,1,5,3,D,1987
26664,37,32,Norm Ullman,35,71,72,C,1967
26665,42,33,Norm Ullman,35,75,77,C,1968
26666,42,34,Norm Ullman,18,74,60,C,1969
26667,51,35,Norm Ullman,34,73,85,C,1970
26668,50,36,Norm Ullman,23,77,73,C,1971
26669,35,37,Norm Ullman,20,65,55,C,1972
26670,47,38,Norm Ullman,22,78,69,C,1973
26671,26,39,Norm Ullman,9,80,35,C,1974
26672,56,40,Norm Ullman*,31,77,87,LW,1975
26673,56,40,Norm Ullman*,31,77,87,LW,1975
26674,27,41,Norm Ullman*,16,67,43,C,1976
26675,27,41,Norm Ullman*,16,67,43,C,1976
26676,1,25,Norman James Johnson,2,13,3,C,1967
26677,27,26,Norman James Johnson,17,69,44,C,1968
26678,30,27,Norman James Johnson,18,72,48,C,1969
26679,29,28,Norman James Johnson,16,66,45,C,1970
26680,24,29,Norman James Johnson,21,74,45,C,1971
26681,14,30,Norman James Johnson,9,33,23,LW,1972
26682,14,30,Norman James Johnson,9,33,23,LW,1972
26683,39,31,Norman James Johnson,15,71,54,LW,1973
26684,39,31,Norman James Johnson,15,71,54,LW,1973
26685,18,32,Norman James Johnson,8,53,26,C,1974
26686,15,32,Norman James Johnson,7,42,22,C,1974
26687,3,32,Norman James Johnson,1,11,4,C,1974
26688,18,32,Norman James Johnson,8,53,26,C,1974
26689,15,32,Norman James Johnson,7,42,22,C,1974
26690,3,32,Norman James Johnson,1,11,4,C,1974
26691,0,26,Normand Baron,0,4,0,LW,1983
26692,0,28,Normand Baron,2,23,2,LW,1985
26693,4,20,Normand Lacombe,2,30,6,RW,1984
26694,7,21,Normand Lacombe,6,25,13,RW,1985
26695,7,22,Normand Lacombe,4,40,11,RW,1986
26696,9,23,Normand Lacombe,8,53,17,RW,1987
26697,11,24,Normand Lacombe,17,64,28,RW,1988
26698,4,25,Normand Lacombe,5,33,9,RW,1989
26699,20,26,Normand Lacombe,11,74,31,RW,1990
26700,19,19,Normand Leveille,14,66,33,LW,1981
26701,6,20,Normand Leveille,3,9,9,LW,1982
26702,7,20,Normand Rochefort,3,56,10,D,1980
26703,14,21,Normand Rochefort,4,72,18,D,1981
26704,17,22,Normand Rochefort,6,62,23,D,1982
26705,22,23,Normand Rochefort,2,75,24,D,1983
26706,21,24,Normand Rochefort,3,73,24,D,1984
26707,4,25,Normand Rochefort,5,26,9,D,1985
26708,9,26,Normand Rochefort,6,70,15,D,1986
26709,10,27,Normand Rochefort,3,46,13,D,1987
26710,5,28,Normand Rochefort,1,11,6,D,1988
26711,1,29,Normand Rochefort,3,31,4,D,1989
26712,7,30,Normand Rochefort,3,44,10,D,1990
26713,2,31,Normand Rochefort,0,26,2,D,1991
26714,0,33,Normand Rochefort,0,6,0,D,1993
26715,0,21,Ole-Kristian Tollefsen,0,5,0,D,2005
26716,3,22,Ole-Kristian Tollefsen,2,70,5,D,2006
26717,2,23,Ole-Kristian Tollefsen,2,51,4,D,2007
26718,1,24,Ole-Kristian Tollefsen,0,19,1,D,2008
26719,2,25,Ole-Kristian Tollefsen,0,18,2,D,2009
26720,13,20,Oleg Kvasha,12,68,25,LW,1998
26721,20,21,Oleg Kvasha,5,78,25,RW,1999
26722,9,22,Oleg Kvasha,11,62,20,C,2000
26723,25,23,Oleg Kvasha,13,71,38,LW,2001
26724,14,24,Oleg Kvasha,12,69,26,LW,2002
26725,36,25,Oleg Kvasha,15,81,51,LW,2003
26726,19,27,Oleg Kvasha,13,64,32,LW,2005
26727,1,29,Oleg Mikulchik,0,4,1,D,1993
26728,2,30,Oleg Mikulchik,0,25,2,D,1994
26729,0,31,Oleg Mikulchik,0,8,0,D,1995
26730,1,21,Oleg Petrov,2,9,3,RW,1992
26731,15,22,Oleg Petrov,12,55,27,RW,1993
26732,3,23,Oleg Petrov,2,12,5,RW,1994
26733,7,24,Oleg Petrov,4,36,11,RW,1995
26734,24,28,Oleg Petrov,2,44,26,RW,1999
26735,30,29,Oleg Petrov,17,81,47,RW,2000
26736,17,30,Oleg Petrov,24,75,41,LW,2001
26737,18,31,Oleg Petrov,9,70,27,LW,2002
26738,1,18,Oleg Saprykin,0,4,1,C,1999
26739,14,19,Oleg Saprykin,9,59,23,RW,2000
26740,0,20,Oleg Saprykin,0,3,0,C,2001
26741,15,21,Oleg Saprykin,8,52,23,LW,2002
26742,17,22,Oleg Saprykin,12,69,29,LW,2003
26743,14,24,Oleg Saprykin,11,67,25,LW,2005
26744,21,25,Oleg Saprykin,15,71,36,LW,2006
26745,9,18,Oleg Tverdovsky,3,36,12,D,1994
26746,23,19,Oleg Tverdovsky,7,82,30,D,1995
26747,45,20,Oleg Tverdovsky,10,82,55,D,1996
26748,12,21,Oleg Tverdovsky,7,46,19,D,1997
26749,18,22,Oleg Tverdovsky,7,82,25,D,1998
26750,36,23,Oleg Tverdovsky,15,82,51,D,1999
26751,39,24,Oleg Tverdovsky,14,82,53,D,2000
26752,26,25,Oleg Tverdovsky,6,73,32,D,2001
26753,8,26,Oleg Tverdovsky,5,50,13,D,2002
26754,20,29,Oleg Tverdovsky,3,72,23,D,2005
26755,4,30,Oleg Tverdovsky,0,26,4,D,2006
26756,4,20,Oliver Bjorkstrand,4,12,8,RW,2015
26757,7,21,Oliver Bjorkstrand,6,26,13,RW,2016
26758,29,22,Oliver Bjorkstrand,11,82,40,RW,2017
26759,10,19,Oliver Ekman-Larsson,1,48,11,D,2010
26760,19,20,Oliver Ekman-Larsson,13,82,32,D,2011
26761,21,21,Oliver Ekman-Larsson,3,48,24,D,2012
26762,29,22,Oliver Ekman-Larsson,15,80,44,D,2013
26763,20,23,Oliver Ekman-Larsson,23,82,43,D,2014
26764,34,24,Oliver Ekman-Larsson,21,75,55,D,2015
26765,27,25,Oliver Ekman-Larsson,12,79,39,D,2016
26766,28,26,Oliver Ekman-Larsson,14,82,42,D,2017
26767,0,18,Oliver Kylington,0,1,0,D,2015
26768,1,23,Oliver Lauridsen,2,15,3,D,2012
26769,0,25,Oliver Lauridsen,0,1,0,D,2014
26770,0,24,Olivier Magnan,0,18,0,D,2010
26771,0,19,Olli Jokinen,0,8,0,C,1997
26772,12,20,Olli Jokinen,9,66,21,C,1998
26773,10,21,Olli Jokinen,11,82,21,C,1999
26774,10,22,Olli Jokinen,6,78,16,C,2000
26775,20,23,Olli Jokinen,9,80,29,C,2001
26776,29,24,Olli Jokinen,36,81,65,C,2002
26777,32,25,Olli Jokinen,26,82,58,C,2003
26778,51,27,Olli Jokinen,38,82,89,C,2005
26779,52,28,Olli Jokinen,39,82,91,C,2006
26780,37,29,Olli Jokinen,34,82,71,C,2007
26781,28,30,Olli Jokinen,29,76,57,C,2008
26782,35,31,Olli Jokinen,15,82,50,C,2009
26783,37,32,Olli Jokinen,17,79,54,C,2010
26784,38,33,Olli Jokinen,23,82,61,C,2011
26785,7,34,Olli Jokinen,7,45,14,C,2012
26786,25,35,Olli Jokinen,18,82,43,C,2013
26787,6,36,Olli Jokinen,4,62,10,C,2014
26788,20,19,Olli Maatta,9,78,29,D,2013
26789,8,20,Olli Maatta,1,20,9,D,2014
26790,13,21,Olli Maatta,6,67,19,D,2015
26791,6,22,Olli Maatta,1,55,7,D,2016
26792,22,23,Olli Maatta,7,82,29,D,2017
26793,0,25,Olli Malmivaara,0,2,0,D,2007
26794,0,28,Olli Saarinen,0,1,0,RW,1978
26795,0,28,Olli Saarinen,0,1,0,RW,1978
26796,10,21,Ondrej Kase,5,53,15,RW,2016
26797,18,22,Ondrej Kase,20,66,38,RW,2017
26798,2,21,Ondrej Palat,2,14,4,LW,2012
26799,36,22,Ondrej Palat,23,81,59,LW,2013
26800,47,23,Ondrej Palat,16,75,63,LW,2014
26801,24,24,Ondrej Palat,16,62,40,LW,2015
26802,35,25,Ondrej Palat,17,75,52,LW,2016
26803,24,26,Ondrej Palat,11,56,35,LW,2017
26804,0,22,Orest Kindrachuk,0,2,0,C,1972
26805,30,23,Orest Kindrachuk,11,71,41,C,1973
26806,21,24,Orest Kindrachuk,10,60,31,C,1974
26807,49,25,Orest Kindrachuk,26,76,75,C,1975
26808,36,26,Orest Kindrachuk,15,78,51,C,1976
26809,45,27,Orest Kindrachuk,17,73,62,C,1977
26810,42,28,Orest Kindrachuk,18,79,60,C,1978
26811,29,29,Orest Kindrachuk,17,52,46,C,1979
26812,9,30,Orest Kindrachuk,3,13,12,C,1980
26813,0,31,Orest Kindrachuk,1,4,1,C,1981
26814,20,31,Orland Kurtenbach,15,73,35,C,1967
26815,0,32,Orland Kurtenbach,0,2,0,C,1968
26816,10,33,Orland Kurtenbach,4,53,14,C,1969
26817,32,34,Orland Kurtenbach,21,52,53,C,1970
26818,37,35,Orland Kurtenbach,24,78,61,C,1971
26819,19,36,Orland Kurtenbach,9,47,28,C,1972
26820,13,37,Orland Kurtenbach,8,52,21,C,1973
26821,7,26,Oscar Fantenberg,2,27,9,D,2017
26822,2,20,Oscar Klefbom,1,17,3,D,2013
26823,18,21,Oscar Klefbom,2,60,20,D,2014
26824,8,22,Oscar Klefbom,4,30,12,D,2015
26825,26,23,Oscar Klefbom,12,82,38,D,2016
26826,16,24,Oscar Klefbom,5,66,21,D,2017
26827,0,23,Oscar Lindberg,0,1,0,C,2014
26828,15,24,Oscar Lindberg,13,68,28,C,2015
26829,12,25,Oscar Lindberg,8,65,20,C,2016
26830,2,26,Oscar Lindberg,9,63,11,C,2017
26831,8,20,Oscar Moller,7,40,15,C,2008
26832,3,21,Oscar Moller,4,34,7,C,2009
26833,3,22,Oscar Moller,1,13,4,C,2010
26834,4,21,Oskar Lindblom,2,23,6,LW,2017
26835,0,21,Oskar Osala,0,2,0,LW,2008
26836,0,22,Oskar Osala,0,1,0,LW,2009
26837,3,21,Oskar Sundqvist,1,18,4,C,2015
26838,0,22,Oskar Sundqvist,0,10,0,C,2016
26839,4,23,Oskar Sundqvist,1,42,5,C,2017
26840,8,23,Oskars Bartulis,1,53,9,D,2009
26841,0,24,Oskars Bartulis,0,13,0,D,2010
26842,12,20,Ossi Vaananen,4,81,16,D,2000
26843,12,21,Ossi Vaananen,2,76,14,D,2001
26844,7,22,Ossi Vaananen,2,67,9,D,2002
26845,4,23,Ossi Vaananen,2,79,6,D,2003
26846,4,25,Ossi Vaananen,0,53,4,D,2005
26847,6,26,Ossi Vaananen,2,74,8,D,2006
26848,10,28,Ossi Vaananen,1,49,11,D,2008
26849,1,20,Owen Fussey,0,4,1,RW,2003
26850,1,20,Owen Lloyd,0,3,1,D,1977
26851,1,20,Owen Lloyd,0,3,1,D,1977
26852,10,18,Owen Nolan,3,59,13,RW,1990
26853,31,19,Owen Nolan,42,75,73,RW,1991
26854,41,20,Owen Nolan,36,73,77,RW,1992
26855,2,21,Owen Nolan,2,6,4,RW,1993
26856,19,22,Owen Nolan,30,46,49,RW,1994
26857,36,23,Owen Nolan,33,81,69,RW,1995
26858,32,24,Owen Nolan,31,72,63,RW,1996
26859,27,25,Owen Nolan,14,75,41,RW,1997
26860,26,26,Owen Nolan,19,78,45,RW,1998
26861,40,27,Owen Nolan,44,78,84,RW,1999
26862,25,28,Owen Nolan,24,57,49,RW,2000
26863,43,29,Owen Nolan,23,75,66,C,2001
26864,25,30,Owen Nolan,29,75,54,RW,2002
26865,29,31,Owen Nolan,19,65,48,RW,2003
26866,24,34,Owen Nolan,16,76,40,RW,2006
26867,16,35,Owen Nolan,16,77,32,RW,2007
26868,20,36,Owen Nolan,25,59,45,RW,2008
26869,17,37,Owen Nolan,16,73,33,RW,2009
26870,0,18,Owen Tippett,1,7,1,RW,2017
26871,1,23,P.A. Parenteau,0,5,1,LW,2006
26872,5,26,P.A. Parenteau,3,22,8,LW,2009
26873,33,27,P.A. Parenteau,20,81,53,LW,2010
26874,49,28,P.A. Parenteau,18,80,67,LW,2011
26875,25,29,P.A. Parenteau,18,48,43,LW,2012
26876,19,30,P.A. Parenteau,14,55,33,RW,2013
26877,21,32,P.A. Parenteau,20,77,41,RW,2015
26878,1,33,P.A. Parenteau,0,8,1,RW,2016
26879,0,22,P.C. Drouin,0,3,0,LW,1996
26880,19,22,P.J. Axelsson,8,82,27,LW,1997
26881,10,23,P.J. Axelsson,7,77,17,LW,1998
26882,16,24,P.J. Axelsson,10,81,26,LW,1999
26883,15,25,P.J. Axelsson,8,81,23,LW,2000
26884,17,26,P.J. Axelsson,7,78,24,LW,2001
26885,19,27,P.J. Axelsson,17,66,36,LW,2002
26886,14,28,P.J. Axelsson,6,68,20,LW,2003
26887,18,30,P.J. Axelsson,10,59,28,LW,2005
26888,16,31,P.J. Axelsson,11,55,27,LW,2006
26889,16,32,P.J. Axelsson,13,75,29,LW,2007
26890,24,33,P.J. Axelsson,6,75,30,LW,2008
26891,3,22,P.J. Stock,2,38,5,C,1997
26892,0,23,P.J. Stock,0,5,0,LW,1998
26893,1,24,P.J. Stock,0,11,1,C,1999
26894,5,25,P.J. Stock,2,51,7,C,2000
26895,3,26,P.J. Stock,0,58,3,C,2001
26896,9,27,P.J. Stock,1,71,10,C,2002
26897,0,28,P.J. Stock,0,1,0,C,2003
26898,2,20,P.K. Subban,0,2,2,D,2009
26899,24,21,P.K. Subban,14,77,38,D,2010
26900,29,22,P.K. Subban,7,81,36,D,2011
26901,27,23,P.K. Subban,11,42,38,D,2012
26902,43,24,P.K. Subban,10,82,53,D,2013
26903,45,25,P.K. Subban,15,82,60,D,2014
26904,45,26,P.K. Subban,6,68,51,D,2015
26905,30,27,P.K. Subban,10,66,40,D,2016
26906,43,28,P.K. Subban,16,82,59,D,2017
26907,23,34,Parker MacDonald,19,69,42,LW,1967
26908,9,35,Parker MacDonald,2,35,11,LW,1968
26909,0,21,Pascal Dupuis,1,4,1,LW,2000
26910,12,22,Pascal Dupuis,15,76,27,RW,2001
26911,28,23,Pascal Dupuis,20,80,48,RW,2002
26912,15,24,Pascal Dupuis,11,59,26,LW,2003
26913,16,26,Pascal Dupuis,10,67,26,RW,2005
26914,5,27,Pascal Dupuis,14,71,19,LW,2006
26915,15,28,Pascal Dupuis,12,78,27,LW,2007
26916,16,29,Pascal Dupuis,12,71,28,LW,2008
26917,20,30,Pascal Dupuis,18,81,38,LW,2009
26918,20,31,Pascal Dupuis,17,81,37,LW,2010
26919,34,32,Pascal Dupuis,25,82,59,LW,2011
26920,18,33,Pascal Dupuis,20,48,38,LW,2012
26921,13,34,Pascal Dupuis,7,39,20,LW,2013
26922,5,35,Pascal Dupuis,6,16,11,LW,2014
26923,2,36,Pascal Dupuis,2,18,4,RW,2015
26924,0,24,Pascal Pelletier,0,6,0,LW,2007
26925,0,25,Pascal Pelletier,0,7,0,LW,2008
26926,0,30,Pascal Pelletier,0,3,0,LW,2013
26927,0,23,Pascal Rheaume,1,2,1,C,1996
26928,9,24,Pascal Rheaume,6,48,15,LW,1997
26929,18,25,Pascal Rheaume,9,60,27,C,1998
26930,1,26,Pascal Rheaume,1,7,2,C,1999
26931,0,27,Pascal Rheaume,2,8,2,LW,2000
26932,11,28,Pascal Rheaume,11,61,22,C,2001
26933,10,29,Pascal Rheaume,8,77,18,C,2002
26934,3,30,Pascal Rheaume,1,42,4,C,2003
26935,0,32,Pascal Rheaume,0,13,0,C,2005
26936,1,24,Pascal Trepanier,0,15,1,D,1997
26937,4,25,Pascal Trepanier,2,45,6,D,1998
26938,4,26,Pascal Trepanier,0,37,4,D,1999
26939,4,27,Pascal Trepanier,6,57,10,D,2000
26940,9,28,Pascal Trepanier,4,74,13,D,2001
26941,0,29,Pascal Trepanier,0,1,0,D,2002
26942,22,23,Pat Boutette,10,77,32,RW,1975
26943,18,24,Pat Boutette,18,80,36,RW,1976
26944,19,25,Pat Boutette,17,80,36,LW,1977
26945,19,26,Pat Boutette,14,80,33,LW,1978
26946,35,27,Pat Boutette,13,79,48,LW,1979
26947,52,28,Pat Boutette,28,80,80,LW,1980
26948,51,29,Pat Boutette,23,80,74,LW,1981
26949,29,30,Pat Boutette,27,80,56,RW,1982
26950,26,31,Pat Boutette,14,73,40,RW,1983
26951,11,32,Pat Boutette,7,47,18,LW,1984
26952,5,20,Pat Conacher,0,17,5,C,1979
26953,1,23,Pat Conacher,0,5,1,C,1982
26954,8,24,Pat Conacher,2,45,10,C,1983
26955,2,26,Pat Conacher,0,2,2,C,1985
26956,5,28,Pat Conacher,2,24,7,C,1987
26957,5,29,Pat Conacher,7,55,12,LW,1988
26958,3,30,Pat Conacher,3,19,6,LW,1989
26959,11,31,Pat Conacher,5,49,16,LW,1990
26960,3,32,Pat Conacher,7,44,10,LW,1991
26961,8,33,Pat Conacher,9,81,17,C,1992
26962,13,34,Pat Conacher,15,77,28,C,1993
26963,9,35,Pat Conacher,7,48,16,LW,1994
26964,3,36,Pat Conacher,6,55,9,C,1995
26965,0,20,Pat Daley,1,5,1,LW,1979
26966,0,21,Pat Daley,0,7,0,LW,1980
26967,7,22,Pat Donnelly,5,23,12,C,1975
26968,7,22,Pat Donnelly,5,23,12,C,1975
26969,3,20,Pat Elynuik,1,13,4,RW,1987
26970,25,21,Pat Elynuik,26,56,51,RW,1988
26971,42,22,Pat Elynuik,32,80,74,RW,1989
26972,34,23,Pat Elynuik,31,80,65,RW,1990
26973,25,24,Pat Elynuik,25,60,50,RW,1991
26974,35,25,Pat Elynuik,22,80,57,RW,1992
26975,15,26,Pat Elynuik,13,67,28,RW,1993
26976,7,27,Pat Elynuik,3,41,10,RW,1994
26977,2,28,Pat Elynuik,1,29,3,RW,1995
26978,34,19,Pat Falloon,25,79,59,RW,1991
26979,14,20,Pat Falloon,14,41,28,RW,1992
26980,31,21,Pat Falloon,22,83,53,RW,1993
26981,7,22,Pat Falloon,12,46,19,RW,1994
26982,26,23,Pat Falloon,25,71,51,RW,1995
26983,12,24,Pat Falloon,11,52,23,RW,1996
26984,10,25,Pat Falloon,8,58,18,RW,1997
26985,23,26,Pat Falloon,17,82,40,RW,1998
26986,22,27,Pat Falloon,9,63,31,RW,1999
26987,7,20,Pat Flatley,2,16,9,RW,1983
26988,31,21,Pat Flatley,20,78,51,RW,1984
26989,34,22,Pat Flatley,18,73,52,RW,1985
26990,35,23,Pat Flatley,16,63,51,RW,1986
26991,15,24,Pat Flatley,9,40,24,RW,1987
26992,15,25,Pat Flatley,10,41,25,RW,1988
26993,32,26,Pat Flatley,17,62,49,RW,1989
26994,25,27,Pat Flatley,20,56,45,RW,1990
26995,28,28,Pat Flatley,8,38,36,RW,1991
26996,47,29,Pat Flatley,13,80,60,RW,1992
26997,30,30,Pat Flatley,12,64,42,RW,1993
26998,20,31,Pat Flatley,7,45,27,RW,1994
26999,9,32,Pat Flatley,8,56,17,RW,1995
27000,12,33,Pat Flatley,10,68,22,RW,1996
27001,8,20,Pat Graham,6,42,14,LW,1981
27002,5,21,Pat Graham,1,20,6,LW,1982
27003,4,22,Pat Graham,4,41,8,LW,1983
27004,15,31,Pat Hannigan,11,65,26,RW,1967
27005,1,32,Pat Hannigan,0,7,1,LW,1968
27006,29,20,Pat Hickey,26,78,55,LW,1973
27007,29,20,Pat Hickey,26,78,55,LW,1973
27008,34,21,Pat Hickey,35,74,69,LW,1974
27009,34,21,Pat Hickey,35,74,69,LW,1974
27010,22,22,Pat Hickey,14,70,36,LW,1975
27011,17,23,Pat Hickey,23,80,40,LW,1976
27012,33,24,Pat Hickey,40,80,73,LW,1977
27013,41,25,Pat Hickey,34,80,75,LW,1978
27014,27,26,Pat Hickey,31,76,58,LW,1979
27015,33,27,Pat Hickey,16,72,49,LW,1980
27016,15,28,Pat Hickey,15,61,30,LW,1981
27017,0,29,Pat Hickey,0,1,0,LW,1982
27018,11,30,Pat Hickey,9,69,20,LW,1983
27019,13,31,Pat Hickey,10,57,23,RW,1984
27020,0,22,Pat Hughes,0,3,0,RW,1977
27021,8,23,Pat Hughes,9,41,17,RW,1978
27022,14,24,Pat Hughes,18,76,32,RW,1979
27023,9,25,Pat Hughes,10,60,19,RW,1980
27024,22,26,Pat Hughes,24,68,46,RW,1981
27025,20,27,Pat Hughes,25,80,45,RW,1982
27026,28,28,Pat Hughes,27,77,55,RW,1983
27027,13,29,Pat Hughes,12,73,25,RW,1984
27028,9,30,Pat Hughes,4,50,13,RW,1985
27029,5,31,Pat Hughes,1,45,6,RW,1986
27030,0,23,Pat Kavanagh,1,3,1,RW,2002
27031,0,24,Pat Kavanagh,1,3,1,RW,2003
27032,0,26,Pat Kavanagh,0,8,0,RW,2005
27033,6,18,Pat LaFontaine,13,15,19,C,1983
27034,35,19,Pat LaFontaine,19,67,54,C,1984
27035,23,20,Pat LaFontaine,30,65,53,C,1985
27036,32,21,Pat LaFontaine,38,80,70,C,1986
27037,45,22,Pat LaFontaine,47,75,92,C,1987
27038,43,23,Pat LaFontaine,45,79,88,C,1988
27039,51,24,Pat LaFontaine,54,74,105,C,1989
27040,44,25,Pat LaFontaine,41,75,85,C,1990
27041,47,26,Pat LaFontaine,46,57,93,C,1991
27042,95,27,Pat LaFontaine,53,84,148,C,1992
27043,13,28,Pat LaFontaine,5,16,18,C,1993
27044,15,29,Pat LaFontaine,12,22,27,C,1994
27045,51,30,Pat LaFontaine,40,76,91,C,1995
27046,6,31,Pat LaFontaine,2,13,8,C,1996
27047,39,32,Pat LaFontaine,23,67,62,C,1997
27048,1,21,Pat MacLeod,0,1,1,D,1990
27049,11,22,Pat MacLeod,5,37,16,D,1991
27050,1,23,Pat MacLeod,0,13,1,D,1992
27051,0,26,Pat MacLeod,0,2,0,D,1995
27052,0,26,Pat Mayer,0,1,0,D,1987
27053,0,24,Pat Micheletti,2,12,2,C,1987
27054,1,21,Pat Murray,2,16,3,LW,1990
27055,0,22,Pat Murray,1,9,1,LW,1991
27056,1,22,Pat Neaton,1,9,2,D,1993
27057,18,20,Pat Peake,11,49,29,RW,1993
27058,4,21,Pat Peake,0,18,4,C,1994
27059,19,22,Pat Peake,17,62,36,RW,1995
27060,0,23,Pat Peake,0,4,0,C,1996
27061,0,24,Pat Peake,0,1,0,RW,1997
27062,29,19,Pat Price,5,68,34,D,1974
27063,29,19,Pat Price,5,68,34,D,1974
27064,2,20,Pat Price,0,4,2,D,1975
27065,22,21,Pat Price,3,71,25,D,1976
27066,10,22,Pat Price,2,52,12,D,1977
27067,11,23,Pat Price,3,55,14,D,1978
27068,21,24,Pat Price,11,75,32,D,1979
27069,34,25,Pat Price,8,72,42,D,1980
27070,31,26,Pat Price,7,77,38,D,1981
27071,13,27,Pat Price,2,52,15,D,1982
27072,25,28,Pat Price,3,72,28,D,1983
27073,26,29,Pat Price,1,68,27,D,1984
27074,13,30,Pat Price,3,54,16,D,1985
27075,8,31,Pat Price,0,60,8,D,1986
27076,2,32,Pat Price,0,14,2,D,1987
27077,7,26,Pat Quinn,2,40,9,D,1968
27078,5,27,Pat Quinn,0,59,5,D,1969
27079,11,28,Pat Quinn,2,76,13,D,1970
27080,3,29,Pat Quinn,2,57,5,D,1971
27081,18,30,Pat Quinn,2,78,20,D,1972
27082,27,31,Pat Quinn,5,77,32,D,1973
27083,19,32,Pat Quinn,2,80,21,D,1974
27084,11,33,Pat Quinn,2,80,13,D,1975
27085,12,34,Pat Quinn,1,59,13,D,1976
27086,0,21,Pat Ribble,0,3,0,D,1975
27087,2,22,Pat Ribble,2,23,4,D,1976
27088,12,23,Pat Ribble,5,80,17,D,1977
27089,19,24,Pat Ribble,6,78,25,D,1978
27090,9,25,Pat Ribble,2,55,11,D,1979
27091,15,26,Pat Ribble,3,67,18,D,1980
27092,2,27,Pat Ribble,1,15,3,D,1981
27093,1,28,Pat Ribble,0,28,1,D,1982
27094,34,27,Pat Stapleton,4,67,38,D,1967
27095,50,28,Pat Stapleton,6,75,56,D,1968
27096,38,29,Pat Stapleton,4,49,42,D,1969
27097,44,30,Pat Stapleton,7,76,51,D,1970
27098,38,31,Pat Stapleton,3,78,41,D,1971
27099,21,32,Pat Stapleton,10,75,31,D,1972
27100,52,33,Pat Stapleton,6,78,58,D,1973
27101,52,33,Pat Stapleton,6,78,58,D,1973
27102,30,34,Pat Stapleton,4,68,34,D,1974
27103,40,35,Pat Stapleton,5,80,45,D,1975
27104,45,36,Pat Stapleton,8,81,53,D,1976
27105,45,36,Pat Stapleton,8,81,53,D,1976
27106,45,37,Pat Stapleton,4,65,49,D,1977
27107,45,37,Pat Stapleton,4,65,49,D,1977
27108,2,18,Pat Verbeek,3,6,5,C,1982
27109,27,19,Pat Verbeek,20,79,47,C,1983
27110,18,20,Pat Verbeek,15,78,33,RW,1984
27111,28,21,Pat Verbeek,25,76,53,C,1985
27112,24,22,Pat Verbeek,35,74,59,RW,1986
27113,31,23,Pat Verbeek,46,73,77,RW,1987
27114,21,24,Pat Verbeek,26,77,47,RW,1988
27115,45,25,Pat Verbeek,44,80,89,LW,1989
27116,39,26,Pat Verbeek,43,80,82,LW,1990
27117,35,27,Pat Verbeek,22,76,57,RW,1991
27118,43,28,Pat Verbeek,39,84,82,RW,1992
27119,38,29,Pat Verbeek,37,84,75,RW,1993
27120,16,30,Pat Verbeek,17,48,33,RW,1994
27121,41,31,Pat Verbeek,41,69,82,RW,1995
27122,36,32,Pat Verbeek,17,81,53,RW,1996
27123,26,33,Pat Verbeek,31,82,57,RW,1997
27124,17,34,Pat Verbeek,17,78,34,RW,1998
27125,26,35,Pat Verbeek,22,68,48,RW,1999
27126,15,36,Pat Verbeek,15,67,30,RW,2000
27127,13,37,Pat Verbeek,7,64,20,RW,2001
27128,3,26,Pat Westrum,0,23,3,D,1974
27129,3,26,Pat Westrum,0,23,3,D,1974
27130,12,27,Pat Westrum,3,63,15,D,1975
27131,12,27,Pat Westrum,3,63,15,D,1975
27132,20,28,Pat Westrum,2,74,22,D,1976
27133,9,28,Pat Westrum,1,40,10,D,1976
27134,11,28,Pat Westrum,1,34,12,D,1976
27135,20,28,Pat Westrum,2,74,22,D,1976
27136,9,28,Pat Westrum,1,40,10,D,1976
27137,11,28,Pat Westrum,1,34,12,D,1976
27138,10,29,Pat Westrum,2,77,12,D,1977
27139,10,29,Pat Westrum,2,77,12,D,1977
27140,5,22,Patric Hornqvist,2,28,7,RW,2008
27141,21,23,Patric Hornqvist,30,80,51,RW,2009
27142,27,24,Patric Hornqvist,21,79,48,RW,2010
27143,16,25,Patric Hornqvist,27,76,43,RW,2011
27144,10,26,Patric Hornqvist,4,24,14,RW,2012
27145,31,27,Patric Hornqvist,22,76,53,RW,2013
27146,26,28,Patric Hornqvist,25,64,51,RW,2014
27147,29,29,Patric Hornqvist,22,82,51,RW,2015
27148,23,30,Patric Hornqvist,21,70,44,RW,2016
27149,20,31,Patric Hornqvist,29,70,49,RW,2017
27150,0,23,Patric Kjellberg,0,7,0,LW,1992
27151,20,29,Patric Kjellberg,11,71,31,LW,1998
27152,23,30,Patric Kjellberg,23,82,46,LW,1999
27153,31,31,Patric Kjellberg,14,81,45,LW,2000
27154,11,32,Patric Kjellberg,8,77,19,LW,2001
27155,11,33,Patric Kjellberg,8,76,19,LW,2002
27156,23,18,Patrice Bergeron,16,71,39,C,2003
27157,42,20,Patrice Bergeron,31,81,73,C,2005
27158,48,21,Patrice Bergeron,22,77,70,C,2006
27159,4,22,Patrice Bergeron,3,10,7,C,2007
27160,31,23,Patrice Bergeron,8,64,39,C,2008
27161,33,24,Patrice Bergeron,19,73,52,C,2009
27162,35,25,Patrice Bergeron,22,80,57,C,2010
27163,42,26,Patrice Bergeron,22,81,64,C,2011
27164,22,27,Patrice Bergeron,10,42,32,C,2012
27165,32,28,Patrice Bergeron,30,80,62,C,2013
27166,32,29,Patrice Bergeron,23,81,55,C,2014
27167,36,30,Patrice Bergeron,32,80,68,C,2015
27168,32,31,Patrice Bergeron,21,79,53,C,2016
27169,33,32,Patrice Bergeron,30,64,63,C,2017
27170,2,20,Patrice Brisebois,0,10,2,D,1990
27171,8,21,Patrice Brisebois,2,26,10,D,1991
27172,21,22,Patrice Brisebois,10,70,31,D,1992
27173,21,23,Patrice Brisebois,2,53,23,D,1993
27174,8,24,Patrice Brisebois,4,35,12,D,1994
27175,27,25,Patrice Brisebois,9,69,36,D,1995
27176,13,26,Patrice Brisebois,2,49,15,D,1996
27177,27,27,Patrice Brisebois,10,79,37,D,1997
27178,9,28,Patrice Brisebois,3,54,12,D,1998
27179,25,29,Patrice Brisebois,10,54,35,D,1999
27180,21,30,Patrice Brisebois,15,77,36,D,2000
27181,29,31,Patrice Brisebois,4,71,33,D,2001
27182,25,32,Patrice Brisebois,4,73,29,D,2002
27183,27,33,Patrice Brisebois,4,71,31,D,2003
27184,28,35,Patrice Brisebois,10,80,38,D,2005
27185,10,36,Patrice Brisebois,1,33,11,D,2006
27186,8,37,Patrice Brisebois,3,43,11,D,2007
27187,13,38,Patrice Brisebois,5,62,18,D,2008
27188,1,20,Patrice Cormier,1,21,2,C,2010
27189,0,21,Patrice Cormier,0,9,0,C,2011
27190,0,22,Patrice Cormier,0,10,0,C,2012
27191,3,23,Patrice Cormier,0,9,3,C,2013
27192,0,24,Patrice Cormier,0,1,0,C,2014
27193,0,25,Patrice Cormier,0,2,0,C,2015
27194,0,31,Patrice Lefebvre,0,3,0,RW,1998
27195,10,24,Patrice Tardif,3,27,13,RW,1994
27196,1,25,Patrice Tardif,4,38,5,C,1995
27197,0,21,Patrick Boileau,0,1,0,D,1996
27198,1,23,Patrick Boileau,0,4,1,D,1998
27199,0,26,Patrick Boileau,0,2,0,D,2001
27200,6,27,Patrick Boileau,2,25,8,D,2002
27201,4,28,Patrick Boileau,3,16,7,D,2003
27202,3,26,Patrick Bordeleau,2,46,5,LW,2012
27203,5,27,Patrick Bordeleau,6,82,11,LW,2013
27204,0,28,Patrick Bordeleau,0,1,0,LW,2014
27205,0,22,Patrick Brown,0,7,0,C,2014
27206,1,23,Patrick Brown,1,7,2,C,2015
27207,0,24,Patrick Brown,0,14,0,C,2016
27208,0,30,Patrick Cannone,0,3,0,C,2016
27209,0,21,Patrick Cote,0,2,0,LW,1995
27210,0,22,Patrick Cote,0,3,0,LW,1996
27211,0,23,Patrick Cote,0,3,0,LW,1997
27212,2,24,Patrick Cote,1,70,3,LW,1998
27213,0,25,Patrick Cote,0,21,0,LW,1999
27214,0,26,Patrick Cote,0,6,0,LW,2000
27215,1,21,Patrick Coulombe,0,7,1,D,2006
27216,0,22,Patrick Davis,0,1,0,LW,2008
27217,0,23,Patrick Davis,1,8,1,LW,2009
27218,0,25,Patrick Dwyer,1,13,1,RW,2008
27219,5,26,Patrick Dwyer,7,58,12,RW,2009
27220,10,27,Patrick Dwyer,8,80,18,RW,2010
27221,7,28,Patrick Dwyer,5,73,12,RW,2011
27222,8,29,Patrick Dwyer,8,46,16,RW,2012
27223,14,30,Patrick Dwyer,8,75,22,RW,2013
27224,7,31,Patrick Dwyer,5,71,12,RW,2014
27225,9,21,Patrick Eaves,20,58,29,RW,2005
27226,18,22,Patrick Eaves,14,73,32,RW,2006
27227,10,23,Patrick Eaves,5,37,15,RW,2007
27228,8,24,Patrick Eaves,6,74,14,RW,2008
27229,10,25,Patrick Eaves,12,65,22,RW,2009
27230,7,26,Patrick Eaves,13,63,20,RW,2010
27231,1,27,Patrick Eaves,0,10,1,RW,2011
27232,6,28,Patrick Eaves,2,34,8,RW,2012
27233,3,29,Patrick Eaves,2,30,5,RW,2013
27234,13,30,Patrick Eaves,14,47,27,RW,2014
27235,6,31,Patrick Eaves,11,54,17,RW,2015
27236,3,32,Patrick Eaves,11,20,14,RW,2016
27237,0,33,Patrick Eaves,1,2,1,RW,2017
27238,6,31,Patrick Fischer,4,27,10,C,2006
27239,0,22,Patrick Holland,0,5,0,RW,2013
27240,2,20,Patrick Kaleta,0,7,2,RW,2006
27241,2,21,Patrick Kaleta,3,40,5,RW,2007
27242,5,22,Patrick Kaleta,4,51,9,RW,2008
27243,5,23,Patrick Kaleta,10,55,15,RW,2009
27244,5,24,Patrick Kaleta,4,51,9,RW,2010
27245,5,25,Patrick Kaleta,5,63,10,RW,2011
27246,0,26,Patrick Kaleta,1,34,1,RW,2012
27247,0,27,Patrick Kaleta,0,5,0,RW,2013
27248,3,28,Patrick Kaleta,0,42,3,RW,2014
27249,51,19,Patrick Kane,21,82,72,RW,2007
27250,45,20,Patrick Kane,25,80,70,RW,2008
27251,58,21,Patrick Kane,30,82,88,RW,2009
27252,46,22,Patrick Kane,27,73,73,RW,2010
27253,43,23,Patrick Kane,23,82,66,RW,2011
27254,32,24,Patrick Kane,23,47,55,RW,2012
27255,40,25,Patrick Kane,29,69,69,RW,2013
27256,37,26,Patrick Kane,27,61,64,RW,2014
27257,60,27,Patrick Kane,46,82,106,RW,2015
27258,55,28,Patrick Kane,34,82,89,RW,2016
27259,49,29,Patrick Kane,27,82,76,RW,2017
27260,0,24,Patrick Leahy,0,6,0,LW,2003
27261,4,26,Patrick Leahy,4,43,8,LW,2005
27262,0,27,Patrick Leahy,0,1,0,RW,2006
27263,1,20,Patrick Lebeau,1,2,2,LW,1990
27264,0,22,Patrick Lebeau,0,1,0,LW,1992
27265,1,23,Patrick Lebeau,1,4,2,LW,1993
27266,0,28,Patrick Lebeau,1,8,1,LW,1998
27267,19,18,Patrick Marleau,13,74,32,C,1997
27268,24,19,Patrick Marleau,21,81,45,C,1998
27269,23,20,Patrick Marleau,17,81,40,C,1999
27270,27,21,Patrick Marleau,25,81,52,C,2000
27271,23,22,Patrick Marleau,21,79,44,C,2001
27272,29,23,Patrick Marleau,28,82,57,C,2002
27273,29,24,Patrick Marleau,28,80,57,C,2003
27274,52,26,Patrick Marleau,34,82,86,C,2005
27275,46,27,Patrick Marleau,32,77,78,C,2006
27276,29,28,Patrick Marleau,19,78,48,C,2007
27277,33,29,Patrick Marleau,38,76,71,LW,2008
27278,39,30,Patrick Marleau,44,82,83,C,2009
27279,36,31,Patrick Marleau,37,82,73,C,2010
27280,34,32,Patrick Marleau,30,82,64,C,2011
27281,14,33,Patrick Marleau,17,48,31,C,2012
27282,37,34,Patrick Marleau,33,82,70,LW,2013
27283,38,35,Patrick Marleau,19,82,57,LW,2014
27284,23,36,Patrick Marleau,25,82,48,LW,2015
27285,19,37,Patrick Marleau,27,82,46,LW,2016
27286,20,38,Patrick Marleau,27,82,47,LW,2017
27287,0,23,Patrick Maroon,0,2,0,LW,2011
27288,1,24,Patrick Maroon,2,13,3,LW,2012
27289,18,25,Patrick Maroon,11,62,29,LW,2013
27290,25,26,Patrick Maroon,9,71,34,LW,2014
27291,15,27,Patrick Maroon,12,72,27,LW,2015
27292,15,28,Patrick Maroon,27,81,42,LW,2016
27293,10,29,Patrick Maroon,3,17,13,LW,2017
27294,0,21,Patrick Nemeth,0,8,0,D,2013
27295,14,21,Patrick O'Sullivan,5,44,19,C,2006
27296,31,22,Patrick O'Sullivan,22,82,53,C,2007
27297,27,23,Patrick O'Sullivan,16,81,43,LW,2008
27298,23,24,Patrick O'Sullivan,11,73,34,C,2009
27299,6,25,Patrick O'Sullivan,2,31,8,C,2010
27300,2,26,Patrick O'Sullivan,2,23,4,C,2011
27301,0,18,Patrick Poulin,0,1,0,LW,1991
27302,31,19,Patrick Poulin,20,81,51,LW,1992
27303,14,20,Patrick Poulin,14,67,28,LW,1993
27304,15,21,Patrick Poulin,15,45,30,LW,1994
27305,9,22,Patrick Poulin,7,46,16,LW,1995
27306,14,23,Patrick Poulin,12,73,26,LW,1996
27307,13,24,Patrick Poulin,6,78,19,LW,1997
27308,17,25,Patrick Poulin,8,81,25,LW,1998
27309,5,26,Patrick Poulin,10,82,15,C,1999
27310,11,27,Patrick Poulin,9,52,20,LW,2000
27311,5,28,Patrick Poulin,0,28,5,RW,2001
27312,0,25,Patrick Rissmiller,0,4,0,C,2003
27313,3,27,Patrick Rissmiller,3,18,6,C,2005
27314,15,28,Patrick Rissmiller,7,79,22,C,2006
27315,9,29,Patrick Rissmiller,8,79,17,LW,2007
27316,0,30,Patrick Rissmiller,0,2,0,LW,2008
27317,1,32,Patrick Rissmiller,0,10,1,C,2010
27318,0,21,Patrick Sharp,0,3,0,C,2002
27319,2,22,Patrick Sharp,5,41,7,C,2003
27320,17,24,Patrick Sharp,14,72,31,C,2005
27321,15,25,Patrick Sharp,20,80,35,RW,2006
27322,26,26,Patrick Sharp,36,80,62,LW,2007
27323,18,27,Patrick Sharp,26,61,44,C,2008
27324,41,28,Patrick Sharp,25,82,66,C,2009
27325,37,29,Patrick Sharp,34,74,71,C,2010
27326,36,30,Patrick Sharp,33,74,69,C,2011
27327,14,31,Patrick Sharp,6,28,20,C,2012
27328,44,32,Patrick Sharp,34,82,78,LW,2013
27329,27,33,Patrick Sharp,16,68,43,LW,2014
27330,35,34,Patrick Sharp,20,76,55,LW,2015
27331,10,35,Patrick Sharp,8,48,18,LW,2016
27332,11,36,Patrick Sharp,10,70,21,LW,2017
27333,0,21,Patrick Sieloff,1,1,1,D,2015
27334,0,23,Patrick Sieloff,1,1,1,D,2017
27335,12,23,Patrick Thoresen,4,68,16,LW,2006
27336,6,24,Patrick Thoresen,2,38,8,LW,2007
27337,0,21,Patrick Traverse,0,5,0,D,1995
27338,9,24,Patrick Traverse,1,46,10,D,1998
27339,17,25,Patrick Traverse,6,66,23,D,1999
27340,9,26,Patrick Traverse,5,71,14,D,2000
27341,3,27,Patrick Traverse,2,25,5,D,2001
27342,13,28,Patrick Traverse,0,65,13,D,2002
27343,0,31,Patrick Traverse,0,1,0,D,2005
27344,3,22,Patrick Wey,0,9,3,D,2013
27345,2,20,Patrick Wiercioch,0,8,2,D,2010
27346,14,22,Patrick Wiercioch,5,42,19,D,2012
27347,19,23,Patrick Wiercioch,4,53,23,D,2013
27348,10,24,Patrick Wiercioch,3,56,13,D,2014
27349,5,25,Patrick Wiercioch,0,52,5,D,2015
27350,8,26,Patrick Wiercioch,4,57,12,D,2016
27351,0,24,Patrik Augusta,0,2,0,RW,1993
27352,0,29,Patrik Augusta,0,2,0,RW,1998
27353,26,20,Patrik Berglund,21,76,47,C,2008
27354,13,21,Patrik Berglund,13,71,26,C,2009
27355,30,22,Patrik Berglund,22,81,52,C,2010
27356,19,23,Patrik Berglund,19,82,38,C,2011
27357,8,24,Patrik Berglund,17,48,25,C,2012
27358,18,25,Patrik Berglund,14,78,32,C,2013
27359,15,26,Patrik Berglund,12,77,27,C,2014
27360,5,27,Patrik Berglund,10,42,15,C,2015
27361,11,28,Patrik Berglund,23,82,34,C,2016
27362,9,29,Patrik Berglund,17,57,26,C,2017
27363,0,24,Patrik Carnback,0,6,0,LW,1992
27364,11,25,Patrik Carnback,12,73,23,C,1993
27365,15,26,Patrik Carnback,6,41,21,LW,1994
27366,12,27,Patrik Carnback,6,34,18,RW,1995
27367,0,19,Patrik Elias,0,1,0,RW,1995
27368,3,20,Patrik Elias,2,17,5,RW,1996
27369,19,21,Patrik Elias,18,74,37,LW,1997
27370,33,22,Patrik Elias,17,74,50,LW,1998
27371,37,23,Patrik Elias,35,72,72,LW,1999
27372,56,24,Patrik Elias,40,82,96,LW,2000
27373,32,25,Patrik Elias,29,75,61,LW,2001
27374,29,26,Patrik Elias,28,81,57,LW,2002
27375,43,27,Patrik Elias,38,82,81,LW,2003
27376,29,29,Patrik Elias,16,38,45,LW,2005
27377,48,30,Patrik Elias,21,75,69,C,2006
27378,35,31,Patrik Elias,20,74,55,LW,2007
27379,47,32,Patrik Elias,31,77,78,LW,2008
27380,29,33,Patrik Elias,19,58,48,LW,2009
27381,41,34,Patrik Elias,21,81,62,LW,2010
27382,52,35,Patrik Elias,26,81,78,LW,2011
27383,22,36,Patrik Elias,14,48,36,LW,2012
27384,35,37,Patrik Elias,18,65,53,LW,2013
27385,21,38,Patrik Elias,13,69,34,LW,2014
27386,6,39,Patrik Elias,2,16,8,C,2015
27387,3,24,Patrik Juhlin,4,42,7,RW,1994
27388,3,25,Patrik Juhlin,3,14,6,RW,1995
27389,28,18,Patrik Laine,36,73,64,RW,2016
27390,26,19,Patrik Laine,44,82,70,RW,2017
27391,3,22,Patrik Nemeth,0,22,3,D,2014
27392,8,23,Patrik Nemeth,0,38,8,D,2015
27393,3,24,Patrik Nemeth,0,40,3,D,2016
27394,12,25,Patrik Nemeth,3,68,15,D,2017
27395,20,19,Patrik Stefan,5,72,25,C,1999
27396,21,20,Patrik Stefan,10,66,31,C,2000
27397,16,21,Patrik Stefan,7,59,23,C,2001
27398,21,22,Patrik Stefan,13,71,34,C,2002
27399,26,23,Patrik Stefan,14,82,40,C,2003
27400,14,25,Patrik Stefan,10,64,24,C,2005
27401,6,26,Patrik Stefan,5,41,11,C,2006
27402,23,21,Patrik Sundstrom,23,74,46,RW,1982
27403,53,22,Patrik Sundstrom,38,78,91,C,1983
27404,43,23,Patrik Sundstrom,25,71,68,C,1984
27405,48,24,Patrik Sundstrom,18,79,66,C,1985
27406,42,25,Patrik Sundstrom,29,72,71,C,1986
27407,36,26,Patrik Sundstrom,15,78,51,C,1987
27408,41,27,Patrik Sundstrom,28,65,69,C,1988
27409,49,28,Patrik Sundstrom,27,74,76,C,1989
27410,31,29,Patrik Sundstrom,15,71,46,C,1990
27411,3,30,Patrik Sundstrom,1,17,4,C,1991
27412,21,26,Paul Andrea,11,65,32,RW,1967
27413,6,27,Paul Andrea,7,25,13,RW,1968
27414,21,29,Paul Andrea,12,56,33,RW,1970
27415,30,31,Paul Andrea,21,66,51,RW,1972
27416,30,31,Paul Andrea,21,66,51,RW,1972
27417,18,32,Paul Andrea,15,69,33,LW,1973
27418,18,32,Paul Andrea,15,69,33,LW,1973
27419,0,19,Paul Baxter,0,5,0,D,1974
27420,0,19,Paul Baxter,0,5,0,D,1974
27421,7,20,Paul Baxter,3,67,10,D,1975
27422,7,20,Paul Baxter,3,67,10,D,1975
27423,17,21,Paul Baxter,6,66,23,D,1976
27424,17,21,Paul Baxter,6,66,23,D,1976
27425,29,22,Paul Baxter,6,76,35,D,1977
27426,36,23,Paul Baxter,10,76,46,D,1978
27427,13,24,Paul Baxter,7,61,20,D,1979
27428,14,25,Paul Baxter,5,51,19,D,1980
27429,34,26,Paul Baxter,9,76,43,D,1981
27430,21,27,Paul Baxter,11,75,32,D,1982
27431,20,28,Paul Baxter,7,74,27,D,1983
27432,14,29,Paul Baxter,5,70,19,D,1984
27433,3,30,Paul Baxter,4,47,7,D,1985
27434,2,31,Paul Baxter,0,18,2,D,1986
27435,0,20,Paul Beraldo,0,3,0,RW,1987
27436,0,21,Paul Beraldo,0,7,0,RW,1988
27437,1,23,Paul Bissonnette,0,15,1,LW,2008
27438,2,24,Paul Bissonnette,3,41,5,LW,2009
27439,0,25,Paul Bissonnette,1,48,1,LW,2010
27440,0,26,Paul Bissonnette,1,31,1,LW,2011
27441,6,27,Paul Bissonnette,0,28,6,LW,2012
27442,6,28,Paul Bissonnette,2,39,8,LW,2013
27443,0,18,Paul Boutilier,0,1,0,D,1981
27444,5,19,Paul Boutilier,4,29,9,D,1982
27445,11,20,Paul Boutilier,0,28,11,D,1983
27446,23,21,Paul Boutilier,12,78,35,D,1984
27447,30,22,Paul Boutilier,4,77,34,D,1985
27448,13,23,Paul Boutilier,7,62,20,D,1986
27449,1,24,Paul Boutilier,0,10,1,D,1987
27450,0,25,Paul Boutilier,0,3,0,D,1988
27451,3,24,Paul Broten,5,32,8,C,1989
27452,6,25,Paul Broten,4,28,10,C,1990
27453,15,26,Paul Broten,13,74,28,RW,1991
27454,9,27,Paul Broten,5,60,14,RW,1992
27455,12,28,Paul Broten,12,64,24,RW,1993
27456,9,29,Paul Broten,7,47,16,RW,1994
27457,1,30,Paul Broten,0,17,1,RW,1995
27458,1,22,Paul Brousseau,1,8,2,RW,1995
27459,0,23,Paul Brousseau,0,6,0,RW,1996
27460,2,24,Paul Brousseau,0,11,2,RW,1997
27461,0,27,Paul Brousseau,0,1,0,RW,2000
27462,2,21,Paul Brydges,2,15,4,C,1986
27463,1,21,Paul Byron,1,8,2,C,2010
27464,2,22,Paul Byron,3,22,5,C,2011
27465,1,23,Paul Byron,0,4,1,C,2012
27466,14,24,Paul Byron,7,47,21,C,2013
27467,13,25,Paul Byron,6,57,19,C,2014
27468,7,26,Paul Byron,11,62,18,C,2015
27469,21,27,Paul Byron,22,81,43,LW,2016
27470,15,28,Paul Byron,20,82,35,LW,2017
27471,0,25,Paul Carey,0,12,0,C,2013
27472,1,26,Paul Carey,0,10,1,C,2014
27473,0,27,Paul Carey,1,4,1,C,2015
27474,0,28,Paul Carey,0,6,0,C,2016
27475,7,29,Paul Carey,7,60,14,C,2017
27476,2,21,Paul Cavallini,0,6,2,D,1986
27477,10,22,Paul Cavallini,6,72,16,D,1987
27478,20,23,Paul Cavallini,4,65,24,D,1988
27479,39,24,Paul Cavallini,8,80,47,D,1989
27480,25,25,Paul Cavallini,10,67,35,D,1990
27481,25,26,Paul Cavallini,10,66,35,D,1991
27482,12,27,Paul Cavallini,6,82,18,D,1992
27483,33,28,Paul Cavallini,11,74,44,D,1993
27484,11,29,Paul Cavallini,1,44,12,D,1994
27485,0,30,Paul Cavallini,0,8,0,D,1995
27486,23,19,Paul Coffey,9,74,32,D,1980
27487,60,20,Paul Coffey,29,80,89,D,1981
27488,67,21,Paul Coffey,29,80,96,D,1982
27489,86,22,Paul Coffey,40,80,126,D,1983
27490,84,23,Paul Coffey,37,80,121,D,1984
27491,90,24,Paul Coffey,48,79,138,D,1985
27492,50,25,Paul Coffey,17,59,67,D,1986
27493,52,26,Paul Coffey,15,46,67,D,1987
27494,83,27,Paul Coffey,30,75,113,D,1988
27495,74,28,Paul Coffey,29,80,103,D,1989
27496,69,29,Paul Coffey,24,76,93,D,1990
27497,58,30,Paul Coffey,11,64,69,D,1991
27498,75,31,Paul Coffey,12,80,87,D,1992
27499,63,32,Paul Coffey,14,80,77,D,1993
27500,44,33,Paul Coffey,14,45,58,D,1994
27501,60,34,Paul Coffey,14,76,74,D,1995
27502,25,35,Paul Coffey,9,57,34,D,1996
27503,27,36,Paul Coffey,2,57,29,D,1997
27504,12,37,Paul Coffey,2,54,14,D,1998
27505,29,38,Paul Coffey,11,69,40,D,1999
27506,4,39,Paul Coffey,0,18,4,D,2000
27507,2,22,Paul Comrie,1,15,3,C,1999
27508,0,20,Paul Crowley,0,4,0,RW,1975
27509,0,20,Paul Crowley,0,4,0,RW,1975
27510,0,22,Paul Curtis,0,1,0,D,1969
27511,13,23,Paul Curtis,1,64,14,D,1970
27512,12,24,Paul Curtis,1,64,13,D,1971
27513,9,25,Paul Curtis,1,56,10,D,1972
27514,15,27,Paul Curtis,4,76,19,D,1974
27515,15,27,Paul Curtis,4,76,19,D,1974
27516,12,19,Paul Cyr,15,36,27,LW,1982
27517,27,20,Paul Cyr,16,71,43,LW,1983
27518,24,21,Paul Cyr,22,71,46,LW,1984
27519,31,22,Paul Cyr,20,71,51,LW,1985
27520,16,23,Paul Cyr,11,73,27,LW,1986
27521,14,24,Paul Cyr,5,60,19,LW,1987
27522,0,25,Paul Cyr,0,1,0,LW,1988
27523,13,27,Paul Cyr,12,70,25,C,1990
27524,3,28,Paul Cyr,0,17,3,LW,1991
27525,6,21,Paul DiPietro,4,33,10,C,1991
27526,13,22,Paul DiPietro,4,29,17,C,1992
27527,20,23,Paul DiPietro,13,70,33,C,1993
27528,6,24,Paul DiPietro,5,34,11,C,1994
27529,4,25,Paul DiPietro,4,20,8,C,1995
27530,0,26,Paul DiPietro,1,6,1,C,1996
27531,1,21,Paul E Evans,1,7,2,C,1976
27532,0,22,Paul E Evans,0,4,0,RW,1977
27533,5,25,Paul Fenton,7,33,12,LW,1984
27534,0,26,Paul Fenton,0,1,0,LW,1985
27535,0,27,Paul Fenton,0,8,0,LW,1986
27536,23,28,Paul Fenton,20,71,43,LW,1987
27537,12,29,Paul Fenton,16,80,28,LW,1988
27538,18,30,Paul Fenton,32,80,50,LW,1989
27539,21,31,Paul Fenton,14,78,35,LW,1990
27540,4,32,Paul Fenton,11,60,15,LW,1991
27541,16,18,Paul Gagne,25,61,41,LW,1980
27542,12,19,Paul Gagne,10,59,22,RW,1981
27543,15,20,Paul Gagne,14,53,29,LW,1982
27544,18,21,Paul Gagne,14,66,32,LW,1983
27545,19,22,Paul Gagne,24,79,43,LW,1984
27546,19,23,Paul Gagne,19,47,38,LW,1985
27547,2,26,Paul Gagne,3,16,5,LW,1988
27548,0,27,Paul Gagne,1,9,1,LW,1989
27549,29,20,Paul Gardner,30,60,59,C,1976
27550,22,21,Paul Gardner,30,46,52,C,1977
27551,28,22,Paul Gardner,30,75,58,C,1978
27552,13,23,Paul Gardner,11,45,24,C,1979
27553,40,24,Paul Gardner,34,62,74,C,1980
27554,33,25,Paul Gardner,36,59,69,C,1981
27555,27,26,Paul Gardner,28,70,55,C,1982
27556,5,27,Paul Gardner,0,16,5,C,1983
27557,4,28,Paul Gardner,2,12,6,C,1984
27558,0,29,Paul Gardner,0,2,0,C,1985
27559,0,20,Paul Gaustad,0,1,0,C,2002
27560,15,23,Paul Gaustad,9,78,24,C,2005
27561,13,24,Paul Gaustad,9,54,22,C,2006
27562,26,25,Paul Gaustad,10,82,36,C,2007
27563,17,26,Paul Gaustad,12,62,29,C,2008
27564,10,27,Paul Gaustad,12,65,22,C,2009
27565,19,28,Paul Gaustad,12,81,31,C,2010
27566,14,29,Paul Gaustad,7,70,21,C,2011
27567,3,30,Paul Gaustad,2,23,5,C,2012
27568,11,31,Paul Gaustad,10,75,21,C,2013
27569,10,32,Paul Gaustad,4,73,14,C,2014
27570,4,33,Paul Gaustad,2,63,6,C,2015
27571,2,19,Paul Gillis,0,7,2,C,1982
27572,9,20,Paul Gillis,8,57,17,C,1983
27573,28,21,Paul Gillis,14,77,42,C,1984
27574,24,22,Paul Gillis,19,80,43,C,1985
27575,26,23,Paul Gillis,13,76,39,C,1986
27576,10,24,Paul Gillis,7,80,17,C,1987
27577,25,25,Paul Gillis,15,79,40,C,1988
27578,14,26,Paul Gillis,8,71,22,LW,1989
27579,13,27,Paul Gillis,3,62,16,C,1990
27580,2,28,Paul Gillis,0,14,2,C,1991
27581,1,29,Paul Gillis,1,21,2,C,1992
27582,6,20,Paul Guay,2,14,8,RW,1983
27583,1,21,Paul Guay,0,2,1,RW,1984
27584,3,22,Paul Guay,3,23,6,RW,1985
27585,5,23,Paul Guay,2,35,7,RW,1986
27586,4,24,Paul Guay,4,33,8,RW,1987
27587,2,25,Paul Guay,0,7,2,RW,1988
27588,2,27,Paul Guay,0,3,2,RW,1990
27589,0,21,Paul Healey,0,2,0,RW,1996
27590,0,22,Paul Healey,0,4,0,RW,1997
27591,7,26,Paul Healey,3,21,10,RW,2001
27592,7,27,Paul Healey,3,44,10,LW,2002
27593,0,28,Paul Healey,0,4,0,RW,2003
27594,0,30,Paul Healey,0,2,0,RW,2005
27595,12,20,Paul Heaver,2,66,14,D,1975
27596,12,20,Paul Heaver,2,66,14,D,1975
27597,0,21,Paul Heaver,0,5,0,D,1976
27598,0,21,Paul Heaver,0,5,0,D,1976
27599,26,25,Paul Henderson,18,63,44,LW,1967
27600,32,26,Paul Henderson,27,74,59,LW,1968
27601,22,27,Paul Henderson,20,67,42,LW,1969
27602,30,28,Paul Henderson,30,72,60,LW,1970
27603,19,29,Paul Henderson,38,73,57,LW,1971
27604,16,30,Paul Henderson,18,40,34,LW,1972
27605,31,31,Paul Henderson,24,69,55,LW,1973
27606,33,32,Paul Henderson,30,58,63,LW,1974
27607,33,32,Paul Henderson,30,58,63,LW,1974
27608,29,33,Paul Henderson,26,65,55,LW,1975
27609,29,33,Paul Henderson,26,65,55,LW,1975
27610,25,34,Paul Henderson,23,81,48,LW,1976
27611,25,34,Paul Henderson,23,81,48,LW,1976
27612,29,35,Paul Henderson,37,80,66,LW,1977
27613,29,35,Paul Henderson,37,80,66,LW,1977
27614,27,36,Paul Henderson,24,76,51,LW,1978
27615,27,36,Paul Henderson,24,76,51,LW,1978
27616,6,37,Paul Henderson,7,30,13,RW,1979
27617,0,20,Paul Higgins,0,3,0,RW,1981
27618,0,21,Paul Higgins,0,22,0,RW,1982
27619,0,20,Paul Holmgren,0,1,0,RW,1975
27620,16,20,Paul Holmgren,14,51,30,RW,1975
27621,16,20,Paul Holmgren,14,51,30,RW,1975
27622,12,21,Paul Holmgren,14,59,26,RW,1976
27623,18,22,Paul Holmgren,16,62,34,RW,1977
27624,10,23,Paul Holmgren,19,57,29,RW,1978
27625,35,24,Paul Holmgren,30,74,65,RW,1979
27626,37,25,Paul Holmgren,22,77,59,RW,1980
27627,22,26,Paul Holmgren,9,41,31,RW,1981
27628,24,27,Paul Holmgren,19,77,43,RW,1982
27629,18,28,Paul Holmgren,11,63,29,RW,1983
27630,3,29,Paul Holmgren,4,16,7,RW,1984
27631,0,22,Paul Houck,1,3,1,RW,1985
27632,2,23,Paul Houck,0,12,2,RW,1986
27633,0,24,Paul Houck,0,1,0,RW,1987
27634,1,22,Paul Hurley,0,1,1,D,1968
27635,15,26,Paul Hurley,3,78,18,D,1972
27636,15,26,Paul Hurley,3,78,18,D,1972
27637,11,27,Paul Hurley,3,52,14,D,1973
27638,11,27,Paul Hurley,3,52,14,D,1973
27639,26,28,Paul Hurley,3,75,29,D,1974
27640,26,28,Paul Hurley,3,75,29,D,1974
27641,18,29,Paul Hurley,1,72,19,D,1975
27642,18,29,Paul Hurley,1,72,19,D,1975
27643,6,30,Paul Hurley,0,34,6,D,1976
27644,6,30,Paul Hurley,0,34,6,D,1976
27645,0,23,Paul Jerrard,0,5,0,RW,1988
27646,21,20,Paul Kariya,18,47,39,RW,1994
27647,58,21,Paul Kariya,50,82,108,LW,1995
27648,55,22,Paul Kariya,44,69,99,LW,1996
27649,14,23,Paul Kariya,17,22,31,LW,1997
27650,62,24,Paul Kariya,39,82,101,LW,1998
27651,44,25,Paul Kariya,42,74,86,LW,1999
27652,34,26,Paul Kariya,33,66,67,LW,2000
27653,25,27,Paul Kariya,32,82,57,RW,2001
27654,56,28,Paul Kariya,25,82,81,LW,2002
27655,25,29,Paul Kariya,11,51,36,LW,2003
27656,54,31,Paul Kariya,31,82,85,LW,2005
27657,52,32,Paul Kariya,24,82,76,LW,2006
27658,49,33,Paul Kariya,16,82,65,LW,2007
27659,13,34,Paul Kariya,2,11,15,LW,2008
27660,25,35,Paul Kariya,18,75,43,LW,2009
27661,0,20,Paul Kruse,0,1,0,LW,1990
27662,1,21,Paul Kruse,3,16,4,LW,1991
27663,3,22,Paul Kruse,2,27,5,LW,1992
27664,8,23,Paul Kruse,3,68,11,LW,1993
27665,5,24,Paul Kruse,11,45,16,LW,1994
27666,12,25,Paul Kruse,3,75,15,LW,1995
27667,2,26,Paul Kruse,6,62,8,LW,1996
27668,2,27,Paul Kruse,7,74,9,LW,1997
27669,0,28,Paul Kruse,3,43,3,LW,1998
27670,0,29,Paul Kruse,0,11,0,LW,1999
27671,0,30,Paul Kruse,0,1,0,LW,2000
27672,8,24,Paul Ladue,0,22,8,D,2016
27673,1,25,Paul Ladue,3,12,4,D,2017
27674,7,23,Paul Larose,0,28,7,RW,1972
27675,7,23,Paul Larose,0,28,7,RW,1972
27676,1,25,Paul Larose,1,5,2,RW,1974
27677,1,25,Paul Larose,1,5,2,RW,1974
27678,0,23,Paul Laus,2,39,2,D,1993
27679,7,24,Paul Laus,0,37,7,D,1994
27680,6,25,Paul Laus,3,78,9,D,1995
27681,12,26,Paul Laus,0,77,12,D,1996
27682,11,27,Paul Laus,0,77,11,RW,1997
27683,9,28,Paul Laus,1,75,10,D,1998
27684,8,29,Paul Laus,3,77,11,D,1999
27685,2,30,Paul Laus,1,25,3,RW,2000
27686,3,31,Paul Laus,4,45,7,D,2001
27687,9,18,Paul Lawless,6,47,15,LW,1982
27688,3,19,Paul Lawless,0,6,3,LW,1983
27689,21,21,Paul Lawless,17,64,38,LW,1985
27690,32,22,Paul Lawless,22,60,54,LW,1986
27691,11,23,Paul Lawless,4,49,15,LW,1987
27692,0,24,Paul Lawless,0,7,0,LW,1988
27693,1,25,Paul Lawless,0,6,1,LW,1989
27694,0,18,Paul MacDermid,1,3,1,C,1981
27695,0,19,Paul MacDermid,0,7,0,C,1982
27696,1,20,Paul MacDermid,0,3,1,C,1983
27697,7,21,Paul MacDermid,4,31,11,RW,1984
27698,10,22,Paul MacDermid,13,74,23,RW,1985
27699,11,23,Paul MacDermid,7,72,18,RW,1986
27700,15,24,Paul MacDermid,20,80,35,RW,1987
27701,27,25,Paul MacDermid,17,74,44,RW,1988
27702,22,26,Paul MacDermid,13,73,35,RW,1989
27703,21,27,Paul MacDermid,15,69,36,RW,1990
27704,16,28,Paul MacDermid,12,74,28,RW,1991
27705,8,29,Paul MacDermid,9,72,17,RW,1992
27706,3,30,Paul MacDermid,2,44,5,RW,1993
27707,1,31,Paul MacDermid,3,14,4,RW,1994
27708,15,20,Paul MacKinnon,2,73,17,D,1978
27709,15,20,Paul MacKinnon,2,73,17,D,1978
27710,11,21,Paul MacKinnon,1,63,12,D,1979
27711,0,22,Paul MacKinnon,0,14,0,D,1980
27712,9,23,Paul MacKinnon,2,39,11,D,1981
27713,2,24,Paul MacKinnon,2,19,4,D,1982
27714,1,25,Paul MacKinnon,0,12,1,D,1983
27715,0,22,Paul MacLean,0,1,0,RW,1980
27716,25,23,Paul MacLean,36,74,61,RW,1981
27717,44,24,Paul MacLean,32,80,76,RW,1982
27718,31,25,Paul MacLean,40,76,71,RW,1983
27719,60,26,Paul MacLean,41,79,101,RW,1984
27720,29,27,Paul MacLean,27,69,56,RW,1985
27721,42,28,Paul MacLean,32,72,74,RW,1986
27722,39,29,Paul MacLean,40,77,79,RW,1987
27723,35,30,Paul MacLean,36,76,71,RW,1988
27724,33,31,Paul MacLean,34,78,67,RW,1989
27725,11,32,Paul MacLean,6,37,17,RW,1990
27726,0,23,Paul Manning,0,8,0,D,2002
27727,1,19,Paul Mara,1,1,2,D,1998
27728,11,20,Paul Mara,7,54,18,D,1999
27729,14,21,Paul Mara,6,62,20,D,2000
27730,17,22,Paul Mara,7,75,24,D,2001
27731,15,23,Paul Mara,10,73,25,D,2002
27732,36,24,Paul Mara,6,81,42,D,2003
27733,32,26,Paul Mara,15,78,47,D,2005
27734,18,27,Paul Mara,5,78,23,D,2006
27735,16,28,Paul Mara,1,61,17,D,2007
27736,16,29,Paul Mara,5,76,21,D,2008
27737,8,30,Paul Mara,0,42,8,D,2009
27738,5,31,Paul Mara,1,53,6,D,2010
27739,12,19,Paul Marshall,9,46,21,LW,1979
27740,2,20,Paul Marshall,3,26,5,LW,1980
27741,2,21,Paul Marshall,2,10,4,LW,1981
27742,2,22,Paul Marshall,1,13,3,LW,1982
27743,18,22,Paul Martin,6,70,24,D,2003
27744,32,24,Paul Martin,5,80,37,D,2005
27745,23,25,Paul Martin,3,82,26,D,2006
27746,27,26,Paul Martin,5,73,32,D,2007
27747,28,27,Paul Martin,5,73,33,D,2008
27748,9,28,Paul Martin,2,22,11,D,2009
27749,21,29,Paul Martin,3,77,24,D,2010
27750,25,30,Paul Martin,2,73,27,D,2011
27751,17,31,Paul Martin,6,34,23,D,2012
27752,12,32,Paul Martin,3,39,15,D,2013
27753,17,33,Paul Martin,3,74,20,D,2014
27754,17,34,Paul Martin,3,78,20,D,2015
27755,22,35,Paul Martin,4,81,26,D,2016
27756,2,36,Paul Martin,0,14,2,D,2017
27757,1,20,Paul McIntosh,0,6,1,D,1974
27758,1,21,Paul McIntosh,0,42,1,D,1975
27759,0,21,Paul Messier,0,9,0,C,1978
27760,3,22,Paul Miller,0,3,3,C,1981
27761,4,20,Paul Mulvey,7,55,11,LW,1978
27762,19,21,Paul Mulvey,15,77,34,LW,1979
27763,14,22,Paul Mulvey,7,55,21,LW,1980
27764,14,23,Paul Mulvey,1,38,15,RW,1981
27765,5,20,Paul Nicholson,4,39,9,LW,1974
27766,2,21,Paul Nicholson,0,14,2,LW,1975
27767,1,22,Paul Nicholson,0,9,1,LW,1976
27768,0,20,Paul O'Neil,0,5,0,C,1973
27769,0,22,Paul O'Neil,0,1,0,C,1975
27770,0,25,Paul O'Neil,0,1,0,C,1978
27771,0,25,Paul O'Neil,0,1,0,C,1978
27772,2,24,Paul Pooley,0,12,2,C,1984
27773,1,25,Paul Pooley,0,3,1,C,1985
27774,0,21,Paul Postma,0,1,0,D,2010
27775,0,22,Paul Postma,0,3,0,D,2011
27776,5,23,Paul Postma,4,34,9,D,2012
27777,2,24,Paul Postma,1,20,3,D,2013
27778,4,25,Paul Postma,2,42,6,D,2014
27779,0,26,Paul Postma,2,26,2,D,2015
27780,13,27,Paul Postma,1,65,14,D,2016
27781,1,28,Paul Postma,0,14,1,D,2017
27782,17,21,Paul Ranger,1,76,18,D,2005
27783,24,22,Paul Ranger,4,72,28,D,2006
27784,21,23,Paul Ranger,10,72,31,D,2007
27785,11,24,Paul Ranger,2,42,13,D,2008
27786,1,25,Paul Ranger,1,8,2,D,2009
27787,8,29,Paul Ranger,6,53,14,D,2013
27788,0,23,Paul Ranheim,0,5,0,LW,1988
27789,28,24,Paul Ranheim,26,80,54,LW,1989
27790,16,25,Paul Ranheim,14,39,30,LW,1990
27791,20,26,Paul Ranheim,23,80,43,LW,1991
27792,22,27,Paul Ranheim,21,83,43,LW,1992
27793,17,28,Paul Ranheim,10,82,27,LW,1993
27794,14,29,Paul Ranheim,6,47,20,LW,1994
27795,20,30,Paul Ranheim,10,73,30,LW,1995
27796,11,31,Paul Ranheim,10,67,21,LW,1996
27797,9,32,Paul Ranheim,5,73,14,LW,1997
27798,10,33,Paul Ranheim,9,78,19,LW,1998
27799,13,34,Paul Ranheim,9,79,22,LW,1999
27800,7,35,Paul Ranheim,10,80,17,LW,2000
27801,4,36,Paul Ranheim,5,79,9,RW,2001
27802,8,37,Paul Ranheim,3,68,11,RW,2002
27803,38,20,Paul Reinhart,9,79,47,D,1979
27804,49,21,Paul Reinhart,18,74,67,D,1980
27805,48,22,Paul Reinhart,13,62,61,D,1981
27806,58,23,Paul Reinhart,17,78,75,D,1982
27807,15,24,Paul Reinhart,6,27,21,D,1983
27808,46,25,Paul Reinhart,23,75,69,D,1984
27809,25,26,Paul Reinhart,8,32,33,D,1985
27810,53,27,Paul Reinhart,15,76,68,D,1986
27811,4,28,Paul Reinhart,0,14,4,D,1987
27812,50,29,Paul Reinhart,7,64,57,D,1988
27813,40,30,Paul Reinhart,17,67,57,D,1989
27814,4,21,Paul Shakes,0,21,4,D,1973
27815,0,23,Paul Shmyr,1,3,1,D,1968
27816,4,24,Paul Shmyr,0,24,4,D,1969
27817,12,25,Paul Shmyr,1,57,13,D,1970
27818,21,26,Paul Shmyr,6,69,27,D,1971
27819,43,27,Paul Shmyr,5,73,48,D,1972
27820,43,27,Paul Shmyr,5,73,48,D,1972
27821,31,28,Paul Shmyr,13,78,44,D,1973
27822,31,28,Paul Shmyr,13,78,44,D,1973
27823,14,29,Paul Shmyr,7,49,21,D,1974
27824,14,29,Paul Shmyr,7,49,21,D,1974
27825,44,30,Paul Shmyr,6,70,50,D,1975
27826,44,30,Paul Shmyr,6,70,50,D,1975
27827,37,31,Paul Shmyr,13,81,50,D,1976
27828,37,31,Paul Shmyr,13,81,50,D,1976
27829,40,32,Paul Shmyr,9,80,49,D,1977
27830,40,32,Paul Shmyr,9,80,49,D,1977
27831,39,33,Paul Shmyr,8,80,47,D,1978
27832,39,33,Paul Shmyr,8,80,47,D,1978
27833,15,34,Paul Shmyr,3,63,18,D,1979
27834,9,35,Paul Shmyr,1,61,10,D,1980
27835,11,36,Paul Shmyr,1,66,12,D,1981
27836,18,23,Paul Stanton,5,75,23,D,1990
27837,8,24,Paul Stanton,2,54,10,D,1991
27838,12,25,Paul Stanton,4,77,16,D,1992
27839,7,26,Paul Stanton,3,71,10,D,1993
27840,4,27,Paul Stanton,0,18,4,D,1994
27841,50,21,Paul Stastny,28,82,78,C,2006
27842,47,22,Paul Stastny,24,66,71,C,2007
27843,25,23,Paul Stastny,11,45,36,C,2008
27844,59,24,Paul Stastny,20,81,79,C,2009
27845,35,25,Paul Stastny,22,74,57,C,2010
27846,32,26,Paul Stastny,21,79,53,C,2011
27847,15,27,Paul Stastny,9,40,24,C,2012
27848,35,28,Paul Stastny,25,71,60,C,2013
27849,30,29,Paul Stastny,16,74,46,C,2014
27850,39,30,Paul Stastny,10,64,49,C,2015
27851,22,31,Paul Stastny,18,66,40,C,2016
27852,9,32,Paul Stastny,4,19,13,C,2017
27853,0,22,Paul Stewart,0,2,0,D,1976
27854,5,23,Paul Stewart,1,40,6,D,1977
27855,1,24,Paul Stewart,2,23,3,LW,1978
27856,1,24,Paul Stewart,2,23,3,LW,1978
27857,0,25,Paul Stewart,2,21,2,LW,1979
27858,5,23,Paul Szczechura,4,31,9,C,2008
27859,2,24,Paul Szczechura,5,52,7,C,2009
27860,3,26,Paul Szczechura,1,9,4,C,2011
27861,7,22,Paul Terbenche,3,68,10,D,1967
27862,0,25,Paul Terbenche,0,3,0,D,1970
27863,0,26,Paul Terbenche,0,9,0,D,1971
27864,7,27,Paul Terbenche,0,42,7,D,1972
27865,12,28,Paul Terbenche,2,67,14,D,1973
27866,14,29,Paul Terbenche,3,60,17,D,1974
27867,14,29,Paul Terbenche,3,60,17,D,1974
27868,4,30,Paul Terbenche,2,58,6,D,1975
27869,4,30,Paul Terbenche,2,58,6,D,1975
27870,24,31,Paul Terbenche,9,80,33,D,1976
27871,24,31,Paul Terbenche,9,80,33,D,1976
27872,0,32,Paul Terbenche,1,11,1,D,1977
27873,0,32,Paul Terbenche,1,11,1,D,1977
27874,22,33,Paul Terbenche,3,68,25,D,1978
27875,22,33,Paul Terbenche,3,68,25,D,1978
27876,0,27,Paul Thompson,0,3,0,RW,2015
27877,3,28,Paul Thompson,0,21,3,RW,2016
27878,23,22,Paul Woods,19,80,42,LW,1977
27879,23,23,Paul Woods,14,80,37,LW,1978
27880,20,24,Paul Woods,6,79,26,LW,1979
27881,16,25,Paul Woods,8,67,24,C,1980
27882,17,26,Paul Woods,10,75,27,C,1981
27883,20,27,Paul Woods,13,63,33,LW,1982
27884,5,28,Paul Woods,2,57,7,LW,1983
27885,4,22,Paul Ysebaert,0,5,4,C,1988
27886,2,23,Paul Ysebaert,1,5,3,C,1989
27887,21,24,Paul Ysebaert,19,62,40,LW,1990
27888,40,25,Paul Ysebaert,35,79,75,LW,1991
27889,28,26,Paul Ysebaert,34,80,62,LW,1992
27890,21,27,Paul Ysebaert,14,71,35,C,1993
27891,16,28,Paul Ysebaert,12,44,28,LW,1994
27892,15,29,Paul Ysebaert,16,55,31,LW,1995
27893,12,30,Paul Ysebaert,5,39,17,LW,1996
27894,27,31,Paul Ysebaert,13,82,40,C,1997
27895,1,32,Paul Ysebaert,0,10,1,C,1998
27896,13,21,Paulin Bordeleau,11,68,24,RW,1973
27897,31,22,Paulin Bordeleau,17,67,48,RW,1974
27898,12,23,Paulin Bordeleau,5,48,17,RW,1975
27899,41,24,Paulin Bordeleau,42,80,83,RW,1976
27900,41,24,Paulin Bordeleau,42,80,83,RW,1976
27901,23,25,Paulin Bordeleau,42,77,65,RW,1977
27902,23,25,Paulin Bordeleau,42,77,65,RW,1977
27903,12,26,Paulin Bordeleau,17,77,29,RW,1978
27904,12,26,Paulin Bordeleau,17,77,29,RW,1978
27905,0,20,Pavel Brendl,1,8,1,RW,2001
27906,8,21,Pavel Brendl,5,50,13,RW,2002
27907,3,22,Pavel Brendl,5,18,8,RW,2003
27908,0,24,Pavel Brendl,0,2,0,RW,2005
27909,12,21,Pavel Buchnevich,8,41,20,RW,2016
27910,29,22,Pavel Buchnevich,14,74,43,RW,2017
27911,26,20,Pavel Bure,34,65,60,RW,1991
27912,50,21,Pavel Bure,60,83,110,RW,1992
27913,47,22,Pavel Bure,60,76,107,RW,1993
27914,23,23,Pavel Bure,20,44,43,LW,1994
27915,7,24,Pavel Bure,6,15,13,LW,1995
27916,32,25,Pavel Bure,23,63,55,RW,1996
27917,39,26,Pavel Bure,51,82,90,RW,1997
27918,3,27,Pavel Bure,13,11,16,RW,1998
27919,36,28,Pavel Bure,58,74,94,RW,1999
27920,33,29,Pavel Bure,59,82,92,RW,2000
27921,35,30,Pavel Bure,34,68,69,RW,2001
27922,11,31,Pavel Bure,19,39,30,RW,2002
27923,24,23,Pavel Datsyuk,11,70,35,C,2001
27924,39,24,Pavel Datsyuk,12,64,51,C,2002
27925,38,25,Pavel Datsyuk,30,75,68,C,2003
27926,59,27,Pavel Datsyuk,28,75,87,C,2005
27927,60,28,Pavel Datsyuk,27,79,87,C,2006
27928,66,29,Pavel Datsyuk,31,82,97,C,2007
27929,65,30,Pavel Datsyuk,32,81,97,C,2008
27930,43,31,Pavel Datsyuk,27,80,70,C,2009
27931,36,32,Pavel Datsyuk,23,56,59,C,2010
27932,48,33,Pavel Datsyuk,19,70,67,C,2011
27933,34,34,Pavel Datsyuk,15,47,49,C,2012
27934,20,35,Pavel Datsyuk,17,45,37,C,2013
27935,39,36,Pavel Datsyuk,26,63,65,C,2014
27936,33,37,Pavel Datsyuk,16,66,49,C,2015
27937,0,28,Pavel Kolarik,0,10,0,D,2000
27938,0,29,Pavel Kolarik,0,13,0,D,2001
27939,2,20,Pavel Kubina,1,10,3,D,1997
27940,12,21,Pavel Kubina,9,68,21,D,1998
27941,18,22,Pavel Kubina,8,69,26,D,1999
27942,19,23,Pavel Kubina,11,70,30,D,2000
27943,23,24,Pavel Kubina,11,82,34,D,2001
27944,19,25,Pavel Kubina,3,75,22,D,2002
27945,18,26,Pavel Kubina,17,81,35,D,2003
27946,33,28,Pavel Kubina,5,76,38,D,2005
27947,14,29,Pavel Kubina,7,61,21,D,2006
27948,29,30,Pavel Kubina,11,72,40,D,2007
27949,26,31,Pavel Kubina,14,82,40,D,2008
27950,32,32,Pavel Kubina,6,76,38,D,2009
27951,19,33,Pavel Kubina,4,79,23,D,2010
27952,12,34,Pavel Kubina,3,69,15,D,2011
27953,4,28,Pavel Patera,1,12,5,C,1999
27954,3,29,Pavel Patera,1,20,4,C,2000
27955,0,,Pavel Pazourek,0,7,0,D,1977
27956,0,,Pavel Pazourek,0,7,0,D,1977
27957,1,,Pavel Richter,3,8,4,RW,1977
27958,1,,Pavel Richter,3,8,4,RW,1977
27959,12,21,Pavel Rosa,4,29,16,RW,1998
27960,0,22,Pavel Rosa,0,3,0,RW,1999
27961,0,25,Pavel Rosa,0,2,0,RW,2002
27962,1,26,Pavel Rosa,1,2,2,RW,2003
27963,0,20,Pavel Skrbek,0,4,0,D,1998
27964,0,22,Pavel Skrbek,0,5,0,D,2000
27965,0,23,Pavel Skrbek,0,3,0,D,2001
27966,10,30,Pavel Torgaev,6,41,16,LW,1995
27967,4,34,Pavel Torgaev,0,14,4,LW,1999
27968,4,21,Pavel Trnka,3,48,7,D,1997
27969,4,22,Pavel Trnka,0,63,4,D,1998
27970,15,23,Pavel Trnka,2,57,17,D,1999
27971,7,24,Pavel Trnka,1,59,8,D,2000
27972,11,25,Pavel Trnka,2,71,13,D,2001
27973,9,26,Pavel Trnka,3,46,12,D,2002
27974,13,27,Pavel Trnka,3,67,16,D,2003
27975,3,21,Pavel Vorobiev,1,18,4,RW,2003
27976,12,23,Pavel Vorobiev,9,39,21,RW,2005
27977,2,18,Pavel Zacha,0,1,2,C,2015
27978,16,19,Pavel Zacha,8,70,24,C,2016
27979,17,20,Pavel Zacha,8,69,25,C,2017
27980,1,19,Pavol Demitra,1,12,2,LW,1993
27981,3,20,Pavol Demitra,4,16,7,RW,1994
27982,10,21,Pavol Demitra,7,31,17,RW,1995
27983,0,22,Pavol Demitra,3,8,3,RW,1996
27984,30,23,Pavol Demitra,22,61,52,LW,1997
27985,52,24,Pavol Demitra,37,82,89,LW,1998
27986,47,25,Pavol Demitra,28,71,75,RW,1999
27987,25,26,Pavol Demitra,20,44,45,RW,2000
27988,43,27,Pavol Demitra,35,82,78,C,2001
27989,57,28,Pavol Demitra,36,78,93,C,2002
27990,35,29,Pavol Demitra,23,68,58,C,2003
27991,37,31,Pavol Demitra,25,58,62,RW,2005
27992,39,32,Pavol Demitra,25,71,64,RW,2006
27993,39,33,Pavol Demitra,15,68,54,LW,2007
27994,33,34,Pavol Demitra,20,69,53,C,2008
27995,13,35,Pavol Demitra,3,28,16,C,2009
27996,0,21,Paxton Schulte,0,1,0,LW,1993
27997,0,24,Paxton Schulte,0,1,0,LW,1996
27998,39,22,Pekka Rautakallio,11,73,50,D,1975
27999,39,22,Pekka Rautakallio,11,73,50,D,1975
28000,31,23,Pekka Rautakallio,4,78,35,D,1976
28001,31,23,Pekka Rautakallio,4,78,35,D,1976
28002,25,26,Pekka Rautakallio,5,79,30,D,1979
28003,45,27,Pekka Rautakallio,11,76,56,D,1980
28004,51,28,Pekka Rautakallio,17,80,68,D,1981
28005,51,22,Pelle Eklund,15,70,66,C,1985
28006,41,23,Pelle Eklund,14,72,55,C,1986
28007,32,24,Pelle Eklund,10,71,42,C,1987
28008,51,25,Pelle Eklund,18,79,69,LW,1988
28009,39,26,Pelle Eklund,23,70,62,LW,1989
28010,50,27,Pelle Eklund,19,73,69,C,1990
28011,16,28,Pelle Eklund,7,51,23,LW,1991
28012,38,29,Pelle Eklund,11,55,49,LW,1992
28013,17,30,Pelle Eklund,3,53,20,LW,1993
28014,12,22,Per Djoos,0,26,12,D,1990
28015,18,23,Per Djoos,1,50,19,D,1991
28016,1,24,Per Djoos,1,6,2,D,1992
28017,22,26,Per Gustafsson,7,58,29,D,1996
28018,5,27,Per Gustafsson,1,31,6,D,1997
28019,0,30,Per Ledin,0,3,0,LW,2008
28020,4,24,Per Svartvadet,3,38,7,LW,1999
28021,11,25,Per Svartvadet,10,69,21,C,2000
28022,12,26,Per Svartvadet,3,78,15,C,2001
28023,7,27,Per Svartvadet,1,62,8,C,2002
28024,37,27,Per-Olov Brasar,20,77,57,LW,1977
28025,28,28,Per-Olov Brasar,6,68,34,LW,1978
28026,24,29,Per-Olov Brasar,10,70,34,LW,1979
28027,41,30,Per-Olov Brasar,22,80,63,LW,1980
28028,12,31,Per-Olov Brasar,6,53,18,LW,1981
28029,2,20,Perry Anderson,1,5,3,LW,1981
28030,2,21,Perry Anderson,5,18,7,LW,1982
28031,5,22,Perry Anderson,7,50,12,LW,1983
28032,9,23,Perry Anderson,9,71,18,LW,1984
28033,12,24,Perry Anderson,7,51,19,LW,1985
28034,9,25,Perry Anderson,10,57,19,LW,1986
28035,6,26,Perry Anderson,4,60,10,LW,1987
28036,6,27,Perry Anderson,3,39,9,LW,1988
28037,0,29,Perry Anderson,0,1,0,LW,1990
28038,8,30,Perry Anderson,4,48,12,LW,1991
28039,2,20,Perry Berezan,3,9,5,C,1984
28040,21,21,Perry Berezan,12,55,33,C,1985
28041,3,22,Perry Berezan,5,24,8,C,1986
28042,12,23,Perry Berezan,7,29,19,C,1987
28043,8,24,Perry Berezan,5,51,13,C,1988
28044,12,25,Perry Berezan,3,64,15,C,1989
28045,6,26,Perry Berezan,11,52,17,C,1990
28046,7,27,Perry Berezan,12,66,19,C,1991
28047,4,28,Perry Berezan,3,28,7,RW,1992
28048,0,20,Perry Ganchar,0,1,0,RW,1983
28049,2,21,Perry Ganchar,0,7,2,RW,1984
28050,5,24,Perry Ganchar,3,31,8,RW,1987
28051,0,25,Perry Ganchar,0,3,0,RW,1988
28052,19,22,Perry Miller,9,67,28,D,1974
28053,19,22,Perry Miller,9,67,28,D,1974
28054,10,23,Perry Miller,8,60,18,D,1975
28055,10,23,Perry Miller,8,60,18,D,1975
28056,31,24,Perry Miller,14,74,45,D,1976
28057,31,24,Perry Miller,14,74,45,D,1976
28058,17,25,Perry Miller,4,62,21,D,1977
28059,23,26,Perry Miller,5,75,28,D,1978
28060,3,27,Perry Miller,0,16,3,D,1979
28061,8,28,Perry Miller,1,64,9,D,1980
28062,0,21,Perry Pelensky,0,4,0,RW,1983
28063,19,20,Perry Turnbull,16,80,35,C,1979
28064,22,21,Perry Turnbull,34,75,56,LW,1980
28065,26,22,Perry Turnbull,33,79,59,LW,1981
28066,15,23,Perry Turnbull,32,79,47,LW,1982
28067,15,24,Perry Turnbull,20,72,35,C,1983
28068,21,25,Perry Turnbull,22,66,43,LW,1984
28069,31,26,Perry Turnbull,20,80,51,LW,1985
28070,5,27,Perry Turnbull,1,26,6,LW,1986
28071,9,28,Perry Turnbull,10,51,19,LW,1987
28072,0,22,Perttu Lindgren,0,1,0,C,2009
28073,2,33,Pete Goegan,1,46,3,D,1967
28074,0,22,Pete Laframboise,0,5,0,C,1971
28075,25,23,Pete Laframboise,16,77,41,LW,1972
28076,7,24,Pete Laframboise,7,65,14,LW,1973
28077,23,25,Pete Laframboise,10,80,33,LW,1974
28078,5,27,Pete Laframboise,0,17,5,C,1976
28079,5,27,Pete Laframboise,0,17,5,C,1976
28080,4,21,Pete Mahovlich,6,15,10,C,1967
28081,2,22,Pete Mahovlich,2,30,4,C,1968
28082,8,23,Pete Mahovlich,9,36,17,C,1969
28083,26,24,Pete Mahovlich,35,78,61,C,1970
28084,32,25,Pete Mahovlich,35,75,67,C,1971
28085,38,26,Pete Mahovlich,21,61,59,C,1972
28086,37,27,Pete Mahovlich,36,78,73,C,1973
28087,82,28,Pete Mahovlich,35,80,117,C,1974
28088,71,29,Pete Mahovlich,34,80,105,C,1975
28089,47,30,Pete Mahovlich,15,76,62,C,1976
28090,41,31,Pete Mahovlich,28,74,69,C,1977
28091,39,32,Pete Mahovlich,14,60,53,C,1978
28092,50,33,Pete Mahovlich,16,80,66,C,1979
28093,4,34,Pete Mahovlich,1,24,5,C,1980
28094,21,24,Pete Stemkowski,10,73,31,C,1967
28095,31,25,Pete Stemkowski,21,71,52,C,1968
28096,24,26,Pete Stemkowski,25,76,49,C,1969
28097,31,27,Pete Stemkowski,18,78,49,C,1970
28098,17,28,Pete Stemkowski,11,59,28,C,1971
28099,37,29,Pete Stemkowski,22,78,59,C,1972
28100,45,30,Pete Stemkowski,25,78,70,C,1973
28101,35,31,Pete Stemkowski,24,77,59,C,1974
28102,28,32,Pete Stemkowski,13,75,41,C,1975
28103,13,33,Pete Stemkowski,2,61,15,C,1976
28104,18,34,Pete Stemkowski,13,80,31,C,1977
28105,0,23,Pete Vipond,0,3,0,LW,1972
28106,12,23,Peter Ahola,7,71,19,D,1991
28107,5,24,Peter Ahola,3,50,8,D,1992
28108,0,25,Peter Ahola,0,2,0,D,1993
28109,0,25,Peter Allen,0,8,0,D,1995
28110,1,23,Peter Ambroziak,0,12,1,LW,1994
28111,11,27,Peter B Andersson,4,31,15,D,1992
28112,2,28,Peter B Andersson,2,16,4,D,1993
28113,0,23,Peter Bakovic,2,10,2,RW,1987
28114,2,27,Peter Bartos,4,13,6,RW,2000
28115,16,22,Peter Bondra,12,54,28,LW,1990
28116,28,23,Peter Bondra,28,71,56,RW,1991
28117,48,24,Peter Bondra,37,83,85,RW,1992
28118,19,25,Peter Bondra,24,69,43,RW,1993
28119,9,26,Peter Bondra,34,47,43,RW,1994
28120,28,27,Peter Bondra,52,67,80,RW,1995
28121,31,28,Peter Bondra,46,77,77,RW,1996
28122,26,29,Peter Bondra,52,76,78,RW,1997
28123,24,30,Peter Bondra,31,66,55,RW,1998
28124,17,31,Peter Bondra,21,62,38,RW,1999
28125,36,32,Peter Bondra,45,82,81,LW,2000
28126,31,33,Peter Bondra,39,77,70,RW,2001
28127,26,34,Peter Bondra,30,76,56,LW,2002
28128,23,35,Peter Bondra,26,77,49,RW,2003
28129,18,37,Peter Bondra,21,60,39,RW,2005
28130,9,38,Peter Bondra,5,37,14,RW,2006
28131,2,21,Peter Cehlarik,0,11,2,LW,2016
28132,1,22,Peter Cehlarik,1,6,2,LW,2017
28133,0,22,Peter Ciavaglia,0,2,0,C,1991
28134,0,23,Peter Ciavaglia,0,3,0,C,1992
28135,2,26,Peter Dineen,0,11,2,D,1986
28136,0,29,Peter Dineen,0,2,0,D,1989
28137,0,19,Peter Douris,0,11,0,RW,1985
28138,0,20,Peter Douris,0,6,0,RW,1986
28139,2,21,Peter Douris,0,4,2,RW,1987
28140,6,23,Peter Douris,5,36,11,RW,1989
28141,2,24,Peter Douris,5,39,7,RW,1990
28142,13,25,Peter Douris,10,54,23,RW,1991
28143,4,26,Peter Douris,4,19,8,RW,1992
28144,22,27,Peter Douris,12,74,34,RW,1993
28145,11,28,Peter Douris,10,46,21,LW,1994
28146,7,29,Peter Douris,8,31,15,RW,1995
28147,0,31,Peter Douris,0,1,0,RW,1997
28148,2,20,Peter Driscoll,3,21,5,LW,1974
28149,2,20,Peter Driscoll,3,21,5,LW,1974
28150,18,21,Peter Driscoll,16,75,34,LW,1975
28151,18,21,Peter Driscoll,16,75,34,LW,1975
28152,29,22,Peter Driscoll,23,76,52,LW,1976
28153,29,22,Peter Driscoll,23,76,52,LW,1976
28154,28,23,Peter Driscoll,28,77,56,LW,1977
28155,21,23,Peter Driscoll,25,56,46,LW,1977
28156,7,23,Peter Driscoll,3,21,10,LW,1977
28157,28,23,Peter Driscoll,28,77,56,LW,1977
28158,21,23,Peter Driscoll,25,56,46,LW,1977
28159,7,23,Peter Driscoll,3,21,10,LW,1977
28160,24,24,Peter Driscoll,20,77,44,LW,1978
28161,24,24,Peter Driscoll,20,77,44,LW,1978
28162,5,25,Peter Driscoll,1,39,6,RW,1979
28163,3,26,Peter Driscoll,2,21,5,LW,1980
28164,3,24,Peter Eriksson,3,20,6,LW,1989
28165,1,23,Peter Ferraro,0,5,1,C,1995
28166,0,24,Peter Ferraro,0,2,0,C,1996
28167,4,25,Peter Ferraro,3,30,7,RW,1997
28168,8,26,Peter Ferraro,6,46,14,C,1998
28169,1,27,Peter Ferraro,0,5,1,RW,1999
28170,1,29,Peter Ferraro,0,4,1,LW,2001
28171,0,23,Peter Fiorentino,0,1,0,D,1991
28172,0,20,Peter Folco,0,2,0,D,1973
28173,8,22,Peter Folco,1,19,9,D,1975
28174,8,22,Peter Folco,1,19,9,D,1975
28175,0,23,Peter Folco,0,2,0,D,1976
28176,0,23,Peter Folco,0,2,0,D,1976
28177,35,21,Peter Forsberg,15,47,50,C,1994
28178,86,22,Peter Forsberg,30,82,116,C,1995
28179,58,23,Peter Forsberg,28,65,86,C,1996
28180,66,24,Peter Forsberg,25,72,91,C,1997
28181,67,25,Peter Forsberg,30,78,97,C,1998
28182,37,26,Peter Forsberg,14,49,51,C,1999
28183,62,27,Peter Forsberg,27,73,89,C,2000
28184,77,29,Peter Forsberg,29,75,106,C,2002
28185,37,30,Peter Forsberg,18,39,55,C,2003
28186,56,32,Peter Forsberg,19,60,75,C,2005
28187,42,33,Peter Forsberg,13,57,55,C,2006
28188,13,34,Peter Forsberg,1,9,14,C,2007
28189,0,37,Peter Forsberg,0,2,0,C,2010
28190,0,23,Peter Gustavsson,0,2,0,LW,1981
28191,2,23,Peter Harrold,0,12,2,D,2006
28192,3,24,Peter Harrold,2,25,5,D,2007
28193,8,25,Peter Harrold,4,69,12,D,2008
28194,2,26,Peter Harrold,1,39,3,D,2009
28195,3,27,Peter Harrold,1,19,4,D,2010
28196,2,28,Peter Harrold,0,11,2,D,2011
28197,3,29,Peter Harrold,2,23,5,D,2012
28198,4,30,Peter Harrold,0,33,4,D,2013
28199,2,31,Peter Harrold,3,43,5,D,2014
28200,0,24,Peter Hayek,0,1,0,D,1981
28201,1,31,Peter Helander,0,7,1,D,1982
28202,0,21,Peter Holland,1,4,1,C,2011
28203,2,22,Peter Holland,3,21,5,C,2012
28204,5,23,Peter Holland,6,43,11,C,2013
28205,14,24,Peter Holland,11,62,25,C,2014
28206,18,25,Peter Holland,9,65,27,C,2015
28207,1,26,Peter Holland,0,8,1,C,2016
28208,3,27,Peter Holland,1,23,4,C,2017
28209,38,25,Peter Ihnacak,28,80,66,C,1982
28210,13,26,Peter Ihnacak,10,47,23,C,1983
28211,22,27,Peter Ihnacak,22,70,44,C,1984
28212,27,28,Peter Ihnacak,18,63,45,C,1985
28213,27,29,Peter Ihnacak,12,58,39,C,1986
28214,20,30,Peter Ihnacak,10,68,30,C,1987
28215,16,31,Peter Ihnacak,2,26,18,C,1988
28216,2,32,Peter Ihnacak,0,5,2,C,1989
28217,0,24,Peter Lappin,0,6,0,RW,1989
28218,0,26,Peter Lappin,0,1,0,RW,1991
28219,0,24,Peter Laviolette,0,12,0,D,1988
28220,0,25,Peter LeBlanc,0,1,0,C,2013
28221,0,22,Peter LeBoutillier,1,23,1,RW,1996
28222,1,23,Peter LeBoutillier,1,12,2,RW,1997
28223,13,22,Peter Lee,5,60,18,RW,1977
28224,26,23,Peter Lee,32,80,58,RW,1978
28225,29,24,Peter Lee,16,74,45,RW,1979
28226,34,25,Peter Lee,30,80,64,RW,1980
28227,16,26,Peter Lee,18,74,34,RW,1981
28228,13,27,Peter Lee,13,63,26,RW,1982
28229,2,27,Peter Loob,1,8,3,D,1984
28230,21,27,Peter Mara,17,67,38,C,1974
28231,21,27,Peter Mara,17,67,38,C,1974
28232,7,28,Peter Mara,3,40,10,C,1975
28233,7,28,Peter Mara,3,40,10,C,1975
28234,4,20,Peter Marrin,1,31,5,C,1973
28235,4,20,Peter Marrin,1,31,5,C,1973
28236,1,21,Peter Marrin,3,4,4,C,1974
28237,1,21,Peter Marrin,3,4,4,C,1974
28238,16,22,Peter Marrin,22,64,38,C,1975
28239,16,22,Peter Marrin,22,64,38,C,1975
28240,37,23,Peter Marrin,23,79,60,C,1976
28241,37,23,Peter Marrin,23,79,60,C,1976
28242,43,24,Peter Marrin,28,80,71,C,1977
28243,43,24,Peter Marrin,28,80,71,C,1977
28244,11,25,Peter Marrin,4,20,15,C,1978
28245,11,25,Peter Marrin,4,20,15,C,1978
28246,28,20,Peter Marsh,23,76,51,C,1976
28247,28,20,Peter Marsh,23,76,51,C,1976
28248,25,21,Peter Marsh,25,74,50,RW,1977
28249,25,21,Peter Marsh,25,74,50,RW,1977
28250,23,22,Peter Marsh,43,80,66,LW,1978
28251,23,22,Peter Marsh,43,80,66,LW,1978
28252,20,23,Peter Marsh,18,57,38,RW,1979
28253,13,24,Peter Marsh,10,53,23,RW,1980
28254,18,25,Peter Marsh,10,57,28,RW,1981
28255,14,26,Peter Marsh,6,68,20,RW,1982
28256,6,27,Peter Marsh,4,43,10,RW,1983
28257,6,21,Peter McNab,3,22,9,C,1973
28258,21,22,Peter McNab,22,53,43,C,1974
28259,32,23,Peter McNab,24,79,56,C,1975
28260,48,24,Peter McNab,38,80,86,C,1976
28261,39,25,Peter McNab,41,79,80,C,1977
28262,45,26,Peter McNab,35,76,80,C,1978
28263,38,27,Peter McNab,40,74,78,C,1979
28264,46,28,Peter McNab,37,80,83,C,1980
28265,40,29,Peter McNab,36,80,76,C,1981
28266,52,30,Peter McNab,22,74,74,C,1982
28267,22,31,Peter McNab,15,65,37,C,1983
28268,25,32,Peter McNab,23,75,48,C,1984
28269,24,33,Peter McNab,19,71,43,C,1985
28270,12,34,Peter McNab,8,46,20,C,1986
28271,0,23,Peter McNamee,0,3,0,D,1973
28272,0,23,Peter McNamee,0,3,0,D,1973
28273,20,24,Peter McNamee,11,66,31,LW,1974
28274,19,24,Peter McNamee,9,55,28,LW,1974
28275,1,24,Peter McNamee,2,11,3,LW,1974
28276,19,24,Peter McNamee,9,55,28,LW,1974
28277,1,24,Peter McNamee,2,11,3,LW,1974
28278,5,25,Peter McNamee,3,65,8,D,1975
28279,6,26,Peter McNamee,3,41,9,D,1976
28280,6,26,Peter McNamee,3,41,9,D,1976
28281,13,20,Peter Morris,7,75,20,LW,1975
28282,13,20,Peter Morris,7,75,20,LW,1975
28283,0,21,Peter Morris,0,3,0,LW,1976
28284,0,21,Peter Morris,0,3,0,LW,1976
28285,32,19,Peter Mueller,22,81,54,C,2007
28286,23,20,Peter Mueller,13,72,36,RW,2008
28287,24,21,Peter Mueller,13,69,37,C,2009
28288,9,23,Peter Mueller,7,32,16,C,2011
28289,9,24,Peter Mueller,8,43,17,C,2012
28290,7,21,Peter N Andersson,3,42,10,D,1983
28291,10,22,Peter N Andersson,0,57,10,D,1984
28292,24,23,Peter N Andersson,7,73,31,D,1985
28293,0,24,Peter Nordstrom,0,2,0,C,1998
28294,5,23,Peter Olvecky,2,31,7,LW,2008
28295,0,24,Peter Olvecky,0,1,0,LW,2009
28296,12,25,Peter Popovic,2,47,14,D,1993
28297,5,26,Peter Popovic,0,33,5,D,1994
28298,12,27,Peter Popovic,2,76,14,D,1995
28299,13,28,Peter Popovic,1,78,14,D,1996
28300,6,29,Peter Popovic,2,69,8,D,1997
28301,4,30,Peter Popovic,1,68,5,D,1998
28302,5,31,Peter Popovic,1,54,6,D,1999
28303,6,32,Peter Popovic,1,60,7,D,2000
28304,1,21,Peter Ratchuk,1,24,2,D,1998
28305,0,23,Peter Ratchuk,0,8,0,D,2000
28306,1,22,Peter Regin,1,11,2,C,2008
28307,16,23,Peter Regin,13,75,29,C,2009
28308,14,24,Peter Regin,3,55,17,C,2010
28309,2,25,Peter Regin,2,10,4,C,2011
28310,3,26,Peter Regin,0,27,3,C,2012
28311,7,27,Peter Regin,4,61,11,C,2013
28312,1,28,Peter Regin,0,4,1,C,2014
28313,0,24,Peter Sarno,1,6,1,C,2003
28314,0,26,Peter Sarno,0,1,0,C,2005
28315,13,20,Peter Scamurra,2,58,15,D,1975
28316,2,21,Peter Scamurra,0,21,2,D,1976
28317,5,23,Peter Scamurra,3,30,8,D,1978
28318,5,24,Peter Scamurra,3,23,8,D,1979
28319,4,21,Peter Schaefer,4,25,8,LW,1998
28320,15,22,Peter Schaefer,16,71,31,LW,1999
28321,20,23,Peter Schaefer,16,82,36,LW,2000
28322,17,25,Peter Schaefer,6,75,23,LW,2002
28323,24,26,Peter Schaefer,15,81,39,LW,2003
28324,30,28,Peter Schaefer,20,82,50,LW,2005
28325,34,29,Peter Schaefer,12,77,46,LW,2006
28326,17,30,Peter Schaefer,9,63,26,LW,2007
28327,1,33,Peter Schaefer,1,16,2,LW,2010
28328,0,23,Peter Sejna,1,1,1,LW,2002
28329,2,24,Peter Sejna,2,20,4,LW,2003
28330,1,26,Peter Sejna,1,6,2,LW,2005
28331,1,27,Peter Sejna,3,22,4,LW,2006
28332,12,25,Peter Slater,12,73,24,C,1972
28333,12,25,Peter Slater,12,73,24,C,1972
28334,1,26,Peter Slater,1,19,2,C,1973
28335,1,26,Peter Slater,1,19,2,C,1973
28336,3,21,Peter Smrek,2,20,5,D,2000
28337,1,22,Peter Smrek,0,8,1,D,2001
28338,70,24,Peter Stastny,39,77,109,C,1980
28339,93,25,Peter Stastny,46,80,139,C,1981
28340,77,26,Peter Stastny,47,75,124,C,1982
28341,73,27,Peter Stastny,46,80,119,C,1983
28342,68,28,Peter Stastny,32,75,100,C,1984
28343,81,29,Peter Stastny,41,76,122,C,1985
28344,53,30,Peter Stastny,24,64,77,C,1986
28345,65,31,Peter Stastny,46,76,111,C,1987
28346,50,32,Peter Stastny,35,72,85,C,1988
28347,44,33,Peter Stastny,29,74,73,C,1989
28348,42,34,Peter Stastny,18,77,60,C,1990
28349,38,35,Peter Stastny,24,66,62,C,1991
28350,23,36,Peter Stastny,17,62,40,C,1992
28351,11,37,Peter Stastny,5,17,16,C,1993
28352,1,38,Peter Stastny,1,6,2,C,1994
28353,0,25,Peter Sturgeon,0,2,0,LW,1979
28354,1,26,Peter Sturgeon,0,4,1,LW,1980
28355,39,24,Peter Sullivan,32,78,71,C,1975
28356,39,24,Peter Sullivan,32,78,71,C,1975
28357,52,25,Peter Sullivan,31,78,83,C,1976
28358,52,25,Peter Sullivan,31,78,83,C,1976
28359,39,26,Peter Sullivan,16,77,55,C,1977
28360,39,26,Peter Sullivan,16,77,55,C,1977
28361,40,27,Peter Sullivan,46,80,86,C,1978
28362,40,27,Peter Sullivan,46,80,86,C,1978
28363,35,28,Peter Sullivan,24,79,59,C,1979
28364,19,29,Peter Sullivan,4,47,23,C,1980
28365,22,22,Peter Sundstrom,22,77,44,LW,1983
28366,25,23,Peter Sundstrom,18,76,43,RW,1984
28367,15,24,Peter Sundstrom,8,53,23,LW,1985
28368,17,26,Peter Sundstrom,8,76,25,LW,1987
28369,2,27,Peter Sundstrom,4,35,6,LW,1988
28370,2,28,Peter Sundstrom,1,21,3,LW,1989
28371,0,21,Peter Taglianetti,0,1,0,D,1984
28372,0,22,Peter Taglianetti,0,18,0,D,1985
28373,0,23,Peter Taglianetti,0,3,0,D,1986
28374,17,24,Peter Taglianetti,6,70,23,D,1987
28375,14,25,Peter Taglianetti,1,66,15,D,1988
28376,6,26,Peter Taglianetti,3,49,9,D,1989
28377,9,27,Peter Taglianetti,3,55,12,D,1990
28378,3,28,Peter Taglianetti,1,44,4,D,1991
28379,12,29,Peter Taglianetti,2,72,14,D,1992
28380,12,30,Peter Taglianetti,2,60,14,D,1993
28381,1,31,Peter Taglianetti,0,13,1,D,1994
28382,0,32,Peter Vandermeer,0,2,0,LW,2007
28383,5,23,Peter Wallin,1,12,6,RW,1980
28384,9,24,Peter Wallin,2,40,11,LW,1981
28385,5,24,Peter White,3,26,8,LW,1993
28386,4,25,Peter White,2,9,6,C,1994
28387,3,26,Peter White,5,27,8,C,1995
28388,0,29,Peter White,0,3,0,C,1998
28389,5,30,Peter White,1,21,6,LW,1999
28390,16,31,Peter White,9,77,25,C,2000
28391,3,32,Peter White,3,48,6,C,2001
28392,1,33,Peter White,0,6,1,C,2002
28393,0,34,Peter White,0,3,0,C,2003
28394,0,20,Peter Worrell,0,19,0,LW,1997
28395,5,21,Peter Worrell,4,62,9,LW,1998
28396,6,22,Peter Worrell,3,48,9,LW,1999
28397,7,23,Peter Worrell,3,71,10,LW,2000
28398,5,24,Peter Worrell,4,79,9,LW,2001
28399,3,25,Peter Worrell,2,63,5,LW,2002
28400,1,26,Peter Worrell,3,49,4,LW,2003
28401,46,19,Peter Zezel,15,65,61,C,1984
28402,37,20,Peter Zezel,17,79,54,C,1985
28403,39,21,Peter Zezel,33,71,72,C,1986
28404,35,22,Peter Zezel,22,69,57,C,1987
28405,49,23,Peter Zezel,21,78,70,C,1988
28406,47,24,Peter Zezel,25,73,72,C,1989
28407,19,25,Peter Zezel,21,52,40,C,1990
28408,33,26,Peter Zezel,16,64,49,C,1991
28409,23,27,Peter Zezel,12,70,35,C,1992
28410,8,28,Peter Zezel,8,41,16,C,1993
28411,5,29,Peter Zezel,6,30,11,C,1994
28412,13,30,Peter Zezel,8,57,21,C,1995
28413,12,31,Peter Zezel,4,53,16,C,1996
28414,15,32,Peter Zezel,5,30,20,C,1997
28415,8,33,Peter Zezel,6,41,14,C,1998
28416,2,28,Petr Adamik,0,6,2,RW,1978
28417,0,20,Petr Buzek,0,2,0,D,1997
28418,0,21,Petr Buzek,0,2,0,D,1998
28419,14,22,Petr Buzek,5,63,19,D,1999
28420,0,23,Petr Buzek,0,5,0,D,2000
28421,3,24,Petr Buzek,1,41,4,D,2001
28422,5,25,Petr Buzek,3,44,8,D,2002
28423,29,27,Petr Cajanek,9,51,38,C,2002
28424,14,28,Petr Cajanek,12,70,26,C,2003
28425,31,30,Petr Cajanek,10,71,41,LW,2005
28426,33,31,Petr Cajanek,15,77,48,C,2006
28427,0,21,Petr Hubacek,1,6,1,C,2000
28428,1,19,Petr Kalus,4,9,5,RW,2006
28429,0,22,Petr Kalus,0,2,0,RW,2009
28430,0,21,Petr Kanko,1,10,1,RW,2005
28431,24,21,Petr Klima,32,74,56,LW,1985
28432,23,22,Petr Klima,30,77,53,LW,1986
28433,25,23,Petr Klima,37,78,62,LW,1987
28434,16,24,Petr Klima,25,51,41,LW,1988
28435,33,25,Petr Klima,30,76,63,LW,1989
28436,28,26,Petr Klima,40,70,68,RW,1990
28437,13,27,Petr Klima,21,57,34,RW,1991
28438,16,28,Petr Klima,32,68,48,RW,1992
28439,27,29,Petr Klima,28,75,55,RW,1993
28440,13,30,Petr Klima,13,47,26,LW,1994
28441,30,31,Petr Klima,22,67,52,LW,1995
28442,12,32,Petr Klima,2,33,14,RW,1996
28443,0,34,Petr Klima,1,13,1,LW,1998
28444,27,18,Petr L Svoboda,4,73,31,D,1984
28445,18,19,Petr L Svoboda,1,73,19,D,1985
28446,17,20,Petr L Svoboda,5,70,22,D,1986
28447,22,21,Petr L Svoboda,7,69,29,D,1987
28448,37,22,Petr L Svoboda,8,71,45,D,1988
28449,31,23,Petr L Svoboda,5,60,36,D,1989
28450,22,24,Petr L Svoboda,4,60,26,D,1990
28451,22,25,Petr L Svoboda,6,71,28,D,1991
28452,24,26,Petr L Svoboda,2,40,26,D,1992
28453,14,27,Petr L Svoboda,2,60,16,D,1993
28454,8,28,Petr L Svoboda,0,37,8,D,1994
28455,28,29,Petr L Svoboda,1,73,29,D,1995
28456,12,30,Petr L Svoboda,2,67,14,D,1996
28457,15,31,Petr L Svoboda,3,56,18,D,1997
28458,18,32,Petr L Svoboda,5,59,23,D,1998
28459,23,33,Petr L Svoboda,2,70,25,D,1999
28460,3,34,Petr L Svoboda,1,19,4,D,2000
28461,0,20,Petr Mika,0,3,0,C,1999
28462,6,19,Petr Nedved,10,61,16,C,1990
28463,22,20,Petr Nedved,15,77,37,C,1991
28464,33,21,Petr Nedved,38,84,71,C,1992
28465,14,22,Petr Nedved,6,19,20,C,1993
28466,12,23,Petr Nedved,11,46,23,C,1994
28467,54,24,Petr Nedved,45,80,99,LW,1995
28468,38,25,Petr Nedved,33,74,71,C,1996
28469,27,27,Petr Nedved,20,56,47,C,1998
28470,44,28,Petr Nedved,24,76,68,C,1999
28471,46,29,Petr Nedved,32,79,78,C,2000
28472,25,30,Petr Nedved,21,78,46,C,2001
28473,31,31,Petr Nedved,27,78,58,C,2002
28474,27,32,Petr Nedved,19,81,46,C,2003
28475,18,34,Petr Nedved,7,53,25,C,2005
28476,10,35,Petr Nedved,2,40,12,C,2006
28477,0,20,Petr O Sykora,0,2,0,C,1998
28478,2,27,Petr O Sykora,2,10,4,C,2005
28479,0,22,Petr Prajsler,0,7,0,D,1987
28480,3,23,Petr Prajsler,0,2,3,D,1988
28481,7,24,Petr Prajsler,3,34,10,D,1989
28482,0,26,Petr Prajsler,0,3,0,D,1991
28483,17,23,Petr Prucha,30,68,47,LW,2005
28484,18,24,Petr Prucha,22,79,40,C,2006
28485,10,25,Petr Prucha,7,62,17,LW,2007
28486,13,26,Petr Prucha,6,47,19,LW,2008
28487,9,27,Petr Prucha,13,79,22,C,2009
28488,1,28,Petr Prucha,0,11,1,C,2010
28489,2,20,Petr R Svoboda,1,18,3,D,2000
28490,24,19,Petr R Sykora,18,63,42,C,1995
28491,2,20,Petr R Sykora,1,19,3,C,1996
28492,20,21,Petr R Sykora,16,58,36,C,1997
28493,43,22,Petr R Sykora,29,80,72,C,1998
28494,43,23,Petr R Sykora,25,79,68,C,1999
28495,46,24,Petr R Sykora,35,73,81,RW,2000
28496,27,25,Petr R Sykora,21,73,48,RW,2001
28497,25,26,Petr R Sykora,34,82,59,RW,2002
28498,29,27,Petr R Sykora,23,81,52,RW,2003
28499,28,29,Petr R Sykora,23,74,51,RW,2005
28500,31,30,Petr R Sykora,22,82,53,C,2006
28501,35,31,Petr R Sykora,28,81,63,RW,2007
28502,21,32,Petr R Sykora,25,76,46,RW,2008
28503,1,33,Petr R Sykora,2,14,3,RW,2009
28504,23,35,Petr R Sykora,21,82,44,RW,2011
28505,5,20,Petr Schastlivy,2,13,7,LW,1999
28506,2,21,Petr Schastlivy,3,17,5,LW,2000
28507,1,22,Petr Schastlivy,0,1,1,LW,2001
28508,10,23,Petr Schastlivy,9,33,19,LW,2002
28509,4,24,Petr Schastlivy,4,65,8,LW,2003
28510,2,22,Petr Straka,0,3,2,RW,2014
28511,0,22,Petr Taticek,0,3,0,C,2005
28512,9,23,Petr Tenkrat,5,46,14,RW,2000
28513,16,24,Petr Tenkrat,8,67,24,RW,2001
28514,5,29,Petr Tenkrat,9,64,14,RW,2006
28515,0,23,Petr Vrana,1,16,1,C,2008
28516,5,23,Petri Kontiola,0,12,5,C,2007
28517,14,22,Petri Skriko,21,72,35,LW,1984
28518,40,23,Petri Skriko,38,80,78,LW,1985
28519,41,24,Petri Skriko,33,76,74,LW,1986
28520,34,25,Petri Skriko,30,73,64,LW,1987
28521,36,26,Petri Skriko,30,74,66,LW,1988
28522,33,27,Petri Skriko,15,77,48,LW,1989
28523,18,28,Petri Skriko,9,48,27,LW,1990
28524,3,29,Petri Skriko,3,24,6,LW,1991
28525,3,30,Petri Skriko,4,17,7,LW,1992
28526,0,28,Petri Varis,0,1,0,LW,1997
28527,0,21,Petter Granberg,0,1,0,D,2013
28528,0,22,Petter Granberg,0,7,0,D,2014
28529,2,23,Petter Granberg,0,27,2,D,2015
28530,0,24,Petter Granberg,0,10,0,D,2016
28531,0,23,Petteri Lehto,0,6,0,D,1984
28532,1,21,Petteri Lindbohm,2,23,3,D,2014
28533,0,22,Petteri Lindbohm,0,10,0,D,2015
28534,0,23,Petteri Lindbohm,0,7,0,D,2016
28535,1,20,Petteri Nokelainen,1,15,2,C,2005
28536,3,22,Petteri Nokelainen,7,57,10,C,2007
28537,5,23,Petteri Nokelainen,4,50,9,C,2008
28538,8,24,Petteri Nokelainen,5,67,13,C,2009
28539,4,26,Petteri Nokelainen,3,56,7,C,2011
28540,12,28,Petteri Nummelin,4,61,16,D,2000
28541,17,34,Petteri Nummelin,3,51,20,D,2006
28542,7,35,Petteri Nummelin,2,27,9,D,2007
28543,0,21,Petteri Wirtanen,1,3,1,C,2007
28544,0,28,Petti Lehtonen,0,1,0,RW,1978
28545,1,21,Phil Bourque,0,5,1,D,1983
28546,0,23,Phil Bourque,0,4,0,D,1985
28547,3,24,Phil Bourque,2,22,5,D,1986
28548,12,25,Phil Bourque,4,21,16,D,1987
28549,26,26,Phil Bourque,17,80,43,LW,1988
28550,17,27,Phil Bourque,22,76,39,LW,1989
28551,14,28,Phil Bourque,20,78,34,LW,1990
28552,16,29,Phil Bourque,10,58,26,LW,1991
28553,14,30,Phil Bourque,6,55,20,LW,1992
28554,4,31,Phil Bourque,2,27,6,LW,1993
28555,3,32,Phil Bourque,4,38,7,LW,1994
28556,1,33,Phil Bourque,1,13,2,LW,1995
28557,2,23,Phil Crowe,0,31,2,RW,1993
28558,1,25,Phil Crowe,1,16,2,LW,1995
28559,1,26,Phil Crowe,0,26,1,RW,1996
28560,0,27,Phil Crowe,3,9,3,RW,1997
28561,1,28,Phil Crowe,0,8,1,LW,1998
28562,0,29,Phil Crowe,0,4,0,RW,1999
28563,49,25,Phil Esposito,35,74,84,C,1967
28564,77,26,Phil Esposito,49,74,126,C,1968
28565,56,27,Phil Esposito,43,76,99,C,1969
28566,76,28,Phil Esposito,76,78,152,C,1970
28567,67,29,Phil Esposito,66,76,133,C,1971
28568,75,30,Phil Esposito,55,78,130,C,1972
28569,77,31,Phil Esposito,68,78,145,C,1973
28570,66,32,Phil Esposito,61,79,127,C,1974
28571,48,33,Phil Esposito,35,74,83,C,1975
28572,46,34,Phil Esposito,34,80,80,C,1976
28573,43,35,Phil Esposito,38,79,81,C,1977
28574,36,36,Phil Esposito,42,80,78,C,1978
28575,44,37,Phil Esposito,34,80,78,C,1979
28576,13,38,Phil Esposito,7,41,20,C,1980
28577,40,34,Phil Goyette,25,73,65,C,1967
28578,32,35,Phil Goyette,13,67,45,C,1968
28579,49,36,Phil Goyette,29,72,78,C,1969
28580,46,37,Phil Goyette,15,60,61,C,1970
28581,25,38,Phil Goyette,4,45,29,C,1971
28582,1,23,Phil Hoene,0,4,1,LW,1972
28583,3,24,Phil Hoene,2,31,5,LW,1973
28584,0,25,Phil Hoene,0,2,0,LW,1974
28585,47,18,Phil Housley,19,77,66,D,1982
28586,46,19,Phil Housley,31,75,77,D,1983
28587,53,20,Phil Housley,16,73,69,D,1984
28588,47,21,Phil Housley,15,79,62,D,1985
28589,46,22,Phil Housley,21,78,67,D,1986
28590,37,23,Phil Housley,29,74,66,D,1987
28591,44,24,Phil Housley,26,72,70,D,1988
28592,60,25,Phil Housley,21,80,81,D,1989
28593,53,26,Phil Housley,23,78,76,D,1990
28594,63,27,Phil Housley,23,74,86,D,1991
28595,79,28,Phil Housley,18,80,97,D,1992
28596,15,29,Phil Housley,7,26,22,D,1993
28597,35,30,Phil Housley,8,43,43,D,1994
28598,51,31,Phil Housley,17,81,68,D,1995
28599,29,32,Phil Housley,11,77,40,D,1996
28600,25,33,Phil Housley,6,64,31,D,1997
28601,43,34,Phil Housley,11,79,54,D,1998
28602,44,35,Phil Housley,11,78,55,D,1999
28603,30,36,Phil Housley,4,69,34,D,2000
28604,24,37,Phil Housley,15,80,39,D,2001
28605,23,38,Phil Housley,6,58,29,D,2002
28606,18,19,Phil Kessel,11,70,29,C,2006
28607,18,20,Phil Kessel,19,82,37,RW,2007
28608,24,21,Phil Kessel,36,70,60,RW,2008
28609,25,22,Phil Kessel,30,70,55,C,2009
28610,32,23,Phil Kessel,32,82,64,C,2010
28611,45,24,Phil Kessel,37,82,82,C,2011
28612,32,25,Phil Kessel,20,48,52,C,2012
28613,43,26,Phil Kessel,37,82,80,RW,2013
28614,36,27,Phil Kessel,25,82,61,RW,2014
28615,33,28,Phil Kessel,26,82,59,RW,2015
28616,47,29,Phil Kessel,23,82,70,RW,2016
28617,58,30,Phil Kessel,34,82,92,RW,2017
28618,1,22,Phil Oreskovic,1,10,2,D,2008
28619,1,21,Phil Roberto,0,8,1,RW,1969
28620,7,22,Phil Roberto,14,39,21,RW,1970
28621,15,23,Phil Roberto,15,76,30,RW,1971
28622,22,24,Phil Roberto,20,77,42,RW,1972
28623,1,25,Phil Roberto,1,15,2,RW,1973
28624,29,26,Phil Roberto,13,53,42,RW,1974
28625,22,27,Phil Roberto,8,74,30,RW,1975
28626,9,28,Phil Roberto,4,43,13,RW,1976
28627,20,29,Phil Roberto,8,53,28,RW,1977
28628,20,29,Phil Roberto,8,53,28,RW,1977
28629,19,20,Phil Russell,6,76,25,D,1972
28630,25,21,Phil Russell,10,75,35,D,1973
28631,24,22,Phil Russell,5,80,29,D,1974
28632,29,23,Phil Russell,9,74,38,D,1975
28633,36,24,Phil Russell,9,76,45,D,1976
28634,20,25,Phil Russell,6,57,26,D,1977
28635,29,26,Phil Russell,9,79,38,D,1978
28636,31,27,Phil Russell,5,80,36,D,1979
28637,23,28,Phil Russell,6,80,29,D,1980
28638,25,29,Phil Russell,4,71,29,D,1981
28639,18,30,Phil Russell,13,78,31,D,1982
28640,22,31,Phil Russell,9,76,31,D,1983
28641,16,32,Phil Russell,4,66,20,D,1984
28642,6,33,Phil Russell,4,42,10,D,1985
28643,2,34,Phil Russell,0,6,2,D,1986
28644,0,23,Phil Sykes,2,7,2,LW,1982
28645,0,24,Phil Sykes,0,3,0,LW,1983
28646,15,25,Phil Sykes,17,79,32,RW,1984
28647,24,26,Phil Sykes,20,76,44,LW,1985
28648,15,27,Phil Sykes,6,56,21,LW,1986
28649,12,28,Phil Sykes,9,40,21,LW,1987
28650,1,29,Phil Sykes,0,23,1,LW,1988
28651,6,30,Phil Sykes,9,48,15,LW,1989
28652,10,31,Phil Sykes,12,70,22,LW,1990
28653,2,32,Phil Sykes,4,52,6,LW,1991
28654,0,26,Phil Varone,0,7,0,C,2016
28655,4,26,Phil Von Stefenelli,0,27,4,D,1995
28656,1,27,Phil Von Stefenelli,0,6,1,D,1996
28657,0,26,Philip Holm,0,1,0,D,2017
28658,1,20,Philip Larsen,0,2,1,D,2009
28659,2,21,Philip Larsen,0,6,2,D,2010
28660,8,22,Philip Larsen,3,55,11,D,2011
28661,3,23,Philip Larsen,2,32,5,D,2012
28662,9,24,Philip Larsen,3,30,12,D,2013
28663,5,27,Philip Larsen,1,26,6,D,2016
28664,2,20,Philip McRae,1,15,3,C,2010
28665,0,22,Philip Samuelsson,0,5,0,D,2013
28666,0,23,Philip Samuelsson,0,4,0,D,2014
28667,0,24,Philip Samuelsson,0,4,0,D,2015
28668,1,23,Philip Varone,1,9,2,C,2013
28669,2,24,Philip Varone,3,28,5,C,2014
28670,2,25,Philip Varone,1,6,3,C,2015
28671,0,21,Philippe Audet,0,4,0,LW,1998
28672,4,19,Philippe Boucher,0,18,4,D,1992
28673,8,20,Philippe Boucher,6,38,14,D,1993
28674,4,21,Philippe Boucher,2,15,6,D,1994
28675,16,22,Philippe Boucher,7,53,23,D,1995
28676,18,23,Philippe Boucher,7,60,25,D,1996
28677,10,24,Philippe Boucher,6,45,16,D,1997
28678,6,25,Philippe Boucher,2,45,8,D,1998
28679,0,26,Philippe Boucher,0,1,0,D,1999
28680,4,27,Philippe Boucher,2,22,6,D,2000
28681,23,28,Philippe Boucher,7,80,30,D,2001
28682,20,29,Philippe Boucher,7,80,27,D,2002
28683,16,30,Philippe Boucher,8,70,24,D,2003
28684,27,32,Philippe Boucher,16,66,43,D,2005
28685,32,33,Philippe Boucher,19,76,51,D,2006
28686,12,34,Philippe Boucher,2,38,14,D,2007
28687,6,35,Philippe Boucher,3,41,9,D,2008
28688,3,25,Philippe Bozon,1,9,4,LW,1991
28689,6,26,Philippe Bozon,6,54,12,LW,1992
28690,16,27,Philippe Bozon,9,80,25,C,1993
28691,0,28,Philippe Bozon,0,1,0,LW,1994
28692,1,21,Philippe Cornet,0,2,1,LW,2011
28693,0,23,Philippe Dupuis,0,8,0,C,2008
28694,1,24,Philippe Dupuis,0,4,1,C,2009
28695,11,25,Philippe Dupuis,6,74,17,C,2010
28696,0,26,Philippe Dupuis,0,30,0,C,2011
28697,0,21,Phillip Danault,0,2,0,LW,2014
28698,6,22,Phillip Danault,4,51,10,LW,2015
28699,27,23,Phillip Danault,13,82,40,LW,2016
28700,17,24,Phillip Danault,8,52,25,LW,2017
28701,10,22,Phillip Di Giuseppe,7,41,17,LW,2015
28702,6,23,Phillip Di Giuseppe,1,36,7,LW,2016
28703,8,24,Phillip Di Giuseppe,5,49,13,LW,2017
28704,0,20,Pierre Aubry,0,1,0,C,1980
28705,13,21,Pierre Aubry,10,62,23,C,1981
28706,9,22,Pierre Aubry,7,77,16,C,1982
28707,2,23,Pierre Aubry,5,37,7,LW,1983
28708,2,24,Pierre Aubry,2,25,4,LW,1984
28709,3,22,Pierre Bouchard,0,51,3,D,1970
28710,5,23,Pierre Bouchard,3,60,8,D,1971
28711,7,24,Pierre Bouchard,0,41,7,D,1972
28712,14,25,Pierre Bouchard,1,60,15,D,1973
28713,9,26,Pierre Bouchard,3,79,12,D,1974
28714,11,27,Pierre Bouchard,1,66,12,D,1975
28715,11,28,Pierre Bouchard,4,73,15,D,1976
28716,6,29,Pierre Bouchard,4,59,10,D,1977
28717,0,30,Pierre Bouchard,0,1,0,D,1978
28718,9,31,Pierre Bouchard,5,54,14,D,1979
28719,7,32,Pierre Bouchard,3,50,10,D,1980
28720,0,33,Pierre Bouchard,0,1,0,D,1981
28721,2,22,Pierre Dagenais,3,9,5,RW,2000
28722,4,23,Pierre Dagenais,10,42,14,RW,2001
28723,0,24,Pierre Dagenais,0,9,0,RW,2002
28724,10,25,Pierre Dagenais,17,50,27,RW,2003
28725,7,27,Pierre Dagenais,5,32,12,RW,2005
28726,0,27,Pierre Giroux,1,6,1,C,1982
28727,8,20,Pierre Guite,10,66,18,LW,1972
28728,8,20,Pierre Guite,10,66,18,LW,1972
28729,20,21,Pierre Guite,14,72,34,LW,1973
28730,20,21,Pierre Guite,14,72,34,LW,1973
28731,12,22,Pierre Guite,19,35,31,LW,1974
28732,8,22,Pierre Guite,14,22,22,LW,1974
28733,4,22,Pierre Guite,5,13,9,LW,1974
28734,12,22,Pierre Guite,19,35,31,LW,1974
28735,8,22,Pierre Guite,14,22,22,LW,1974
28736,4,22,Pierre Guite,5,13,9,LW,1974
28737,24,23,Pierre Guite,20,52,44,LW,1975
28738,24,23,Pierre Guite,20,52,44,LW,1975
28739,14,24,Pierre Guite,12,62,26,LW,1976
28740,6,24,Pierre Guite,2,35,8,LW,1976
28741,8,24,Pierre Guite,10,27,18,LW,1976
28742,14,24,Pierre Guite,12,62,26,LW,1976
28743,6,24,Pierre Guite,2,35,8,LW,1976
28744,8,24,Pierre Guite,10,27,18,LW,1976
28745,26,25,Pierre Guite,16,78,42,LW,1977
28746,21,25,Pierre Guite,12,60,33,LW,1977
28747,5,25,Pierre Guite,4,18,9,LW,1977
28748,26,25,Pierre Guite,16,78,42,LW,1977
28749,21,25,Pierre Guite,12,60,33,LW,1977
28750,5,25,Pierre Guite,4,18,9,LW,1977
28751,1,26,Pierre Guite,1,12,2,C,1978
28752,1,26,Pierre Guite,1,12,2,C,1978
28753,1,25,Pierre Hedin,0,3,1,D,2003
28754,3,20,Pierre Henry,2,19,5,LW,1972
28755,3,20,Pierre Henry,2,19,5,LW,1972
28756,7,22,Pierre Jarry,6,52,13,LW,1971
28757,18,23,Pierre Jarry,19,74,37,LW,1972
28758,31,24,Pierre Jarry,17,64,48,LW,1973
28759,13,25,Pierre Jarry,8,39,21,LW,1974
28760,18,26,Pierre Jarry,21,59,39,C,1975
28761,13,27,Pierre Jarry,8,21,21,LW,1976
28762,17,28,Pierre Jarry,9,35,26,LW,1977
28763,10,28,Pierre Jarry,4,18,14,LW,1977
28764,10,28,Pierre Jarry,4,18,14,LW,1977
28765,21,20,Pierre Lacroix,9,76,30,D,1979
28766,34,21,Pierre Lacroix,5,61,39,D,1980
28767,23,22,Pierre Lacroix,4,68,27,D,1981
28768,30,23,Pierre Lacroix,6,69,36,D,1982
28769,4,20,Pierre Lagace,2,17,6,C,1977
28770,4,20,Pierre Lagace,2,17,6,C,1977
28771,1,21,Pierre Lagace,0,21,1,C,1978
28772,1,21,Pierre Lagace,0,21,1,C,1978
28773,37,19,Pierre Larouche,31,79,68,C,1974
28774,58,20,Pierre Larouche,53,76,111,C,1975
28775,34,21,Pierre Larouche,29,65,63,C,1976
28776,37,22,Pierre Larouche,23,64,60,C,1977
28777,13,23,Pierre Larouche,9,36,22,C,1978
28778,41,24,Pierre Larouche,50,73,91,C,1979
28779,28,25,Pierre Larouche,25,61,53,C,1980
28780,37,26,Pierre Larouche,34,67,71,C,1981
28781,22,27,Pierre Larouche,18,38,40,C,1982
28782,33,28,Pierre Larouche,48,77,81,C,1983
28783,36,29,Pierre Larouche,24,65,60,C,1984
28784,7,30,Pierre Larouche,20,28,27,RW,1985
28785,35,31,Pierre Larouche,28,73,63,RW,1986
28786,9,32,Pierre Larouche,3,10,12,C,1987
28787,30,22,Pierre Mondou,19,71,49,C,1977
28788,41,23,Pierre Mondou,31,77,72,C,1978
28789,36,24,Pierre Mondou,30,75,66,C,1979
28790,24,25,Pierre Mondou,17,57,41,C,1980
28791,33,26,Pierre Mondou,35,73,68,C,1981
28792,37,27,Pierre Mondou,29,76,66,C,1982
28793,22,28,Pierre Mondou,15,52,37,C,1983
28794,39,29,Pierre Mondou,18,67,57,C,1984
28795,0,22,Pierre Paiement,1,8,1,D,1972
28796,36,36,Pierre Pilote,1,74,37,D,1967
28797,18,37,Pierre Pilote,3,69,21,D,1968
28798,0,20,Pierre Plante,1,24,1,RW,1971
28799,16,21,Pierre Plante,12,51,28,RW,1972
28800,28,22,Pierre Plante,26,78,54,RW,1973
28801,32,23,Pierre Plante,34,80,66,RW,1974
28802,19,24,Pierre Plante,14,74,33,RW,1975
28803,20,25,Pierre Plante,18,76,38,RW,1976
28804,18,26,Pierre Plante,10,77,28,RW,1977
28805,25,27,Pierre Plante,6,70,31,RW,1978
28806,14,28,Pierre Plante,4,69,18,RW,1979
28807,2,20,Pierre Rioux,1,14,3,RW,1982
28808,12,20,Pierre Roy,7,64,19,D,1972
28809,7,21,Pierre Roy,2,44,9,D,1973
28810,18,22,Pierre Roy,1,61,19,D,1974
28811,18,22,Pierre Roy,1,61,19,D,1974
28812,30,23,Pierre Roy,6,78,36,D,1975
28813,30,23,Pierre Roy,6,78,36,D,1975
28814,17,24,Pierre Roy,6,68,23,D,1976
28815,12,24,Pierre Roy,3,39,15,D,1976
28816,5,24,Pierre Roy,3,29,8,D,1976
28817,17,24,Pierre Roy,6,68,23,D,1976
28818,0,26,Pierre Roy,0,1,0,D,1978
28819,5,22,Pierre Sevigny,4,43,9,LW,1993
28820,0,23,Pierre Sevigny,0,19,0,LW,1994
28821,0,25,Pierre Sevigny,0,13,0,LW,1996
28822,0,26,Pierre Sevigny,0,3,0,LW,1997
28823,28,18,Pierre Turgeon,14,76,42,C,1987
28824,54,19,Pierre Turgeon,34,80,88,C,1988
28825,66,20,Pierre Turgeon,40,80,106,C,1989
28826,47,21,Pierre Turgeon,32,78,79,C,1990
28827,55,22,Pierre Turgeon,40,77,95,C,1991
28828,74,23,Pierre Turgeon,58,83,132,C,1992
28829,56,24,Pierre Turgeon,38,69,94,C,1993
28830,23,25,Pierre Turgeon,24,49,47,C,1994
28831,58,26,Pierre Turgeon,38,80,96,C,1995
28832,59,27,Pierre Turgeon,26,78,85,C,1996
28833,46,28,Pierre Turgeon,22,60,68,C,1997
28834,34,29,Pierre Turgeon,31,67,65,C,1998
28835,40,30,Pierre Turgeon,26,52,66,C,1999
28836,52,31,Pierre Turgeon,30,79,82,C,2000
28837,32,32,Pierre Turgeon,15,66,47,C,2001
28838,30,33,Pierre Turgeon,12,65,42,C,2002
28839,25,34,Pierre Turgeon,15,76,40,C,2003
28840,30,36,Pierre Turgeon,16,62,46,C,2005
28841,3,37,Pierre Turgeon,4,17,7,C,2006
28842,0,21,Pierre Viau,0,4,0,D,1972
28843,0,21,Pierre Viau,0,4,0,D,1972
28844,14,31,Pierre-Alexandre Parenteau,8,56,22,RW,2014
28845,2,25,Pierre-Cedric Labrie,0,14,2,LW,2011
28846,1,26,Pierre-Cedric Labrie,2,19,3,LW,2012
28847,0,27,Pierre-Cedric Labrie,0,13,0,LW,2013
28848,6,29,Pierre-Edouard Bellemare,6,81,12,LW,2014
28849,7,30,Pierre-Edouard Bellemare,7,74,14,LW,2015
28850,4,31,Pierre-Edouard Bellemare,4,82,8,LW,2016
28851,10,32,Pierre-Edouard Bellemare,6,72,16,LW,2017
28852,28,19,Pierre-Luc Dubois,20,82,48,LW,2017
28853,1,23,Pierre-Luc Letourneau-Leblond,0,8,1,RW,2008
28854,2,24,Pierre-Luc Letourneau-Leblond,0,27,2,RW,2009
28855,0,25,Pierre-Luc Letourneau-Leblond,0,2,0,RW,2010
28856,0,26,Pierre-Luc Letourneau-Leblond,0,3,0,RW,2011
28857,0,28,Pierre-Luc Letourneau-Leblond,0,1,0,RW,2013
28858,13,18,Pierre-Marc Bouchard,7,50,20,C,2002
28859,18,19,Pierre-Marc Bouchard,4,61,22,LW,2003
28860,42,21,Pierre-Marc Bouchard,17,80,59,C,2005
28861,37,22,Pierre-Marc Bouchard,20,82,57,C,2006
28862,50,23,Pierre-Marc Bouchard,13,81,63,RW,2007
28863,30,24,Pierre-Marc Bouchard,16,71,46,LW,2008
28864,0,25,Pierre-Marc Bouchard,0,1,0,C,2009
28865,26,26,Pierre-Marc Bouchard,12,59,38,C,2010
28866,13,27,Pierre-Marc Bouchard,9,37,22,C,2011
28867,12,28,Pierre-Marc Bouchard,8,43,20,C,2012
28868,5,29,Pierre-Marc Bouchard,4,28,9,C,2013
28869,19,24,Pit Martin,16,63,35,C,1967
28870,38,25,Pit Martin,23,76,61,C,1968
28871,33,26,Pit Martin,30,73,63,C,1969
28872,33,27,Pit Martin,22,62,55,C,1970
28873,51,28,Pit Martin,24,78,75,C,1971
28874,61,29,Pit Martin,29,78,90,C,1972
28875,47,30,Pit Martin,30,78,77,C,1973
28876,26,31,Pit Martin,19,70,45,C,1974
28877,39,32,Pit Martin,32,80,71,C,1975
28878,36,33,Pit Martin,17,75,53,C,1976
28879,32,34,Pit Martin,16,74,48,RW,1977
28880,14,35,Pit Martin,12,64,26,RW,1978
28881,1,23,Pontus Aberg,1,15,2,LW,2016
28882,12,24,Pontus Aberg,4,53,16,LW,2017
28883,0,24,Poul Popiel,0,1,0,D,1967
28884,13,25,Poul Popiel,2,62,15,D,1968
28885,4,26,Poul Popiel,0,32,4,D,1969
28886,22,27,Poul Popiel,10,78,32,D,1970
28887,1,28,Poul Popiel,1,38,2,D,1971
28888,48,29,Poul Popiel,16,73,64,D,1972
28889,48,29,Poul Popiel,16,73,64,D,1972
28890,41,30,Poul Popiel,7,78,48,D,1973
28891,41,30,Poul Popiel,7,78,48,D,1973
28892,53,31,Poul Popiel,11,78,64,D,1974
28893,53,31,Poul Popiel,11,78,64,D,1974
28894,36,32,Poul Popiel,10,78,46,D,1975
28895,36,32,Poul Popiel,10,78,46,D,1975
28896,56,33,Poul Popiel,12,80,68,D,1976
28897,56,33,Poul Popiel,12,80,68,D,1976
28898,31,34,Poul Popiel,6,80,37,D,1977
28899,31,34,Poul Popiel,6,80,37,D,1977
28900,0,36,Poul Popiel,0,10,0,D,1979
28901,0,25,Prestin Ryan,0,1,0,D,2005
28902,1,24,Quintin Laing,0,3,1,LW,2003
28903,5,28,Quintin Laing,1,39,6,LW,2007
28904,0,29,Quintin Laing,0,1,0,LW,2008
28905,2,30,Quintin Laing,2,36,4,LW,2009
28906,0,21,Quinton Howden,0,18,0,C,2012
28907,2,22,Quinton Howden,4,16,6,C,2013
28908,5,24,Quinton Howden,6,58,11,C,2015
28909,0,25,Quinton Howden,0,5,0,C,2016
28910,18,23,R.J. Umberger,20,73,38,C,2005
28911,12,24,R.J. Umberger,16,81,28,C,2006
28912,37,25,R.J. Umberger,13,74,50,C,2007
28913,20,26,R.J. Umberger,26,82,46,C,2008
28914,32,27,R.J. Umberger,23,82,55,C,2009
28915,32,28,R.J. Umberger,25,82,57,C,2010
28916,20,29,R.J. Umberger,20,77,40,C,2011
28917,10,30,R.J. Umberger,8,48,18,C,2012
28918,16,31,R.J. Umberger,18,74,34,LW,2013
28919,6,32,R.J. Umberger,9,67,15,C,2014
28920,9,33,R.J. Umberger,2,39,11,C,2015
28921,8,19,Radek Bonk,3,42,11,C,1994
28922,19,20,Radek Bonk,16,76,35,LW,1995
28923,13,21,Radek Bonk,5,53,18,C,1996
28924,9,22,Radek Bonk,7,65,16,C,1997
28925,16,23,Radek Bonk,16,81,32,C,1998
28926,37,24,Radek Bonk,23,80,60,C,1999
28927,36,25,Radek Bonk,23,74,59,C,2000
28928,45,26,Radek Bonk,25,82,70,C,2001
28929,32,27,Radek Bonk,22,70,54,C,2002
28930,32,28,Radek Bonk,12,66,44,C,2003
28931,15,30,Radek Bonk,6,61,21,C,2005
28932,10,31,Radek Bonk,13,74,23,C,2006
28933,15,32,Radek Bonk,14,79,29,C,2007
28934,16,33,Radek Bonk,9,66,25,C,2008
28935,14,18,Radek Dvorak,13,77,27,RW,1995
28936,21,19,Radek Dvorak,18,78,39,LW,1996
28937,24,20,Radek Dvorak,12,64,36,LW,1997
28938,24,21,Radek Dvorak,19,82,43,RW,1998
28939,32,22,Radek Dvorak,18,81,50,RW,1999
28940,36,23,Radek Dvorak,31,82,67,RW,2000
28941,20,24,Radek Dvorak,17,65,37,RW,2001
28942,25,25,Radek Dvorak,10,75,35,RW,2002
28943,35,26,Radek Dvorak,15,78,50,RW,2003
28944,20,28,Radek Dvorak,8,64,28,RW,2005
28945,27,29,Radek Dvorak,10,82,37,RW,2006
28946,9,30,Radek Dvorak,8,67,17,RW,2007
28947,21,31,Radek Dvorak,15,81,36,RW,2008
28948,18,32,Radek Dvorak,14,76,32,RW,2009
28949,15,33,Radek Dvorak,7,66,22,RW,2010
28950,17,34,Radek Dvorak,4,73,21,RW,2011
28951,0,35,Radek Dvorak,4,9,4,RW,2012
28952,5,36,Radek Dvorak,4,60,9,RW,2013
28953,7,22,Radek Faksa,5,45,12,C,2015
28954,21,23,Radek Faksa,12,80,33,C,2016
28955,16,24,Radek Faksa,17,79,33,C,2017
28956,0,18,Radek Hamr,0,4,0,D,1992
28957,0,19,Radek Hamr,0,7,0,D,1993
28958,4,25,Radek Martinek,1,23,5,D,2001
28959,11,26,Radek Martinek,2,66,13,D,2002
28960,3,27,Radek Martinek,4,47,7,D,2003
28961,16,29,Radek Martinek,1,74,17,D,2005
28962,15,30,Radek Martinek,2,43,17,D,2006
28963,15,31,Radek Martinek,0,69,15,D,2007
28964,4,32,Radek Martinek,6,51,10,D,2008
28965,1,33,Radek Martinek,2,16,3,D,2009
28966,13,34,Radek Martinek,3,64,16,D,2010
28967,0,35,Radek Martinek,1,7,1,D,2011
28968,0,36,Radek Martinek,3,13,3,D,2012
28969,3,37,Radek Martinek,0,13,3,D,2013
28970,1,22,Radek Smolenak,0,6,1,LW,2008
28971,0,23,Radek Smolenak,0,1,0,LW,2009
28972,0,20,Radim Bicanek,0,6,0,D,1994
28973,1,22,Radim Bicanek,0,21,1,D,1996
28974,0,23,Radim Bicanek,0,1,0,D,1997
28975,0,24,Radim Bicanek,0,14,0,D,1998
28976,3,25,Radim Bicanek,0,11,3,D,1999
28977,2,26,Radim Bicanek,0,9,2,D,2000
28978,5,27,Radim Bicanek,1,60,6,D,2001
28979,12,20,Radim Vrbata,18,52,30,LW,2001
28980,19,21,Radim Vrbata,16,76,35,LW,2002
28981,13,22,Radim Vrbata,12,80,25,RW,2003
28982,24,24,Radim Vrbata,15,61,39,RW,2005
28983,27,25,Radim Vrbata,14,77,41,RW,2006
28984,29,26,Radim Vrbata,27,76,56,RW,2007
28985,3,27,Radim Vrbata,3,18,6,RW,2008
28986,19,28,Radim Vrbata,24,82,43,RW,2009
28987,29,29,Radim Vrbata,19,79,48,RW,2010
28988,27,30,Radim Vrbata,35,77,62,RW,2011
28989,16,31,Radim Vrbata,12,34,28,RW,2012
28990,31,32,Radim Vrbata,20,80,51,RW,2013
28991,32,33,Radim Vrbata,31,79,63,RW,2014
28992,14,34,Radim Vrbata,13,63,27,RW,2015
28993,35,35,Radim Vrbata,20,81,55,RW,2016
28994,9,36,Radim Vrbata,5,42,14,RW,2017
28995,3,22,Radko Gudas,2,22,5,D,2012
28996,19,23,Radko Gudas,3,73,22,D,2013
28997,3,24,Radko Gudas,2,31,5,D,2014
28998,9,25,Radko Gudas,5,76,14,D,2015
28999,17,26,Radko Gudas,6,67,23,D,2016
29000,14,27,Radko Gudas,2,70,16,D,2017
29001,0,28,Radoslav Hecl,0,14,0,D,2002
29002,6,23,Radoslav Suchy,0,60,6,D,1999
29003,10,24,Radoslav Suchy,0,72,10,D,2000
29004,13,25,Radoslav Suchy,4,81,17,D,2001
29005,8,26,Radoslav Suchy,1,77,9,D,2002
29006,14,27,Radoslav Suchy,7,82,21,D,2003
29007,7,29,Radoslav Suchy,1,79,8,D,2005
29008,10,25,Radovan Somik,8,60,18,LW,2002
29009,10,26,Radovan Somik,4,53,14,LW,2003
29010,1,20,Raffi Torres,0,14,1,LW,2001
29011,5,21,Raffi Torres,0,17,5,LW,2002
29012,14,22,Raffi Torres,20,80,34,LW,2003
29013,14,24,Raffi Torres,27,82,41,LW,2005
29014,19,25,Raffi Torres,15,82,34,LW,2006
29015,6,26,Raffi Torres,5,32,11,LW,2007
29016,8,27,Raffi Torres,12,51,20,LW,2008
29017,17,28,Raffi Torres,19,74,36,LW,2009
29018,15,29,Raffi Torres,14,80,29,LW,2010
29019,11,30,Raffi Torres,15,79,26,LW,2011
29020,11,31,Raffi Torres,7,39,18,LW,2012
29021,2,32,Raffi Torres,3,5,5,LW,2013
29022,30,21,Raimo Helminen,10,66,40,C,1985
29023,5,22,Raimo Helminen,2,27,7,C,1986
29024,11,24,Raimo Helminen,1,24,12,C,1988
29025,0,21,Raimo Hirvonen,0,1,0,RW,1978
29026,0,21,Raimo Hirvonen,0,1,0,RW,1978
29027,4,21,Raimo Summanen,1,2,5,LW,1983
29028,4,22,Raimo Summanen,0,9,4,LW,1984
29029,18,23,Raimo Summanen,19,73,37,LW,1985
29030,11,24,Raimo Summanen,14,58,25,LW,1986
29031,3,25,Raimo Summanen,2,9,5,LW,1987
29032,0,27,Raitis Ivanans,0,4,0,D,2005
29033,4,28,Raitis Ivanans,4,66,8,LW,2006
29034,2,29,Raitis Ivanans,6,73,8,LW,2007
29035,0,30,Raitis Ivanans,2,76,2,LW,2008
29036,0,31,Raitis Ivanans,0,61,0,LW,2009
29037,0,32,Raitis Ivanans,0,1,0,LW,2010
29038,0,33,Raitis Ivanans,0,1,0,LW,2011
29039,25,30,Ralph Backstrom,20,70,45,C,1967
29040,28,31,Ralph Backstrom,13,72,41,C,1968
29041,24,32,Ralph Backstrom,19,72,43,C,1969
29042,17,33,Ralph Backstrom,15,49,32,C,1970
29043,29,34,Ralph Backstrom,23,76,52,C,1971
29044,32,35,Ralph Backstrom,26,79,58,C,1972
29045,50,36,Ralph Backstrom,33,78,83,C,1973
29046,50,36,Ralph Backstrom,33,78,83,C,1973
29047,24,37,Ralph Backstrom,15,70,39,C,1974
29048,24,37,Ralph Backstrom,15,70,39,C,1974
29049,48,38,Ralph Backstrom,35,79,83,C,1975
29050,48,38,Ralph Backstrom,35,79,83,C,1975
29051,31,39,Ralph Backstrom,17,77,48,C,1976
29052,31,39,Ralph Backstrom,17,77,48,C,1976
29053,1,25,Ralph Barahona,2,3,3,C,1990
29054,1,26,Ralph Barahona,0,3,1,C,1991
29055,5,21,Ralph Hopiavouri,4,29,9,D,1972
29056,5,21,Ralph Hopiavouri,4,29,9,D,1972
29057,2,22,Ralph Hopiavouri,0,13,2,D,1973
29058,2,22,Ralph Hopiavouri,0,13,2,D,1973
29059,8,23,Ralph Hopiavouri,2,28,10,D,1974
29060,8,23,Ralph Hopiavouri,2,28,10,D,1974
29061,1,21,Ralph Intranuovo,0,1,1,C,1994
29062,2,22,Ralph Intranuovo,1,13,3,C,1995
29063,1,23,Ralph Intranuovo,1,8,2,C,1996
29064,15,20,Ralph Klassen,6,71,21,C,1975
29065,18,21,Ralph Klassen,14,80,32,C,1976
29066,10,22,Ralph Klassen,8,57,18,C,1977
29067,13,23,Ralph Klassen,6,64,19,C,1978
29068,16,24,Ralph Klassen,9,80,25,C,1979
29069,12,25,Ralph Klassen,6,66,18,LW,1980
29070,7,26,Ralph Klassen,3,45,10,LW,1981
29071,2,27,Ralph Klassen,0,29,2,C,1982
29072,0,28,Ralph Klassen,0,5,0,C,1983
29073,0,25,Ralph MacSweyn,0,4,0,D,1967
29074,4,26,Ralph MacSweyn,0,24,4,D,1968
29075,0,27,Ralph MacSweyn,0,17,0,D,1969
29076,1,29,Ralph MacSweyn,0,2,1,D,1971
29077,23,30,Ralph MacSweyn,0,78,23,D,1972
29078,23,30,Ralph MacSweyn,0,78,23,D,1972
29079,21,31,Ralph MacSweyn,2,69,23,D,1973
29080,18,31,Ralph MacSweyn,2,56,20,D,1973
29081,3,31,Ralph MacSweyn,0,13,3,D,1973
29082,21,31,Ralph MacSweyn,2,69,23,D,1973
29083,18,31,Ralph MacSweyn,2,56,20,D,1973
29084,3,31,Ralph MacSweyn,0,13,3,D,1973
29085,1,22,Ralph Stewart,0,3,1,C,1970
29086,10,24,Ralph Stewart,4,31,14,C,1972
29087,20,25,Ralph Stewart,23,67,43,C,1973
29088,24,26,Ralph Stewart,16,70,40,C,1974
29089,7,27,Ralph Stewart,6,31,13,C,1975
29090,8,28,Ralph Stewart,6,34,14,C,1976
29091,3,29,Ralph Stewart,2,16,5,C,1977
29092,0,22,Raman Hrabarenka,0,1,0,D,2014
29093,8,22,Ramzi Abid,10,33,18,LW,2002
29094,2,23,Ramzi Abid,3,16,5,LW,2003
29095,2,25,Ramzi Abid,0,6,2,LW,2005
29096,4,26,Ramzi Abid,1,13,5,LW,2006
29097,0,20,Randy Andreachuk,0,2,0,C,1974
29098,0,20,Randy Andreachuk,0,2,0,C,1974
29099,2,20,Randy Boyd,0,23,2,D,1981
29100,14,21,Randy Boyd,4,56,18,D,1982
29101,5,22,Randy Boyd,0,28,5,D,1983
29102,0,23,Randy Boyd,0,3,0,D,1984
29103,12,24,Randy Boyd,2,55,14,D,1985
29104,17,25,Randy Boyd,7,30,24,D,1986
29105,16,26,Randy Boyd,7,60,23,D,1987
29106,1,27,Randy Boyd,0,2,1,D,1988
29107,2,23,Randy Bucyk,4,17,6,C,1985
29108,0,25,Randy Bucyk,0,2,0,C,1987
29109,25,20,Randy Burridge,17,52,42,LW,1985
29110,4,21,Randy Burridge,1,23,5,LW,1986
29111,28,22,Randy Burridge,27,79,55,LW,1987
29112,30,23,Randy Burridge,31,80,61,LW,1988
29113,15,24,Randy Burridge,17,63,32,LW,1989
29114,13,25,Randy Burridge,15,62,28,LW,1990
29115,44,26,Randy Burridge,23,66,67,LW,1991
29116,0,27,Randy Burridge,0,4,0,LW,1992
29117,17,28,Randy Burridge,25,78,42,LW,1993
29118,15,29,Randy Burridge,4,40,19,LW,1994
29119,33,30,Randy Burridge,25,74,58,LW,1995
29120,21,31,Randy Burridge,10,55,31,LW,1996
29121,6,32,Randy Burridge,4,30,10,LW,1997
29122,5,20,Randy Carlyle,0,45,5,D,1976
29123,11,21,Randy Carlyle,2,49,13,D,1977
29124,34,22,Randy Carlyle,13,70,47,D,1978
29125,28,23,Randy Carlyle,8,67,36,D,1979
29126,67,24,Randy Carlyle,16,76,83,D,1980
29127,64,25,Randy Carlyle,11,73,75,D,1981
29128,41,26,Randy Carlyle,15,61,56,D,1982
29129,26,27,Randy Carlyle,3,55,29,D,1983
29130,38,28,Randy Carlyle,13,71,51,D,1984
29131,33,29,Randy Carlyle,16,68,49,D,1985
29132,26,30,Randy Carlyle,16,71,42,D,1986
29133,44,31,Randy Carlyle,15,78,59,D,1987
29134,38,32,Randy Carlyle,6,78,44,D,1988
29135,15,33,Randy Carlyle,3,53,18,D,1989
29136,19,34,Randy Carlyle,9,52,28,D,1990
29137,9,35,Randy Carlyle,1,66,10,D,1991
29138,1,36,Randy Carlyle,1,22,2,D,1992
29139,0,19,Randy Cunneyworth,0,1,0,C,1980
29140,4,20,Randy Cunneyworth,2,20,6,C,1981
29141,30,24,Randy Cunneyworth,15,75,45,LW,1985
29142,27,25,Randy Cunneyworth,26,79,53,LW,1986
29143,39,26,Randy Cunneyworth,35,71,74,LW,1987
29144,19,27,Randy Cunneyworth,25,70,44,LW,1988
29145,15,28,Randy Cunneyworth,14,71,29,LW,1989
29146,5,29,Randy Cunneyworth,9,32,14,LW,1990
29147,10,30,Randy Cunneyworth,7,39,17,LW,1991
29148,4,31,Randy Cunneyworth,5,39,9,LW,1992
29149,11,32,Randy Cunneyworth,13,79,24,LW,1993
29150,5,33,Randy Cunneyworth,5,48,10,LW,1994
29151,19,34,Randy Cunneyworth,17,81,36,LW,1995
29152,24,35,Randy Cunneyworth,12,76,36,LW,1996
29153,11,36,Randy Cunneyworth,2,71,13,LW,1997
29154,2,37,Randy Cunneyworth,2,14,4,LW,1998
29155,1,19,Randy Gilhen,0,2,1,LW,1982
29156,0,23,Randy Gilhen,0,2,0,C,1986
29157,2,24,Randy Gilhen,3,13,5,C,1987
29158,3,25,Randy Gilhen,5,64,8,C,1988
29159,11,26,Randy Gilhen,5,61,16,C,1989
29160,10,27,Randy Gilhen,15,72,25,C,1990
29161,13,28,Randy Gilhen,10,73,23,C,1991
29162,4,29,Randy Gilhen,3,44,7,C,1992
29163,7,30,Randy Gilhen,7,60,14,C,1993
29164,6,31,Randy Gilhen,5,44,11,RW,1994
29165,3,32,Randy Gilhen,2,22,5,C,1995
29166,22,26,Randy Gregg,6,80,28,D,1982
29167,27,27,Randy Gregg,13,80,40,D,1983
29168,20,28,Randy Gregg,3,57,23,D,1984
29169,26,29,Randy Gregg,2,64,28,D,1985
29170,16,30,Randy Gregg,8,52,24,D,1986
29171,2,31,Randy Gregg,1,15,3,D,1987
29172,15,32,Randy Gregg,3,57,18,D,1988
29173,20,33,Randy Gregg,4,48,24,D,1989
29174,4,35,Randy Gregg,1,21,5,D,1991
29175,3,20,Randy Heath,2,12,5,LW,1984
29176,1,21,Randy Heath,0,1,1,LW,1985
29177,8,21,Randy Hillier,0,25,8,D,1981
29178,10,22,Randy Hillier,0,70,10,D,1982
29179,12,23,Randy Hillier,3,69,15,D,1983
29180,19,24,Randy Hillier,2,45,21,D,1984
29181,3,25,Randy Hillier,0,28,3,D,1985
29182,8,26,Randy Hillier,4,55,12,D,1986
29183,12,27,Randy Hillier,1,55,13,D,1987
29184,23,28,Randy Hillier,1,68,24,D,1988
29185,12,29,Randy Hillier,3,61,15,D,1989
29186,2,30,Randy Hillier,2,31,4,D,1990
29187,1,31,Randy Hillier,0,36,1,D,1991
29188,1,22,Randy Holt,0,12,1,D,1974
29189,0,23,Randy Holt,0,12,0,D,1975
29190,3,24,Randy Holt,0,12,3,D,1976
29191,4,25,Randy Holt,1,54,5,D,1977
29192,9,26,Randy Holt,1,58,10,D,1978
29193,1,27,Randy Holt,0,42,1,D,1979
29194,5,28,Randy Holt,0,48,5,D,1980
29195,6,29,Randy Holt,2,61,8,D,1981
29196,8,30,Randy Holt,0,70,8,D,1982
29197,0,31,Randy Holt,0,26,0,D,1983
29198,0,21,Randy Johnston,0,4,0,D,1979
29199,0,22,Randy Jones,0,5,0,D,2003
29200,8,24,Randy Jones,0,28,8,D,2005
29201,18,25,Randy Jones,4,66,22,D,2006
29202,26,26,Randy Jones,5,71,31,D,2007
29203,4,27,Randy Jones,4,47,8,D,2008
29204,16,28,Randy Jones,5,48,21,D,2009
29205,12,29,Randy Jones,1,61,13,D,2010
29206,1,30,Randy Jones,1,39,2,D,2011
29207,4,22,Randy Ladouceur,0,27,4,D,1982
29208,17,23,Randy Ladouceur,3,71,20,D,1983
29209,27,24,Randy Ladouceur,3,80,30,D,1984
29210,13,25,Randy Ladouceur,5,78,18,D,1985
29211,9,26,Randy Ladouceur,5,70,14,D,1986
29212,7,27,Randy Ladouceur,1,67,8,D,1987
29213,5,28,Randy Ladouceur,2,75,7,D,1988
29214,12,29,Randy Ladouceur,3,71,15,D,1989
29215,3,30,Randy Ladouceur,1,67,4,D,1990
29216,9,31,Randy Ladouceur,1,74,10,D,1991
29217,4,32,Randy Ladouceur,2,62,6,D,1992
29218,9,33,Randy Ladouceur,1,81,10,D,1993
29219,4,34,Randy Ladouceur,2,44,6,D,1994
29220,3,35,Randy Ladouceur,1,63,4,D,1995
29221,2,27,Randy Legge,0,12,2,D,1972
29222,14,29,Randy Legge,1,78,15,D,1974
29223,14,29,Randy Legge,1,78,15,D,1974
29224,8,30,Randy Legge,1,45,9,D,1975
29225,8,30,Randy Legge,1,45,9,D,1975
29226,9,31,Randy Legge,1,69,10,D,1976
29227,9,31,Randy Legge,1,69,10,D,1976
29228,1,28,Randy MacGregor,1,2,2,RW,1981
29229,0,22,Randy Manery,0,2,0,D,1970
29230,0,23,Randy Manery,0,1,0,D,1971
29231,30,24,Randy Manery,5,78,35,D,1972
29232,29,25,Randy Manery,8,78,37,D,1973
29233,27,26,Randy Manery,5,68,32,D,1974
29234,32,27,Randy Manery,7,80,39,D,1975
29235,24,28,Randy Manery,5,73,29,D,1976
29236,27,29,Randy Manery,6,79,33,D,1977
29237,27,30,Randy Manery,8,71,35,D,1978
29238,10,31,Randy Manery,6,52,16,D,1979
29239,0,22,Randy McKay,0,3,0,RW,1988
29240,6,23,Randy McKay,3,33,9,RW,1989
29241,7,24,Randy McKay,1,47,8,RW,1990
29242,16,25,Randy McKay,17,80,33,RW,1991
29243,11,26,Randy McKay,11,73,22,RW,1992
29244,15,27,Randy McKay,12,78,27,RW,1993
29245,7,28,Randy McKay,5,33,12,RW,1994
29246,10,29,Randy McKay,11,76,21,RW,1995
29247,18,30,Randy McKay,9,77,27,RW,1996
29248,24,31,Randy McKay,24,74,48,RW,1997
29249,20,32,Randy McKay,17,70,37,RW,1998
29250,23,33,Randy McKay,16,67,39,RW,1999
29251,20,34,Randy McKay,23,77,43,RW,2000
29252,11,35,Randy McKay,7,69,18,RW,2001
29253,13,36,Randy McKay,6,75,19,RW,2002
29254,12,19,Randy Moller,2,75,14,D,1982
29255,14,20,Randy Moller,4,74,18,D,1983
29256,22,21,Randy Moller,7,79,29,D,1984
29257,18,22,Randy Moller,5,69,23,D,1985
29258,9,23,Randy Moller,5,71,14,D,1986
29259,22,24,Randy Moller,3,66,25,D,1987
29260,22,25,Randy Moller,7,74,29,D,1988
29261,12,26,Randy Moller,1,60,13,D,1989
29262,19,27,Randy Moller,4,61,23,D,1990
29263,9,28,Randy Moller,3,56,12,D,1991
29264,7,29,Randy Moller,2,35,9,D,1992
29265,11,30,Randy Moller,2,78,13,D,1993
29266,3,31,Randy Moller,0,17,3,D,1994
29267,0,24,Randy Murray,0,3,0,D,1969
29268,2,20,Randy Osburn,0,26,2,LW,1972
29269,0,22,Randy Osburn,0,1,0,LW,1974
29270,10,20,Randy Pierce,9,35,19,RW,1977
29271,17,21,Randy Pierce,19,70,36,RW,1978
29272,23,22,Randy Pierce,16,75,39,RW,1979
29273,21,23,Randy Pierce,9,55,30,RW,1980
29274,0,24,Randy Pierce,0,5,0,LW,1981
29275,0,25,Randy Pierce,0,3,0,RW,1982
29276,3,26,Randy Pierce,6,17,9,RW,1983
29277,2,27,Randy Pierce,3,17,5,RW,1984
29278,0,21,Randy Robitaille,0,1,0,C,1996
29279,0,22,Randy Robitaille,0,4,0,C,1997
29280,2,23,Randy Robitaille,0,4,2,C,1998
29281,14,24,Randy Robitaille,11,69,25,C,1999
29282,17,25,Randy Robitaille,9,62,26,C,2000
29283,23,26,Randy Robitaille,14,58,37,RW,2001
29284,14,27,Randy Robitaille,6,51,20,C,2002
29285,26,28,Randy Robitaille,11,69,37,C,2003
29286,28,30,Randy Robitaille,12,67,40,C,2005
29287,29,31,Randy Robitaille,11,78,40,C,2006
29288,19,32,Randy Robitaille,10,68,29,C,2007
29289,1,22,Randy Rota,1,2,2,LW,1972
29290,6,23,Randy Rota,10,58,16,LW,1973
29291,18,24,Randy Rota,15,80,33,LW,1974
29292,14,25,Randy Rota,12,71,26,LW,1975
29293,0,26,Randy Rota,0,1,0,LW,1976
29294,6,26,Randy Rota,9,40,15,LW,1976
29295,6,26,Randy Rota,9,40,15,LW,1976
29296,22,27,Randy Rota,8,53,30,LW,1977
29297,22,27,Randy Rota,8,53,30,LW,1977
29298,5,21,Randy Skarda,0,25,5,D,1989
29299,0,23,Randy Skarda,0,1,0,D,1991
29300,0,20,Randy Smith,0,1,0,C,1985
29301,0,21,Randy Smith,0,2,0,C,1986
29302,0,19,Randy Turnbull,0,1,0,D,1981
29303,0,20,Randy Velischek,0,3,0,D,1982
29304,2,21,Randy Velischek,2,33,4,D,1983
29305,9,22,Randy Velischek,4,52,13,D,1984
29306,7,23,Randy Velischek,2,47,9,D,1985
29307,16,24,Randy Velischek,2,64,18,D,1986
29308,9,25,Randy Velischek,3,51,12,D,1987
29309,14,26,Randy Velischek,4,80,18,D,1988
29310,6,27,Randy Velischek,0,62,6,D,1989
29311,10,28,Randy Velischek,2,79,12,D,1990
29312,3,29,Randy Velischek,2,38,5,D,1991
29313,0,23,Randy Wood,1,6,1,LW,1986
29314,16,24,Randy Wood,22,75,38,LW,1987
29315,13,25,Randy Wood,15,77,28,LW,1988
29316,24,26,Randy Wood,24,74,48,LW,1989
29317,18,27,Randy Wood,24,76,42,RW,1990
29318,18,28,Randy Wood,22,78,40,LW,1991
29319,25,29,Randy Wood,18,82,43,RW,1992
29320,16,30,Randy Wood,22,84,38,LW,1993
29321,11,31,Randy Wood,13,48,24,LW,1994
29322,13,32,Randy Wood,8,76,21,LW,1995
29323,5,33,Randy Wood,6,65,11,LW,1996
29324,2,20,Randy Wyrozub,2,16,4,C,1970
29325,4,21,Randy Wyrozub,3,34,7,C,1971
29326,3,22,Randy Wyrozub,3,45,6,C,1972
29327,1,23,Randy Wyrozub,0,5,1,C,1973
29328,14,25,Randy Wyrozub,11,55,25,C,1975
29329,14,25,Randy Wyrozub,11,55,25,C,1975
29330,13,26,Raphael Diaz,3,59,16,D,2011
29331,13,27,Raphael Diaz,1,23,14,D,2012
29332,13,28,Raphael Diaz,2,63,15,D,2013
29333,2,29,Raphael Diaz,2,56,4,D,2014
29334,0,20,Rasmus Andersson,0,1,0,D,2016
29335,0,21,Rasmus Andersson,0,10,0,D,2017
29336,0,23,Rasmus Rissanen,0,6,0,D,2014
29337,2,19,Rasmus Ristolainen,2,34,4,D,2013
29338,12,20,Rasmus Ristolainen,8,78,20,D,2014
29339,32,21,Rasmus Ristolainen,9,82,41,D,2015
29340,39,22,Rasmus Ristolainen,6,79,45,D,2016
29341,35,23,Rasmus Ristolainen,6,73,41,D,2017
29342,0,23,Ravil Gusmanov,0,4,0,RW,1995
29343,0,27,Ray Adduono,0,2,0,C,1973
29344,0,27,Ray Adduono,0,2,0,C,1973
29345,59,28,Ray Adduono,15,78,74,C,1974
29346,59,28,Ray Adduono,15,78,74,C,1974
29347,67,29,Ray Adduono,23,80,90,C,1975
29348,67,29,Ray Adduono,23,80,90,C,1975
29349,24,30,Ray Adduono,6,53,30,C,1976
29350,19,30,Ray Adduono,4,40,23,C,1976
29351,5,30,Ray Adduono,2,13,7,C,1976
29352,24,30,Ray Adduono,6,53,30,C,1976
29353,19,30,Ray Adduono,4,40,23,C,1976
29354,5,30,Ray Adduono,2,13,7,C,1976
29355,2,31,Ray Adduono,1,8,3,C,1977
29356,2,31,Ray Adduono,1,8,3,C,1977
29357,12,20,Ray Allison,16,64,28,RW,1979
29358,0,21,Ray Allison,1,6,1,RW,1980
29359,37,22,Ray Allison,17,51,54,RW,1981
29360,30,23,Ray Allison,21,67,51,RW,1982
29361,13,24,Ray Allison,8,37,21,RW,1983
29362,1,25,Ray Allison,1,11,2,RW,1984
29363,0,27,Ray Allison,0,2,0,RW,1986
29364,36,30,Ray Clearwater,11,78,47,D,1972
29365,36,30,Ray Clearwater,11,78,47,D,1972
29366,23,31,Ray Clearwater,12,68,35,D,1973
29367,23,31,Ray Clearwater,12,68,35,D,1973
29368,18,32,Ray Clearwater,4,66,22,D,1974
29369,18,32,Ray Clearwater,4,66,22,D,1974
29370,0,34,Ray Clearwater,0,2,0,D,1976
29371,0,34,Ray Clearwater,0,2,0,D,1976
29372,0,22,Ray Cote,0,13,0,C,1983
29373,0,23,Ray Cote,0,2,0,C,1984
29374,25,26,Ray Cullen,28,67,53,C,1967
29375,38,27,Ray Cullen,26,67,64,C,1968
29376,28,28,Ray Cullen,17,74,45,C,1969
29377,21,29,Ray Cullen,12,70,33,C,1970
29378,0,,Ray Delorenzi,0,3,0,RW,1974
29379,0,,Ray Delorenzi,0,3,0,RW,1974
29380,12,,Ray Delorenzi,8,39,20,RW,1975
29381,12,,Ray Delorenzi,8,39,20,RW,1975
29382,17,20,Ray Ferraro,11,44,28,C,1984
29383,47,21,Ray Ferraro,30,76,77,C,1985
29384,32,22,Ray Ferraro,27,80,59,C,1986
29385,29,23,Ray Ferraro,21,68,50,C,1987
29386,35,24,Ray Ferraro,41,80,76,C,1988
29387,29,25,Ray Ferraro,25,79,54,C,1989
29388,21,26,Ray Ferraro,21,76,42,C,1990
29389,40,27,Ray Ferraro,40,80,80,C,1991
29390,13,28,Ray Ferraro,14,46,27,C,1992
29391,32,29,Ray Ferraro,21,82,53,C,1993
29392,21,30,Ray Ferraro,22,47,43,C,1994
29393,31,31,Ray Ferraro,29,76,60,C,1995
29394,21,32,Ray Ferraro,25,81,46,C,1996
29395,9,33,Ray Ferraro,6,40,15,C,1997
29396,18,34,Ray Ferraro,13,65,31,C,1998
29397,25,35,Ray Ferraro,19,81,44,C,1999
29398,47,36,Ray Ferraro,29,81,76,C,2000
29399,23,37,Ray Ferraro,14,76,37,C,2001
29400,2,26,Ray Fortin,0,24,2,D,1967
29401,0,27,Ray Fortin,1,11,1,D,1968
29402,4,28,Ray Fortin,1,57,5,D,1969
29403,10,31,Ray Larose,1,68,11,D,1972
29404,10,31,Ray Larose,1,68,11,D,1972
29405,1,32,Ray Larose,0,18,1,D,1973
29406,1,32,Ray Larose,0,18,1,D,1973
29407,1,22,Ray Macias,0,6,1,D,2008
29408,0,24,Ray Macias,0,2,0,D,2010
29409,0,21,Ray Maluta,0,2,0,D,1975
29410,3,22,Ray Maluta,2,23,5,D,1976
29411,1,22,Ray Markham,1,14,2,C,1979
29412,1,22,Ray McKay,0,9,1,D,1968
29413,0,23,Ray McKay,0,17,0,D,1969
29414,0,24,Ray McKay,0,2,0,D,1970
29415,3,25,Ray McKay,0,39,3,D,1971
29416,0,26,Ray McKay,0,1,0,D,1972
29417,12,27,Ray McKay,2,72,14,D,1973
29418,20,28,Ray McKay,8,69,28,D,1974
29419,20,28,Ray McKay,8,69,28,D,1974
29420,10,29,Ray McKay,3,68,13,D,1975
29421,10,29,Ray McKay,3,68,13,D,1975
29422,10,30,Ray McKay,2,61,12,D,1976
29423,9,30,Ray McKay,2,42,11,D,1976
29424,1,30,Ray McKay,0,19,1,D,1976
29425,10,30,Ray McKay,2,61,12,D,1976
29426,9,30,Ray McKay,2,42,11,D,1976
29427,1,30,Ray McKay,0,19,1,D,1976
29428,4,31,Ray McKay,1,14,5,D,1977
29429,4,31,Ray McKay,1,14,5,D,1977
29430,0,20,Ray Neufeld,1,8,1,RW,1979
29431,10,21,Ray Neufeld,5,52,15,RW,1980
29432,3,22,Ray Neufeld,4,19,7,RW,1981
29433,31,23,Ray Neufeld,26,80,57,RW,1982
29434,42,24,Ray Neufeld,27,80,69,RW,1983
29435,35,25,Ray Neufeld,27,76,62,RW,1984
29436,38,26,Ray Neufeld,25,76,63,RW,1985
29437,18,27,Ray Neufeld,18,80,36,RW,1986
29438,18,28,Ray Neufeld,18,78,36,RW,1987
29439,5,29,Ray Neufeld,6,45,11,LW,1988
29440,0,30,Ray Neufeld,0,1,0,RW,1989
29441,1,23,Ray Podloski,0,8,1,C,1988
29442,1,21,Ray Schultz,0,13,1,D,1997
29443,0,22,Ray Schultz,0,4,0,D,1998
29444,1,23,Ray Schultz,0,9,1,D,1999
29445,2,24,Ray Schultz,0,13,2,D,2000
29446,0,25,Ray Schultz,0,2,0,D,2001
29447,0,26,Ray Schultz,0,4,0,D,2002
29448,27,21,Ray Sheppard,38,74,65,RW,1987
29449,21,22,Ray Sheppard,22,67,43,RW,1988
29450,2,23,Ray Sheppard,4,18,6,RW,1989
29451,23,24,Ray Sheppard,24,59,47,RW,1990
29452,26,25,Ray Sheppard,36,74,62,RW,1991
29453,34,26,Ray Sheppard,32,70,66,RW,1992
29454,41,27,Ray Sheppard,52,82,93,RW,1993
29455,10,28,Ray Sheppard,30,43,40,RW,1994
29456,23,29,Ray Sheppard,37,70,60,RW,1995
29457,31,30,Ray Sheppard,29,68,60,RW,1996
29458,19,31,Ray Sheppard,18,71,37,RW,1997
29459,33,32,Ray Sheppard,25,74,58,RW,1998
29460,10,33,Ray Sheppard,10,47,20,RW,1999
29461,1,23,Ray Staszak,0,4,1,RW,1985
29462,3,19,Ray Whitney,0,2,3,C,1991
29463,6,20,Ray Whitney,4,26,10,C,1992
29464,26,21,Ray Whitney,14,61,40,C,1993
29465,12,22,Ray Whitney,13,39,25,LW,1994
29466,24,23,Ray Whitney,17,60,41,C,1995
29467,2,24,Ray Whitney,0,12,2,LW,1996
29468,32,25,Ray Whitney,33,77,65,LW,1997
29469,38,26,Ray Whitney,26,81,64,C,1998
29470,42,27,Ray Whitney,29,81,71,LW,1999
29471,24,28,Ray Whitney,10,46,34,LW,2000
29472,40,29,Ray Whitney,21,67,61,LW,2001
29473,52,30,Ray Whitney,24,81,76,LW,2002
29474,29,31,Ray Whitney,14,67,43,LW,2003
29475,38,33,Ray Whitney,17,63,55,RW,2005
29476,51,34,Ray Whitney,32,81,83,LW,2006
29477,36,35,Ray Whitney,25,66,61,LW,2007
29478,53,36,Ray Whitney,24,82,77,LW,2008
29479,37,37,Ray Whitney,21,80,58,LW,2009
29480,40,38,Ray Whitney,17,75,57,LW,2010
29481,53,39,Ray Whitney,24,82,77,LW,2011
29482,18,40,Ray Whitney,11,32,29,LW,2012
29483,23,41,Ray Whitney,9,69,32,LW,2013
29484,48,19,Raymond Bourque,17,80,65,D,1979
29485,29,20,Raymond Bourque,27,67,56,D,1980
29486,49,21,Raymond Bourque,17,65,66,D,1981
29487,51,22,Raymond Bourque,22,65,73,D,1982
29488,65,23,Raymond Bourque,31,78,96,D,1983
29489,66,24,Raymond Bourque,20,73,86,D,1984
29490,58,25,Raymond Bourque,19,74,77,D,1985
29491,72,26,Raymond Bourque,23,78,95,D,1986
29492,64,27,Raymond Bourque,17,78,81,D,1987
29493,43,28,Raymond Bourque,18,60,61,D,1988
29494,65,29,Raymond Bourque,19,76,84,D,1989
29495,73,30,Raymond Bourque,21,76,94,D,1990
29496,60,31,Raymond Bourque,21,80,81,D,1991
29497,63,32,Raymond Bourque,19,78,82,D,1992
29498,71,33,Raymond Bourque,20,72,91,D,1993
29499,31,34,Raymond Bourque,12,46,43,D,1994
29500,62,35,Raymond Bourque,20,82,82,D,1995
29501,31,36,Raymond Bourque,19,62,50,D,1996
29502,35,37,Raymond Bourque,13,82,48,D,1997
29503,47,38,Raymond Bourque,10,81,57,D,1998
29504,34,39,Raymond Bourque,18,79,52,D,1999
29505,52,40,Raymond Bourque,7,80,59,D,2000
29506,9,23,Raymond Giroux,0,14,9,D,1999
29507,0,25,Raymond Giroux,0,2,0,D,2001
29508,1,26,Raymond Giroux,0,11,1,D,2002
29509,3,27,Raymond Giroux,0,11,3,D,2003
29510,0,23,Raymond Sawada,1,5,1,RW,2008
29511,0,24,Raymond Sawada,0,5,0,RW,2009
29512,0,25,Raymond Sawada,0,1,0,RW,2010
29513,27,18,Real Cloutier,26,63,53,RW,1974
29514,27,18,Real Cloutier,26,63,53,RW,1974
29515,54,19,Real Cloutier,60,80,114,RW,1975
29516,54,19,Real Cloutier,60,80,114,RW,1975
29517,75,20,Real Cloutier,66,76,141,RW,1976
29518,73,21,Real Cloutier,56,73,129,RW,1977
29519,54,22,Real Cloutier,75,77,129,RW,1978
29520,54,22,Real Cloutier,75,77,129,RW,1978
29521,47,23,Real Cloutier,42,67,89,RW,1979
29522,16,24,Real Cloutier,15,34,31,RW,1980
29523,60,25,Real Cloutier,37,67,97,RW,1981
29524,39,26,Real Cloutier,28,68,67,RW,1982
29525,36,27,Real Cloutier,24,77,60,RW,1983
29526,0,28,Real Cloutier,0,4,0,RW,1984
29527,23,23,Real Lemieux,12,74,35,LW,1967
29528,29,24,Real Lemieux,11,75,40,LW,1968
29529,10,25,Real Lemieux,6,73,16,LW,1969
29530,6,26,Real Lemieux,3,43,9,LW,1970
29531,25,27,Real Lemieux,13,78,38,LW,1971
29532,10,28,Real Lemieux,5,74,15,LW,1972
29533,1,29,Real Lemieux,1,38,2,LW,1973
29534,30,28,Red Berenson,24,74,54,LW,1967
29535,47,29,Red Berenson,35,76,82,C,1968
29536,39,30,Red Berenson,33,67,72,C,1969
29537,38,31,Red Berenson,21,69,59,C,1970
29538,41,32,Red Berenson,28,78,69,C,1971
29539,30,33,Red Berenson,13,78,43,C,1972
29540,42,34,Red Berenson,24,76,66,C,1973
29541,22,35,Red Berenson,15,71,37,C,1974
29542,27,36,Red Berenson,20,72,47,C,1975
29543,28,37,Red Berenson,21,80,49,C,1976
29544,25,38,Red Berenson,13,80,38,C,1977
29545,1,20,Reed Larson,0,14,1,D,1976
29546,41,21,Reed Larson,19,75,60,D,1977
29547,49,22,Reed Larson,18,79,67,D,1978
29548,44,23,Reed Larson,22,80,66,D,1979
29549,31,24,Reed Larson,27,78,58,D,1980
29550,39,25,Reed Larson,21,80,60,D,1981
29551,52,26,Reed Larson,22,80,74,D,1982
29552,39,27,Reed Larson,23,78,62,D,1983
29553,45,28,Reed Larson,17,77,62,D,1984
29554,45,29,Reed Larson,22,80,67,D,1985
29555,24,30,Reed Larson,12,66,36,D,1986
29556,24,31,Reed Larson,10,62,34,D,1987
29557,29,32,Reed Larson,9,54,38,D,1988
29558,0,33,Reed Larson,0,1,0,D,1989
29559,5,24,Reed Low,1,56,6,RW,2000
29560,5,25,Reed Low,0,58,5,RW,2001
29561,4,26,Reed Low,2,79,6,RW,2002
29562,2,27,Reed Low,0,57,2,RW,2003
29563,0,30,Reed Low,0,6,0,RW,2006
29564,4,20,Reg Kerr,0,9,4,LW,1977
29565,24,21,Reg Kerr,16,73,40,LW,1978
29566,8,22,Reg Kerr,9,49,17,LW,1979
29567,30,23,Reg Kerr,30,70,60,C,1980
29568,28,24,Reg Kerr,11,59,39,LW,1981
29569,0,26,Reg Kerr,0,3,0,LW,1983
29570,0,27,Reg Krezanski,0,2,0,D,1974
29571,0,27,Reg Krezanski,0,2,0,D,1974
29572,21,20,Reg Thomas,14,72,35,C,1973
29573,13,21,Reg Thomas,8,50,21,C,1974
29574,17,22,Reg Thomas,23,80,40,C,1975
29575,17,22,Reg Thomas,23,80,40,C,1975
29576,30,23,Reg Thomas,25,79,55,C,1976
29577,30,23,Reg Thomas,25,79,55,C,1976
29578,18,24,Reg Thomas,19,67,37,C,1977
29579,16,24,Reg Thomas,15,49,31,C,1977
29580,2,24,Reg Thomas,4,18,6,C,1977
29581,2,24,Reg Thomas,4,18,6,C,1977
29582,39,25,Reg Thomas,32,80,71,C,1978
29583,39,25,Reg Thomas,32,80,71,C,1978
29584,7,26,Reg Thomas,9,39,16,LW,1979
29585,7,31,Reggie Fleming,17,73,24,LW,1967
29586,12,32,Reggie Fleming,8,72,20,LW,1968
29587,18,33,Reggie Fleming,9,65,27,LW,1969
29588,10,34,Reggie Fleming,6,78,16,LW,1970
29589,45,36,Reggie Fleming,23,75,68,LW,1972
29590,45,36,Reggie Fleming,23,75,68,LW,1972
29591,12,37,Reggie Fleming,2,45,14,RW,1973
29592,12,37,Reggie Fleming,2,45,14,RW,1973
29593,4,20,Reggie Leach,2,23,6,RW,1970
29594,20,21,Reggie Leach,13,73,33,RW,1971
29595,12,22,Reggie Leach,23,76,35,RW,1972
29596,24,23,Reggie Leach,22,78,46,RW,1973
29597,33,24,Reggie Leach,45,80,78,RW,1974
29598,30,25,Reggie Leach,61,80,91,RW,1975
29599,14,26,Reggie Leach,32,77,46,RW,1976
29600,28,27,Reggie Leach,24,72,52,RW,1977
29601,20,28,Reggie Leach,34,76,54,RW,1978
29602,26,29,Reggie Leach,50,76,76,RW,1979
29603,36,30,Reggie Leach,34,79,70,RW,1980
29604,21,31,Reggie Leach,26,66,47,RW,1981
29605,17,32,Reggie Leach,15,78,32,RW,1982
29606,0,20,Reggie Savage,0,1,0,C,1990
29607,3,22,Reggie Savage,2,16,5,C,1992
29608,4,23,Reggie Savage,3,17,7,LW,1993
29609,3,24,Reid Bailey,1,17,4,D,1980
29610,0,25,Reid Bailey,0,10,0,D,1981
29611,0,26,Reid Bailey,0,1,0,D,1982
29612,0,27,Reid Bailey,0,12,0,D,1983
29613,5,20,Reid Boucher,2,23,7,C,2013
29614,0,21,Reid Boucher,1,11,1,C,2014
29615,11,22,Reid Boucher,8,39,19,LW,2015
29616,0,23,Reid Boucher,1,3,1,C,2016
29617,2,24,Reid Boucher,3,20,5,C,2017
29618,0,22,Reid Simpson,0,1,0,LW,1991
29619,0,23,Reid Simpson,0,1,0,LW,1992
29620,0,25,Reid Simpson,0,9,0,LW,1994
29621,5,26,Reid Simpson,1,23,6,LW,1995
29622,4,27,Reid Simpson,0,27,4,LW,1996
29623,2,28,Reid Simpson,3,44,5,LW,1997
29624,4,29,Reid Simpson,5,53,9,LW,1998
29625,0,30,Reid Simpson,1,26,1,LW,1999
29626,1,31,Reid Simpson,2,38,3,LW,2000
29627,1,32,Reid Simpson,6,51,7,LW,2001
29628,1,33,Reid Simpson,0,26,1,LW,2002
29629,0,34,Reid Simpson,0,2,0,LW,2003
29630,0,28,Reijo Lappanen,0,1,0,RW,1978
29631,0,28,Reijo Lappanen,0,1,0,RW,1978
29632,38,21,Reijo Ruotsalainen,18,78,56,D,1981
29633,53,22,Reijo Ruotsalainen,16,77,69,D,1982
29634,39,23,Reijo Ruotsalainen,20,74,59,D,1983
29635,45,24,Reijo Ruotsalainen,28,80,73,D,1984
29636,42,25,Reijo Ruotsalainen,17,80,59,D,1985
29637,8,26,Reijo Ruotsalainen,5,16,13,D,1986
29638,12,29,Reijo Ruotsalainen,3,41,15,D,1989
29639,0,20,Reilly Smith,0,3,0,RW,2011
29640,6,21,Reilly Smith,3,37,9,RW,2012
29641,31,22,Reilly Smith,20,82,51,RW,2013
29642,27,23,Reilly Smith,13,81,40,RW,2014
29643,25,24,Reilly Smith,25,82,50,RW,2015
29644,22,25,Reilly Smith,15,80,37,RW,2016
29645,38,26,Reilly Smith,22,67,60,RW,2017
29646,1,19,Rejean Cloutier,0,3,1,D,1979
29647,1,21,Rejean Cloutier,0,2,1,D,1981
29648,12,20,Rejean Giroux,10,59,22,RW,1972
29649,12,20,Rejean Giroux,10,59,22,RW,1972
29650,6,21,Rejean Giroux,5,12,11,RW,1973
29651,6,21,Rejean Giroux,5,12,11,RW,1973
29652,1,20,Rejean Houle,0,9,1,LW,1969
29653,9,21,Rejean Houle,10,66,19,LW,1970
29654,17,22,Rejean Houle,11,77,28,LW,1971
29655,35,23,Rejean Houle,13,72,48,LW,1972
29656,35,24,Rejean Houle,27,69,62,RW,1973
29657,35,24,Rejean Houle,27,69,62,RW,1973
29658,52,25,Rejean Houle,40,64,92,RW,1974
29659,52,25,Rejean Houle,40,64,92,RW,1974
29660,52,26,Rejean Houle,51,81,103,RW,1975
29661,52,26,Rejean Houle,51,81,103,RW,1975
29662,30,27,Rejean Houle,22,65,52,RW,1976
29663,28,28,Rejean Houle,30,76,58,LW,1977
29664,34,29,Rejean Houle,17,66,51,LW,1978
29665,27,30,Rejean Houle,18,60,45,LW,1979
29666,31,31,Rejean Houle,27,77,58,LW,1980
29667,32,32,Rejean Houle,11,51,43,LW,1981
29668,3,33,Rejean Houle,2,16,5,LW,1982
29669,20,24,Rem Murray,11,82,31,C,1996
29670,9,25,Rem Murray,9,61,18,C,1997
29671,18,26,Rem Murray,21,78,39,LW,1998
29672,5,27,Rem Murray,9,44,14,C,1999
29673,21,28,Rem Murray,15,82,36,LW,2000
29674,19,29,Rem Murray,8,80,27,C,2001
29675,19,30,Rem Murray,12,85,31,LW,2002
29676,9,31,Rem Murray,8,39,17,LW,2003
29677,1,33,Rem Murray,1,9,2,C,2005
29678,6,21,Remi Elie,1,18,7,LW,2016
29679,8,22,Remi Elie,6,72,14,LW,2017
29680,0,20,Remi Royer,0,18,0,D,1998
29681,18,24,Rene Bourque,16,77,34,RW,2005
29682,10,25,Rene Bourque,7,44,17,LW,2006
29683,14,26,Rene Bourque,10,62,24,LW,2007
29684,19,27,Rene Bourque,21,58,40,LW,2008
29685,31,28,Rene Bourque,27,73,58,LW,2009
29686,23,29,Rene Bourque,27,80,50,LW,2010
29687,6,30,Rene Bourque,18,76,24,LW,2011
29688,6,31,Rene Bourque,7,27,13,LW,2012
29689,7,32,Rene Bourque,9,63,16,RW,2013
29690,8,33,Rene Bourque,6,51,14,RW,2014
29691,5,34,Rene Bourque,3,49,8,RW,2015
29692,6,35,Rene Bourque,12,65,18,RW,2016
29693,1,24,Rene Chapdelaine,0,3,1,D,1990
29694,1,25,Rene Chapdelaine,0,16,1,D,1991
29695,0,26,Rene Chapdelaine,0,13,0,D,1992
29696,1,20,Rene Corbet,1,9,2,LW,1993
29697,3,21,Rene Corbet,0,8,3,LW,1994
29698,6,22,Rene Corbet,3,33,9,LW,1995
29699,15,23,Rene Corbet,12,76,27,LW,1996
29700,12,24,Rene Corbet,16,68,28,LW,1997
29701,18,25,Rene Corbet,13,73,31,LW,1998
29702,10,26,Rene Corbet,5,52,15,LW,1999
29703,9,27,Rene Corbet,8,43,17,LW,2000
29704,0,27,Rene Drolet,0,1,0,RW,1971
29705,0,30,Rene Drolet,0,1,0,RW,1974
29706,3,21,Rene Leclerc,2,43,5,RW,1968
29707,8,23,Rene Leclerc,8,44,16,RW,1970
29708,28,25,Rene Leclerc,24,67,52,C,1972
29709,28,25,Rene Leclerc,24,67,52,C,1972
29710,27,26,Rene Leclerc,17,58,44,C,1973
29711,27,26,Rene Leclerc,17,58,44,C,1973
29712,32,27,Rene Leclerc,18,72,50,RW,1974
29713,32,27,Rene Leclerc,18,72,50,RW,1974
29714,38,28,Rene Leclerc,33,82,71,RW,1975
29715,38,28,Rene Leclerc,33,82,71,RW,1975
29716,30,29,Rene Leclerc,25,68,55,RW,1976
29717,30,29,Rene Leclerc,25,68,55,RW,1976
29718,15,30,Rene Leclerc,12,60,27,RW,1977
29719,15,30,Rene Leclerc,12,60,27,RW,1977
29720,7,31,Rene Leclerc,5,45,12,RW,1978
29721,7,31,Rene Leclerc,5,45,12,RW,1978
29722,0,22,Rene Robert,0,5,0,RW,1970
29723,14,23,Rene Robert,13,61,27,RW,1971
29724,43,24,Rene Robert,40,75,83,RW,1972
29725,44,25,Rene Robert,21,76,65,RW,1973
29726,60,26,Rene Robert,40,74,100,RW,1974
29727,52,27,Rene Robert,35,72,87,RW,1975
29728,40,28,Rene Robert,33,80,73,RW,1976
29729,48,29,Rene Robert,25,67,73,RW,1977
29730,40,30,Rene Robert,22,68,62,RW,1978
29731,35,31,Rene Robert,28,69,63,RW,1979
29732,18,32,Rene Robert,14,42,32,RW,1980
29733,24,33,Rene Robert,13,55,37,RW,1981
29734,1,24,Reto Von Arx,3,19,4,LW,2000
29735,0,23,Rey Comeau,0,4,0,C,1971
29736,21,24,Rey Comeau,21,77,42,C,1972
29737,23,25,Rey Comeau,11,78,34,C,1973
29738,20,26,Rey Comeau,14,75,34,C,1974
29739,22,27,Rey Comeau,17,79,39,C,1975
29740,18,28,Rey Comeau,15,80,33,C,1976
29741,22,29,Rey Comeau,10,79,32,C,1977
29742,10,30,Rey Comeau,8,70,18,C,1978
29743,5,31,Rey Comeau,2,22,7,C,1979
29744,0,22,Rhett Rakhshani,0,2,0,RW,2010
29745,0,23,Rhett Rakhshani,0,5,0,RW,2011
29746,3,20,Rhett Warrener,0,28,3,D,1995
29747,9,21,Rhett Warrener,4,62,13,D,1996
29748,4,22,Rhett Warrener,0,79,4,D,1997
29749,7,23,Rhett Warrener,1,61,8,D,1998
29750,3,24,Rhett Warrener,0,61,3,D,1999
29751,16,25,Rhett Warrener,3,77,19,D,2000
29752,5,26,Rhett Warrener,5,65,10,D,2001
29753,9,27,Rhett Warrener,0,50,9,D,2002
29754,14,28,Rhett Warrener,3,77,17,D,2003
29755,3,30,Rhett Warrener,3,61,6,D,2005
29756,6,31,Rhett Warrener,4,62,10,D,2006
29757,3,32,Rhett Warrener,1,31,4,D,2007
29758,2,21,Ric Jackman,1,22,3,D,1999
29759,0,22,Ric Jackman,0,16,0,D,2000
29760,0,23,Ric Jackman,0,2,0,D,2001
29761,2,24,Ric Jackman,0,42,2,D,2002
29762,21,25,Ric Jackman,9,54,30,D,2003
29763,23,27,Ric Jackman,7,64,30,D,2005
29764,10,28,Ric Jackman,2,31,12,D,2006
29765,5,22,Ric Jordan,1,34,6,D,1972
29766,5,22,Ric Jordan,1,34,6,D,1972
29767,3,23,Ric Jordan,0,34,3,D,1973
29768,3,23,Ric Jordan,0,34,3,D,1973
29769,8,24,Ric Jordan,6,56,14,D,1974
29770,7,25,Ric Jordan,4,54,11,D,1975
29771,0,26,Ric Jordan,0,5,0,D,1976
29772,0,26,Ric Jordan,0,5,0,D,1976
29773,3,20,Ric Nattress,1,40,4,D,1982
29774,12,21,Ric Nattress,0,34,12,D,1983
29775,1,22,Ric Nattress,0,5,1,D,1984
29776,20,23,Ric Nattress,4,78,24,D,1985
29777,22,24,Ric Nattress,6,73,28,D,1986
29778,13,25,Ric Nattress,2,63,15,D,1987
29779,8,26,Ric Nattress,1,38,9,D,1988
29780,14,27,Ric Nattress,1,49,15,D,1989
29781,13,28,Ric Nattress,5,58,18,D,1990
29782,19,29,Ric Nattress,2,54,21,D,1991
29783,10,30,Ric Nattress,7,44,17,D,1992
29784,19,20,Ric Seiling,19,80,38,RW,1977
29785,22,21,Ric Seiling,20,78,42,RW,1978
29786,35,22,Ric Seiling,25,80,60,RW,1979
29787,27,23,Ric Seiling,30,74,57,RW,1980
29788,25,24,Ric Seiling,22,57,47,RW,1981
29789,22,25,Ric Seiling,19,75,41,RW,1982
29790,22,26,Ric Seiling,13,78,35,C,1983
29791,15,27,Ric Seiling,16,73,31,RW,1984
29792,13,28,Ric Seiling,12,69,25,RW,1985
29793,8,29,Ric Seiling,3,74,11,RW,1986
29794,1,26,Ricard Persson,2,12,3,D,1995
29795,8,27,Ricard Persson,4,54,12,D,1996
29796,0,28,Ricard Persson,0,1,0,D,1997
29797,12,29,Ricard Persson,1,54,13,D,1998
29798,8,30,Ricard Persson,0,41,8,D,1999
29799,8,31,Ricard Persson,1,33,9,D,2000
29800,7,32,Ricard Persson,2,34,9,D,2001
29801,0,24,Rich Brennan,0,2,0,D,1996
29802,2,25,Rich Brennan,1,11,3,D,1997
29803,3,26,Rich Brennan,1,24,4,D,1998
29804,0,28,Rich Brennan,0,2,0,D,2000
29805,0,29,Rich Brennan,0,4,0,D,2001
29806,1,30,Rich Brennan,0,7,1,D,2002
29807,0,18,Rich Chernomaz,0,2,0,RW,1981
29808,1,20,Rich Chernomaz,2,7,3,RW,1983
29809,2,21,Rich Chernomaz,0,3,2,RW,1984
29810,4,23,Rich Chernomaz,6,25,10,RW,1986
29811,0,24,Rich Chernomaz,1,2,1,RW,1987
29812,0,25,Rich Chernomaz,0,1,0,RW,1988
29813,0,28,Rich Chernomaz,0,11,0,RW,1991
29814,2,22,Rich Clune,0,14,2,LW,2009
29815,5,25,Rich Clune,4,47,9,LW,2012
29816,4,26,Rich Clune,3,58,7,LW,2013
29817,0,27,Rich Clune,0,1,0,LW,2014
29818,4,28,Rich Clune,0,19,4,LW,2015
29819,1,20,Rich Costello,2,10,3,C,1983
29820,1,22,Rich Costello,0,2,1,C,1985
29821,0,24,Rich Dupras,0,2,0,C,1973
29822,0,24,Rich Dupras,0,2,0,C,1973
29823,0,22,Rich Gosselin,0,3,0,C,1978
29824,0,22,Rich Gosselin,0,3,0,C,1978
29825,0,24,Rich Hart,0,4,0,D,1976
29826,0,24,Rich Hart,0,4,0,D,1976
29827,1,21,Rich LeDuc,1,5,2,C,1972
29828,3,22,Rich LeDuc,3,28,6,C,1973
29829,31,23,Rich LeDuc,35,78,66,C,1974
29830,31,23,Rich LeDuc,35,78,66,C,1974
29831,22,24,Rich LeDuc,36,79,58,C,1975
29832,55,25,Rich LeDuc,52,81,107,C,1976
29833,46,26,Rich LeDuc,37,82,83,C,1977
29834,31,26,Rich LeDuc,27,54,58,C,1977
29835,15,26,Rich LeDuc,10,28,25,C,1977
29836,46,26,Rich LeDuc,37,82,83,C,1977
29837,31,26,Rich LeDuc,27,54,58,C,1977
29838,15,26,Rich LeDuc,10,28,25,C,1977
29839,41,27,Rich LeDuc,35,74,76,C,1978
29840,41,27,Rich LeDuc,35,74,76,C,1978
29841,27,28,Rich LeDuc,21,75,48,C,1979
29842,7,29,Rich LeDuc,3,22,10,C,1980
29843,9,20,Rich Lemieux,7,42,16,C,1971
29844,35,21,Rich Lemieux,17,78,52,C,1972
29845,17,22,Rich Lemieux,5,72,22,C,1973
29846,20,23,Rich Lemieux,10,79,30,C,1974
29847,1,24,Rich Lemieux,0,3,1,C,1975
29848,11,25,Rich Lemieux,6,33,17,C,1976
29849,11,25,Rich Lemieux,6,33,17,C,1976
29850,1,20,Rich Nantais,4,18,5,LW,1974
29851,0,21,Rich Nantais,0,5,0,LW,1975
29852,3,22,Rich Nantais,1,40,4,LW,1976
29853,1,24,Rich Peverley,0,13,1,C,2006
29854,5,25,Rich Peverley,5,33,10,C,2007
29855,29,26,Rich Peverley,15,66,44,C,2008
29856,33,27,Rich Peverley,22,82,55,C,2009
29857,23,28,Rich Peverley,18,82,41,C,2010
29858,31,29,Rich Peverley,11,57,42,C,2011
29859,12,30,Rich Peverley,6,47,18,C,2012
29860,23,31,Rich Peverley,7,62,30,C,2013
29861,14,20,Rich Pilon,0,62,14,D,1988
29862,2,21,Rich Pilon,0,14,2,D,1989
29863,4,22,Rich Pilon,1,60,5,D,1990
29864,6,23,Rich Pilon,1,65,7,D,1991
29865,3,24,Rich Pilon,1,44,4,D,1992
29866,4,25,Rich Pilon,1,28,5,D,1993
29867,1,26,Rich Pilon,1,20,2,D,1994
29868,3,27,Rich Pilon,0,27,3,D,1995
29869,4,28,Rich Pilon,1,52,5,D,1996
29870,7,29,Rich Pilon,0,76,7,D,1997
29871,4,30,Rich Pilon,0,52,4,D,1998
29872,6,31,Rich Pilon,0,54,6,D,1999
29873,9,32,Rich Pilon,2,69,11,D,2000
29874,2,33,Rich Pilon,0,8,2,D,2001
29875,21,22,Rich Preston,20,78,41,LW,1974
29876,21,22,Rich Preston,20,78,41,LW,1974
29877,33,23,Rich Preston,22,77,55,RW,1975
29878,33,23,Rich Preston,22,77,55,RW,1975
29879,41,24,Rich Preston,38,80,79,RW,1976
29880,41,24,Rich Preston,38,80,79,RW,1976
29881,25,25,Rich Preston,25,73,50,RW,1977
29882,25,25,Rich Preston,25,73,50,RW,1977
29883,32,26,Rich Preston,28,80,60,RW,1978
29884,32,26,Rich Preston,28,80,60,RW,1978
29885,30,27,Rich Preston,31,80,61,RW,1979
29886,14,28,Rich Preston,7,47,21,RW,1980
29887,28,29,Rich Preston,15,75,43,RW,1981
29888,28,30,Rich Preston,25,79,53,RW,1982
29889,18,31,Rich Preston,10,75,28,RW,1983
29890,15,32,Rich Preston,12,75,27,RW,1984
29891,22,33,Rich Preston,19,76,41,RW,1985
29892,9,34,Rich Preston,8,73,17,RW,1986
29893,20,24,Rich Pumple,21,77,41,C,1972
29894,20,24,Rich Pumple,21,77,41,C,1972
29895,2,25,Rich Pumple,2,17,4,RW,1973
29896,2,25,Rich Pumple,2,17,4,RW,1973
29897,8,26,Rich Pumple,4,34,12,LW,1974
29898,8,26,Rich Pumple,4,34,12,LW,1974
29899,0,19,Rich Sutter,0,4,0,RW,1982
29900,12,20,Rich Sutter,16,75,28,RW,1983
29901,10,21,Rich Sutter,6,56,16,LW,1984
29902,25,22,Rich Sutter,14,78,39,RW,1985
29903,22,23,Rich Sutter,20,74,42,RW,1986
29904,15,24,Rich Sutter,15,80,30,RW,1987
29905,15,25,Rich Sutter,17,75,32,RW,1988
29906,9,26,Rich Sutter,11,74,20,RW,1989
29907,11,27,Rich Sutter,16,77,27,RW,1990
29908,16,28,Rich Sutter,9,77,25,RW,1991
29909,14,29,Rich Sutter,13,84,27,RW,1992
29910,14,30,Rich Sutter,12,83,26,RW,1993
29911,3,31,Rich Sutter,0,37,3,RW,1994
29912,4,20,Richard David,0,14,4,LW,1978
29913,4,20,Richard David,0,14,4,LW,1978
29914,0,21,Richard David,0,10,0,LW,1979
29915,1,23,Richard David,1,5,2,LW,1981
29916,3,24,Richard David,3,16,6,LW,1982
29917,25,29,Richard Farda,6,66,31,C,1974
29918,25,29,Richard Farda,6,66,31,C,1974
29919,35,30,Richard Farda,19,63,54,C,1975
29920,35,30,Richard Farda,19,63,54,C,1975
29921,26,31,Richard Farda,9,48,35,C,1976
29922,26,31,Richard Farda,9,48,35,C,1976
29923,1,20,Richard Grenier,1,10,2,C,1972
29924,9,24,Richard Grenier,11,34,20,C,1976
29925,0,20,Richard Hajdu,0,3,0,RW,1985
29926,0,21,Richard Hajdu,0,2,0,LW,1986
29927,12,19,Richard Kromm,11,53,23,LW,1983
29928,32,20,Richard Kromm,20,73,52,LW,1984
29929,24,21,Richard Kromm,19,77,43,LW,1985
29930,17,22,Richard Kromm,12,70,29,LW,1986
29931,10,23,Richard Kromm,5,71,15,LW,1987
29932,6,24,Richard Kromm,1,20,7,LW,1988
29933,0,26,Richard Kromm,1,6,1,LW,1990
29934,0,27,Richard Kromm,0,1,0,LW,1991
29935,2,28,Richard Kromm,1,1,3,LW,1992
29936,5,22,Richard Lintner,1,33,6,D,1999
29937,5,23,Richard Lintner,3,50,8,D,2000
29938,2,25,Richard Lintner,4,29,6,D,2002
29939,3,19,Richard Matvichuk,2,53,5,D,1992
29940,3,20,Richard Matvichuk,0,25,3,D,1993
29941,2,21,Richard Matvichuk,0,14,2,D,1994
29942,16,22,Richard Matvichuk,6,73,22,D,1995
29943,7,23,Richard Matvichuk,5,57,12,D,1996
29944,15,24,Richard Matvichuk,3,74,18,D,1997
29945,9,25,Richard Matvichuk,3,64,12,D,1998
29946,21,26,Richard Matvichuk,4,70,25,D,1999
29947,16,27,Richard Matvichuk,4,78,20,D,2000
29948,12,28,Richard Matvichuk,9,82,21,D,2001
29949,5,29,Richard Matvichuk,1,68,6,D,2002
29950,20,30,Richard Matvichuk,1,75,21,D,2003
29951,10,32,Richard Matvichuk,1,62,11,D,2005
29952,0,33,Richard Matvichuk,0,1,0,D,2006
29953,0,20,Richard Mulhern,1,12,1,D,1975
29954,32,21,Richard Mulhern,12,79,44,D,1976
29955,23,22,Richard Mulhern,9,79,32,D,1977
29956,21,23,Richard Mulhern,5,73,26,D,1978
29957,13,24,Richard Mulhern,0,41,13,D,1979
29958,4,25,Richard Mulhern,0,19,4,D,1980
29959,4,21,Richard Panik,5,25,9,RW,2012
29960,10,22,Richard Panik,3,50,13,RW,2013
29961,6,23,Richard Panik,11,76,17,RW,2014
29962,2,24,Richard Panik,6,30,8,RW,2015
29963,22,25,Richard Panik,22,82,44,RW,2016
29964,11,26,Richard Panik,8,35,19,RW,2017
29965,1,18,Richard Park,0,1,1,C,1994
29966,6,19,Richard Park,4,56,10,C,1995
29967,1,20,Richard Park,1,12,2,C,1996
29968,2,21,Richard Park,0,15,2,C,1997
29969,0,22,Richard Park,0,7,0,C,1998
29970,15,25,Richard Park,10,63,25,RW,2001
29971,10,26,Richard Park,14,81,24,RW,2002
29972,12,27,Richard Park,13,73,25,RW,2003
29973,10,29,Richard Park,8,60,18,C,2005
29974,16,30,Richard Park,10,82,26,RW,2006
29975,20,31,Richard Park,12,82,32,RW,2007
29976,17,32,Richard Park,14,71,31,RW,2008
29977,22,33,Richard Park,9,81,31,C,2009
29978,7,35,Richard Park,7,54,14,C,2011
29979,0,23,Richard Petiot,0,2,0,D,2005
29980,3,26,Richard Petiot,0,11,3,D,2008
29981,0,28,Richard Petiot,0,2,0,D,2010
29982,0,23,Richard Scott,0,5,0,LW,2001
29983,0,25,Richard Scott,0,5,0,LW,2003
29984,27,23,Richard Smehlik,4,80,31,D,1992
29985,27,24,Richard Smehlik,14,84,41,D,1993
29986,7,25,Richard Smehlik,4,39,11,D,1994
29987,19,27,Richard Smehlik,11,62,30,D,1996
29988,17,28,Richard Smehlik,3,72,20,D,1997
29989,11,29,Richard Smehlik,3,72,14,D,1998
29990,9,30,Richard Smehlik,2,64,11,D,1999
29991,12,31,Richard Smehlik,3,56,15,D,2000
29992,6,32,Richard Smehlik,3,60,9,D,2001
29993,11,33,Richard Smehlik,2,55,13,D,2002
29994,0,20,Richard Zednik,0,1,0,LW,1995
29995,1,21,Richard Zednik,2,11,3,LW,1996
29996,9,22,Richard Zednik,17,65,26,RW,1997
29997,8,23,Richard Zednik,9,49,17,LW,1998
29998,16,24,Richard Zednik,19,69,35,LW,1999
29999,25,25,Richard Zednik,19,74,44,RW,2000
30000,22,26,Richard Zednik,22,82,44,RW,2001
30001,19,27,Richard Zednik,31,80,50,RW,2002
30002,24,28,Richard Zednik,26,81,50,LW,2003
30003,14,30,Richard Zednik,16,67,30,RW,2005
30004,14,31,Richard Zednik,7,42,21,LW,2006
30005,11,32,Richard Zednik,15,54,26,LW,2007
30006,16,33,Richard Zednik,17,70,33,RW,2008
30007,2,23,Richard Zemlak,0,20,2,C,1986
30008,4,24,Richard Zemlak,1,54,5,RW,1987
30009,0,25,Richard Zemlak,0,34,0,RW,1988
30010,5,26,Richard Zemlak,1,19,6,RW,1989
30011,1,28,Richard Zemlak,0,5,1,RW,1991
30012,3,20,Richie Dunn,0,25,3,D,1977
30013,3,21,Richie Dunn,0,24,3,D,1978
30014,31,22,Richie Dunn,7,80,38,D,1979
30015,42,23,Richie Dunn,7,79,49,D,1980
30016,19,24,Richie Dunn,7,72,26,D,1981
30017,11,25,Richie Dunn,3,80,14,D,1982
30018,20,26,Richie Dunn,5,63,25,D,1983
30019,4,27,Richie Dunn,1,13,5,D,1984
30020,5,28,Richie Dunn,4,29,9,D,1985
30021,1,29,Richie Dunn,0,2,1,D,1986
30022,0,30,Richie Dunn,2,12,2,D,1987
30023,1,31,Richie Dunn,0,4,1,D,1988
30024,0,21,Richie Hansen,1,4,1,C,1976
30025,0,22,Richie Hansen,0,2,0,C,1977
30026,6,23,Richie Hansen,1,12,7,C,1978
30027,2,26,Richie Hansen,0,2,2,C,1981
30028,2,23,Richie Regehr,0,14,2,D,2005
30029,1,24,Richie Regehr,1,6,2,D,2006
30030,0,21,Rick Adduono,0,1,0,C,1975
30031,33,24,Rick Adduono,20,80,53,C,1978
30032,0,25,Rick Adduono,0,3,0,C,1979
30033,0,22,Rick Bennett,1,6,1,LW,1989
30034,0,23,Rick Bennett,0,6,0,LW,1990
30035,1,24,Rick Bennett,0,3,1,LW,1991
30036,4,22,Rick Berry,0,19,4,D,2000
30037,2,23,Rick Berry,0,70,2,D,2001
30038,1,24,Rick Berry,2,43,3,D,2002
30039,6,25,Rick Berry,0,65,6,D,2003
30040,31,20,Rick Blight,25,74,56,RW,1975
30041,40,21,Rick Blight,28,78,68,RW,1976
30042,38,22,Rick Blight,25,80,63,RW,1977
30043,10,23,Rick Blight,5,56,15,RW,1978
30044,6,24,Rick Blight,12,33,18,RW,1979
30045,0,25,Rick Blight,1,3,1,RW,1980
30046,0,27,Rick Blight,0,2,0,RW,1982
30047,1,23,Rick Boh,2,8,3,C,1987
30048,0,20,Rick Bourbonnais,0,7,0,RW,1975
30049,8,21,Rick Bourbonnais,6,33,14,RW,1976
30050,7,22,Rick Bourbonnais,3,31,10,RW,1977
30051,0,21,Rick Bowness,0,5,0,RW,1975
30052,4,22,Rick Bowness,0,28,4,RW,1976
30053,11,23,Rick Bowness,8,61,19,RW,1977
30054,3,24,Rick Bowness,1,24,4,RW,1978
30055,2,25,Rick Bowness,1,10,3,RW,1979
30056,17,26,Rick Bowness,8,45,25,RW,1980
30057,10,24,Rick Bragnalo,2,19,12,C,1975
30058,12,25,Rick Bragnalo,11,80,23,C,1976
30059,13,26,Rick Bragnalo,2,44,15,C,1977
30060,0,27,Rick Bragnalo,0,2,0,C,1978
30061,0,20,Rick Chartraw,0,12,0,D,1974
30062,3,21,Rick Chartraw,1,16,4,D,1975
30063,4,22,Rick Chartraw,3,43,7,D,1976
30064,12,23,Rick Chartraw,4,68,16,D,1977
30065,11,24,Rick Chartraw,5,62,16,D,1978
30066,7,25,Rick Chartraw,5,66,12,D,1979
30067,6,26,Rick Chartraw,1,35,7,D,1980
30068,8,27,Rick Chartraw,2,33,10,D,1981
30069,7,28,Rick Chartraw,5,57,12,D,1982
30070,6,29,Rick Chartraw,2,28,8,D,1983
30071,1,20,Rick Chinnick,0,1,1,RW,1973
30072,1,21,Rick Chinnick,0,3,1,RW,1974
30073,32,21,Rick Cunningham,9,78,41,D,1972
30074,19,22,Rick Cunningham,2,75,21,D,1973
30075,18,23,Rick Cunningham,7,71,25,D,1974
30076,18,23,Rick Cunningham,7,71,25,D,1974
30077,14,24,Rick Cunningham,5,36,19,D,1975
30078,14,24,Rick Cunningham,5,36,19,D,1975
30079,8,25,Rick Cunningham,0,63,8,D,1976
30080,8,25,Rick Cunningham,0,63,8,D,1976
30081,1,24,Rick Dudley,0,6,1,LW,1972
30082,13,25,Rick Dudley,13,67,26,LW,1973
30083,39,26,Rick Dudley,31,78,70,LW,1974
30084,38,27,Rick Dudley,43,74,81,RW,1975
30085,38,27,Rick Dudley,43,74,81,RW,1975
30086,47,28,Rick Dudley,41,77,88,LW,1976
30087,47,28,Rick Dudley,41,77,88,LW,1976
30088,41,29,Rick Dudley,30,72,71,LW,1977
30089,41,29,Rick Dudley,30,72,71,LW,1977
30090,6,30,Rick Dudley,5,24,11,LW,1978
30091,20,30,Rick Dudley,17,47,37,LW,1978
30092,20,30,Rick Dudley,17,47,37,LW,1978
30093,22,31,Rick Dudley,11,66,33,LW,1979
30094,18,32,Rick Dudley,15,68,33,LW,1980
30095,1,25,Rick Foley,0,2,1,D,1970
30096,25,26,Rick Foley,11,58,36,D,1971
30097,0,28,Rick Foley,0,7,0,D,1973
30098,2,30,Rick Foley,1,11,3,D,1975
30099,2,30,Rick Foley,1,11,3,D,1975
30100,0,20,Rick Fraser,0,4,0,D,1974
30101,0,20,Rick Fraser,0,4,0,D,1974
30102,12,20,Rick Green,3,45,15,D,1976
30103,14,21,Rick Green,5,60,19,D,1977
30104,33,22,Rick Green,8,71,41,D,1978
30105,20,23,Rick Green,4,71,24,D,1979
30106,23,24,Rick Green,8,65,31,D,1980
30107,25,25,Rick Green,3,65,28,D,1981
30108,24,26,Rick Green,2,66,26,D,1982
30109,1,27,Rick Green,0,7,1,D,1983
30110,18,28,Rick Green,1,77,19,D,1984
30111,2,29,Rick Green,3,46,5,D,1985
30112,9,30,Rick Green,1,72,10,D,1986
30113,11,31,Rick Green,2,59,13,D,1987
30114,14,32,Rick Green,1,72,15,D,1988
30115,14,34,Rick Green,2,65,16,D,1990
30116,0,35,Rick Green,0,4,0,D,1991
30117,17,18,Rick Hampton,8,78,25,D,1974
30118,37,19,Rick Hampton,14,73,51,D,1975
30119,24,20,Rick Hampton,16,57,40,LW,1976
30120,18,21,Rick Hampton,18,77,36,D,1977
30121,17,22,Rick Hampton,3,49,20,D,1978
30122,0,23,Rick Hampton,0,3,0,D,1979
30123,0,24,Rick Hayward,0,4,0,D,1990
30124,0,23,Rick Hodgson,0,6,0,D,1979
30125,3,20,Rick Jodzio,1,44,4,LW,1974
30126,3,20,Rick Jodzio,1,44,4,LW,1974
30127,7,21,Rick Jodzio,10,47,17,LW,1975
30128,7,21,Rick Jodzio,10,47,17,LW,1975
30129,6,22,Rick Jodzio,4,46,10,LW,1976
30130,6,22,Rick Jodzio,4,46,10,LW,1976
30131,8,23,Rick Jodzio,2,70,10,LW,1977
30132,8,20,Rick Kehoe,8,38,16,RW,1971
30133,42,21,Rick Kehoe,33,77,75,RW,1972
30134,22,22,Rick Kehoe,18,69,40,RW,1973
30135,31,23,Rick Kehoe,32,76,63,RW,1974
30136,47,24,Rick Kehoe,29,71,76,RW,1975
30137,27,25,Rick Kehoe,30,80,57,RW,1976
30138,21,26,Rick Kehoe,29,70,50,RW,1977
30139,18,27,Rick Kehoe,27,57,45,RW,1978
30140,30,28,Rick Kehoe,30,79,60,RW,1979
30141,33,29,Rick Kehoe,55,80,88,RW,1980
30142,52,30,Rick Kehoe,33,71,85,RW,1981
30143,36,31,Rick Kehoe,29,75,65,RW,1982
30144,27,32,Rick Kehoe,18,57,45,RW,1983
30145,2,33,Rick Kehoe,0,6,2,RW,1984
30146,2,20,Rick Kessell,1,8,3,C,1969
30147,2,21,Rick Kessell,0,6,2,C,1970
30148,1,22,Rick Kessell,0,3,1,C,1971
30149,13,23,Rick Kessell,1,67,14,C,1972
30150,6,24,Rick Kessell,2,51,8,C,1973
30151,0,20,Rick Lalonde,0,2,0,D,1975
30152,0,20,Rick Lalonde,0,2,0,D,1975
30153,22,19,Rick Lanz,7,76,29,D,1980
30154,11,20,Rick Lanz,3,39,14,D,1981
30155,38,21,Rick Lanz,10,74,48,D,1982
30156,39,22,Rick Lanz,18,79,57,D,1983
30157,17,23,Rick Lanz,2,57,19,D,1984
30158,38,24,Rick Lanz,15,75,53,D,1985
30159,25,25,Rick Lanz,3,61,28,D,1986
30160,22,26,Rick Lanz,6,75,28,D,1987
30161,9,27,Rick Lanz,1,32,10,D,1988
30162,0,30,Rick Lanz,0,1,0,D,1991
30163,23,20,Rick Lapointe,10,80,33,D,1975
30164,19,21,Rick Lapointe,3,71,22,D,1976
30165,16,22,Rick Lapointe,4,47,20,D,1977
30166,18,23,Rick Lapointe,3,77,21,D,1978
30167,19,24,Rick Lapointe,6,80,25,D,1979
30168,25,25,Rick Lapointe,8,80,33,D,1980
30169,20,26,Rick Lapointe,2,71,22,D,1981
30170,9,27,Rick Lapointe,2,43,11,D,1982
30171,10,28,Rick Lapointe,2,22,12,D,1983
30172,13,29,Rick Lapointe,4,73,17,D,1984
30173,4,30,Rick Lapointe,0,20,4,D,1985
30174,1,21,Rick Lessard,0,6,1,D,1988
30175,1,23,Rick Lessard,0,1,1,D,1990
30176,2,24,Rick Lessard,0,8,2,D,1991
30177,11,20,Rick Ley,1,38,12,D,1968
30178,13,21,Rick Ley,2,48,15,D,1969
30179,16,22,Rick Ley,4,76,20,D,1970
30180,14,23,Rick Ley,1,67,15,D,1971
30181,27,24,Rick Ley,3,76,30,D,1972
30182,27,24,Rick Ley,3,76,30,D,1972
30183,35,25,Rick Ley,6,72,41,D,1973
30184,35,25,Rick Ley,6,72,41,D,1973
30185,36,26,Rick Ley,6,62,42,D,1974
30186,36,26,Rick Ley,6,62,42,D,1974
30187,30,27,Rick Ley,8,67,38,D,1975
30188,30,27,Rick Ley,8,67,38,D,1975
30189,21,28,Rick Ley,2,55,23,D,1976
30190,21,28,Rick Ley,2,55,23,D,1976
30191,41,29,Rick Ley,3,73,44,D,1977
30192,41,29,Rick Ley,3,73,44,D,1977
30193,20,30,Rick Ley,7,73,27,D,1978
30194,20,30,Rick Ley,7,73,27,D,1978
30195,16,31,Rick Ley,4,65,20,D,1979
30196,2,32,Rick Ley,0,16,2,D,1980
30197,4,21,Rick MacLeish,2,26,6,LW,1970
30198,2,22,Rick MacLeish,1,17,3,C,1971
30199,50,23,Rick MacLeish,50,78,100,C,1972
30200,45,24,Rick MacLeish,32,78,77,C,1973
30201,41,25,Rick MacLeish,38,80,79,C,1974
30202,23,26,Rick MacLeish,22,51,45,C,1975
30203,48,27,Rick MacLeish,49,79,97,C,1976
30204,39,28,Rick MacLeish,31,76,70,LW,1977
30205,32,29,Rick MacLeish,26,71,58,LW,1978
30206,35,30,Rick MacLeish,31,78,66,LW,1979
30207,36,31,Rick MacLeish,38,78,74,LW,1980
30208,28,32,Rick MacLeish,19,74,47,LW,1981
30209,5,33,Rick MacLeish,0,6,5,LW,1982
30210,22,34,Rick MacLeish,10,54,32,C,1983
30211,30,20,Rick Martin,44,73,74,LW,1971
30212,36,21,Rick Martin,37,75,73,LW,1972
30213,34,22,Rick Martin,52,78,86,LW,1973
30214,43,23,Rick Martin,52,68,95,LW,1974
30215,37,24,Rick Martin,49,80,86,LW,1975
30216,29,25,Rick Martin,36,66,65,LW,1976
30217,35,26,Rick Martin,28,65,63,LW,1977
30218,21,27,Rick Martin,32,73,53,LW,1978
30219,34,28,Rick Martin,45,80,79,LW,1979
30220,15,29,Rick Martin,8,24,23,LW,1980
30221,3,30,Rick Martin,1,3,4,LW,1981
30222,0,23,Rick McCann,0,3,0,C,1967
30223,0,24,Rick McCann,0,3,0,C,1968
30224,1,25,Rick McCann,0,18,1,C,1969
30225,0,26,Rick McCann,0,5,0,C,1970
30226,0,27,Rick McCann,0,1,0,C,1971
30227,3,30,Rick McCann,1,13,4,C,1974
30228,0,26,Rick Meagher,0,2,0,C,1979
30229,10,27,Rick Meagher,7,27,17,C,1980
30230,19,28,Rick Meagher,24,65,43,C,1981
30231,14,29,Rick Meagher,15,61,29,C,1982
30232,14,30,Rick Meagher,14,52,28,C,1983
30233,20,31,Rick Meagher,11,71,31,C,1984
30234,19,32,Rick Meagher,11,79,30,C,1985
30235,21,33,Rick Meagher,18,80,39,C,1986
30236,16,34,Rick Meagher,18,76,34,C,1987
30237,14,35,Rick Meagher,15,78,29,C,1988
30238,17,36,Rick Meagher,8,76,25,C,1989
30239,1,37,Rick Meagher,3,24,4,C,1990
30240,18,21,Rick Middleton,22,47,40,RW,1974
30241,26,22,Rick Middleton,24,77,50,RW,1975
30242,22,23,Rick Middleton,20,72,42,RW,1976
30243,35,24,Rick Middleton,25,79,60,RW,1977
30244,48,25,Rick Middleton,38,71,86,RW,1978
30245,52,26,Rick Middleton,40,80,92,RW,1979
30246,59,27,Rick Middleton,44,80,103,RW,1980
30247,43,28,Rick Middleton,51,75,94,RW,1981
30248,47,29,Rick Middleton,49,80,96,RW,1982
30249,58,30,Rick Middleton,47,80,105,RW,1983
30250,46,31,Rick Middleton,30,80,76,RW,1984
30251,30,32,Rick Middleton,14,49,44,RW,1985
30252,37,33,Rick Middleton,31,76,68,RW,1986
30253,19,34,Rick Middleton,13,59,32,RW,1987
30254,17,26,Rick Morris,31,76,48,LW,1972
30255,17,26,Rick Morris,31,76,48,LW,1972
30256,16,27,Rick Morris,17,76,33,LW,1973
30257,16,27,Rick Morris,17,76,33,LW,1973
30258,13,28,Rick Morris,15,78,28,LW,1974
30259,13,28,Rick Morris,15,78,28,LW,1974
30260,21,29,Rick Morris,20,74,41,LW,1975
30261,21,29,Rick Morris,20,74,41,LW,1975
30262,17,30,Rick Morris,18,79,35,LW,1976
30263,17,30,Rick Morris,18,79,35,LW,1976
30264,6,31,Rick Morris,1,30,7,LW,1977
30265,5,31,Rick Morris,0,25,5,LW,1977
30266,1,31,Rick Morris,1,5,2,LW,1977
30267,6,31,Rick Morris,1,30,7,LW,1977
30268,5,31,Rick Morris,0,25,5,LW,1977
30269,1,31,Rick Morris,1,5,2,LW,1977
30270,0,28,Rick Mrozik,0,2,0,D,2002
30271,22,18,Rick Nash,17,74,39,LW,2002
30272,16,19,Rick Nash,41,80,57,LW,2003
30273,23,21,Rick Nash,31,54,54,LW,2005
30274,30,22,Rick Nash,27,75,57,LW,2006
30275,31,23,Rick Nash,38,80,69,LW,2007
30276,39,24,Rick Nash,40,78,79,LW,2008
30277,34,25,Rick Nash,33,76,67,LW,2009
30278,34,26,Rick Nash,32,75,66,LW,2010
30279,29,27,Rick Nash,30,82,59,LW,2011
30280,21,28,Rick Nash,21,44,42,LW,2012
30281,13,29,Rick Nash,26,65,39,LW,2013
30282,27,30,Rick Nash,42,79,69,LW,2014
30283,21,31,Rick Nash,15,60,36,LW,2015
30284,15,32,Rick Nash,23,67,38,RW,2016
30285,3,33,Rick Nash,3,11,6,LW,2017
30286,0,24,Rick Newell,0,3,0,D,1972
30287,0,25,Rick Newell,0,3,0,D,1973
30288,4,26,Rick Newell,0,25,4,D,1974
30289,4,26,Rick Newell,0,25,4,D,1974
30290,2,21,Rick Paterson,0,11,2,C,1979
30291,2,22,Rick Paterson,8,49,10,RW,1980
30292,7,23,Rick Paterson,4,48,11,RW,1981
30293,9,24,Rick Paterson,14,79,23,C,1982
30294,6,25,Rick Paterson,7,72,13,C,1983
30295,12,26,Rick Paterson,7,79,19,RW,1984
30296,3,27,Rick Paterson,9,70,12,C,1985
30297,2,28,Rick Paterson,1,22,3,C,1986
30298,0,21,Rick Rypien,1,5,1,C,2005
30299,0,22,Rick Rypien,0,2,0,C,2006
30300,2,23,Rick Rypien,1,22,3,C,2007
30301,0,24,Rick Rypien,3,12,3,C,2008
30302,4,25,Rick Rypien,4,69,8,C,2009
30303,1,26,Rick Rypien,0,9,1,C,2010
30304,0,21,Rick Shinske,0,5,0,C,1976
30305,12,22,Rick Shinske,5,47,17,RW,1977
30306,4,23,Rick Shinske,0,11,4,RW,1978
30307,5,20,Rick Smith,0,48,5,D,1968
30308,8,21,Rick Smith,2,69,10,D,1969
30309,19,22,Rick Smith,4,67,23,D,1970
30310,16,23,Rick Smith,3,78,19,D,1971
30311,24,24,Rick Smith,9,64,33,D,1972
30312,28,25,Rick Smith,10,71,38,D,1973
30313,28,25,Rick Smith,10,71,38,D,1973
30314,29,26,Rick Smith,9,78,38,D,1974
30315,29,26,Rick Smith,9,78,38,D,1974
30316,7,27,Rick Smith,1,24,8,D,1975
30317,32,27,Rick Smith,1,51,33,D,1975
30318,32,27,Rick Smith,1,51,33,D,1975
30319,17,28,Rick Smith,6,64,23,D,1976
30320,29,29,Rick Smith,7,79,36,D,1977
30321,18,30,Rick Smith,7,65,25,D,1978
30322,18,31,Rick Smith,8,78,26,D,1979
30323,6,32,Rick Smith,5,51,11,D,1980
30324,25,20,Rick Tocchet,14,75,39,RW,1984
30325,21,21,Rick Tocchet,14,69,35,RW,1985
30326,28,22,Rick Tocchet,21,69,49,RW,1986
30327,33,23,Rick Tocchet,31,65,64,RW,1987
30328,36,24,Rick Tocchet,45,66,81,RW,1988
30329,59,25,Rick Tocchet,37,75,96,RW,1989
30330,31,26,Rick Tocchet,40,70,71,RW,1990
30331,32,27,Rick Tocchet,27,61,59,RW,1991
30332,61,28,Rick Tocchet,48,80,109,RW,1992
30333,26,29,Rick Tocchet,14,51,40,RW,1993
30334,17,30,Rick Tocchet,18,36,35,RW,1994
30335,31,31,Rick Tocchet,29,71,60,RW,1995
30336,19,32,Rick Tocchet,21,53,40,RW,1996
30337,19,33,Rick Tocchet,26,68,45,RW,1997
30338,30,34,Rick Tocchet,26,81,56,RW,1998
30339,20,35,Rick Tocchet,15,80,35,RW,1999
30340,22,36,Rick Tocchet,14,60,36,RW,2000
30341,2,37,Rick Tocchet,0,14,2,RW,2001
30342,33,19,Rick Vaive,26,75,59,RW,1978
30343,33,19,Rick Vaive,26,75,59,RW,1978
30344,15,20,Rick Vaive,22,69,37,RW,1979
30345,29,21,Rick Vaive,33,75,62,RW,1980
30346,35,22,Rick Vaive,54,77,89,RW,1981
30347,28,23,Rick Vaive,51,78,79,RW,1982
30348,41,24,Rick Vaive,52,76,93,RW,1983
30349,33,25,Rick Vaive,35,72,68,RW,1984
30350,31,26,Rick Vaive,33,61,64,RW,1985
30351,34,27,Rick Vaive,32,73,66,RW,1986
30352,26,28,Rick Vaive,43,76,69,RW,1987
30353,26,29,Rick Vaive,31,58,57,RW,1988
30354,19,30,Rick Vaive,29,70,48,RW,1989
30355,27,31,Rick Vaive,25,71,52,RW,1990
30356,3,32,Rick Vaive,1,20,4,RW,1991
30357,0,21,Rick Vasko,0,3,0,D,1977
30358,0,23,Rick Vasko,0,8,0,D,1979
30359,7,24,Rick Vasko,3,20,10,D,1980
30360,2,23,Rick Wilson,0,21,2,D,1973
30361,5,24,Rick Wilson,2,76,7,D,1974
30362,6,25,Rick Wilson,1,65,7,D,1975
30363,13,26,Rick Wilson,3,77,16,D,1976
30364,0,21,Rick Zombo,0,1,0,D,1984
30365,1,22,Rick Zombo,0,14,1,D,1985
30366,4,23,Rick Zombo,1,44,5,D,1986
30367,14,24,Rick Zombo,3,62,17,D,1987
30368,20,25,Rick Zombo,1,75,21,D,1988
30369,20,26,Rick Zombo,5,77,25,D,1989
30370,19,27,Rick Zombo,4,77,23,D,1990
30371,15,28,Rick Zombo,3,67,18,D,1991
30372,15,29,Rick Zombo,0,71,15,D,1992
30373,8,30,Rick Zombo,2,74,10,D,1993
30374,4,31,Rick Zombo,1,23,5,D,1994
30375,10,32,Rick Zombo,4,67,14,D,1995
30376,0,19,Rickard Rakell,0,4,0,RW,2012
30377,4,20,Rickard Rakell,0,18,4,C,2013
30378,22,21,Rickard Rakell,9,71,31,C,2014
30379,23,22,Rickard Rakell,20,72,43,C,2015
30380,18,23,Rickard Rakell,33,71,51,C,2016
30381,35,24,Rickard Rakell,34,77,69,C,2017
30382,0,22,Rickard Wallin,1,4,1,C,2002
30383,4,23,Rickard Wallin,5,15,9,C,2003
30384,7,29,Rickard Wallin,2,60,9,C,2009
30385,1,18,Rico Fata,0,20,1,C,1998
30386,0,19,Rico Fata,0,2,0,RW,1999
30387,0,20,Rico Fata,0,5,0,RW,2000
30388,0,21,Rico Fata,0,10,0,RW,2001
30389,12,22,Rico Fata,7,63,19,LW,2002
30390,18,23,Rico Fata,16,73,34,C,2003
30391,4,25,Rico Fata,3,47,7,RW,2005
30392,1,26,Rico Fata,1,10,2,LW,2006
30393,18,19,Rik Wilson,3,48,21,D,1981
30394,11,20,Rik Wilson,3,56,14,D,1982
30395,11,21,Rik Wilson,7,48,18,D,1983
30396,16,22,Rik Wilson,8,51,24,D,1984
30397,4,23,Rik Wilson,0,34,4,D,1985
30398,5,25,Rik Wilson,4,14,9,D,1987
30399,3,21,Riku Hahl,2,22,5,C,2001
30400,4,22,Riku Hahl,3,42,7,C,2002
30401,1,23,Riku Hahl,0,28,1,C,2003
30402,0,24,Riley Armstrong,0,2,0,RW,2008
30403,0,22,Riley Barber,0,3,0,RW,2016
30404,0,24,Riley Cote,0,8,0,LW,2006
30405,3,25,Riley Cote,1,70,4,LW,2007
30406,3,26,Riley Cote,0,63,3,LW,2008
30407,0,27,Riley Cote,0,15,0,LW,2009
30408,1,22,Riley Nash,0,5,1,C,2011
30409,5,23,Riley Nash,4,32,9,C,2012
30410,14,24,Riley Nash,10,73,24,C,2013
30411,17,25,Riley Nash,8,68,25,C,2014
30412,13,26,Riley Nash,9,64,22,C,2015
30413,10,27,Riley Nash,7,81,17,C,2016
30414,26,28,Riley Nash,15,76,41,C,2017
30415,0,20,Riley Sheahan,0,1,0,C,2011
30416,0,21,Riley Sheahan,0,1,0,C,2012
30417,15,22,Riley Sheahan,9,42,24,C,2013
30418,23,23,Riley Sheahan,13,79,36,C,2014
30419,11,24,Riley Sheahan,14,81,25,C,2015
30420,11,25,Riley Sheahan,2,80,13,C,2016
30421,0,26,Riley Sheahan,0,8,0,C,2017
30422,0,20,Rinat Valiev,0,10,0,D,2015
30423,0,22,Rinat Valiev,0,2,0,D,2017
30424,3,23,Risto Jalo,0,3,3,C,1985
30425,4,20,Risto Siltanen,3,20,7,D,1978
30426,29,21,Risto Siltanen,6,64,35,D,1979
30427,36,22,Risto Siltanen,17,79,53,D,1980
30428,48,23,Risto Siltanen,15,63,63,D,1981
30429,25,24,Risto Siltanen,5,74,30,D,1982
30430,38,25,Risto Siltanen,15,75,53,D,1983
30431,33,26,Risto Siltanen,12,76,45,D,1984
30432,27,27,Risto Siltanen,10,65,37,D,1985
30433,29,28,Risto Siltanen,10,66,39,D,1986
30434,0,20,Rob Blake,0,4,0,D,1989
30435,34,21,Rob Blake,12,75,46,D,1990
30436,13,22,Rob Blake,7,57,20,D,1991
30437,43,23,Rob Blake,16,76,59,D,1992
30438,48,24,Rob Blake,20,84,68,D,1993
30439,7,25,Rob Blake,4,24,11,D,1994
30440,2,26,Rob Blake,1,6,3,D,1995
30441,23,27,Rob Blake,8,62,31,D,1996
30442,27,28,Rob Blake,23,81,50,D,1997
30443,23,29,Rob Blake,12,62,35,D,1998
30444,39,30,Rob Blake,18,77,57,D,1999
30445,40,31,Rob Blake,19,67,59,D,2000
30446,40,32,Rob Blake,16,75,56,D,2001
30447,28,33,Rob Blake,17,79,45,D,2002
30448,33,34,Rob Blake,13,74,46,D,2003
30449,37,36,Rob Blake,14,81,51,D,2005
30450,20,37,Rob Blake,14,72,34,D,2006
30451,22,38,Rob Blake,9,71,31,D,2007
30452,35,39,Rob Blake,10,73,45,D,2008
30453,23,40,Rob Blake,7,70,30,D,2009
30454,20,19,Rob Brown,24,51,44,RW,1987
30455,66,20,Rob Brown,49,68,115,RW,1988
30456,47,21,Rob Brown,33,80,80,RW,1989
30457,34,22,Rob Brown,24,69,58,RW,1990
30458,26,23,Rob Brown,21,67,47,C,1991
30459,6,24,Rob Brown,1,15,7,RW,1992
30460,0,25,Rob Brown,0,1,0,RW,1993
30461,0,26,Rob Brown,0,2,0,RW,1994
30462,25,29,Rob Brown,15,82,40,RW,1997
30463,11,30,Rob Brown,13,58,24,RW,1998
30464,13,31,Rob Brown,10,50,23,RW,1999
30465,0,18,Rob Cimetta,2,7,2,LW,1988
30466,9,19,Rob Cimetta,8,47,17,RW,1989
30467,4,20,Rob Cimetta,2,25,6,LW,1990
30468,3,21,Rob Cimetta,4,24,7,LW,1991
30469,1,27,Rob Collins,1,8,2,C,2005
30470,0,23,Rob Conn,0,2,0,LW,1991
30471,5,27,Rob Conn,2,28,7,RW,1995
30472,7,27,Rob Cowie,2,32,9,D,1994
30473,5,28,Rob Cowie,5,46,10,D,1995
30474,2,22,Rob Davison,1,15,3,D,2002
30475,3,23,Rob Davison,0,55,3,D,2003
30476,5,25,Rob Davison,1,69,6,D,2005
30477,2,26,Rob Davison,0,22,2,D,2006
30478,1,27,Rob Davison,1,34,2,D,2007
30479,2,28,Rob Davison,0,23,2,D,2008
30480,0,29,Rob Davison,0,1,0,D,2009
30481,0,20,Rob DiMaio,1,16,1,C,1988
30482,0,21,Rob DiMaio,0,7,0,C,1989
30483,0,22,Rob DiMaio,0,1,0,C,1990
30484,2,23,Rob DiMaio,5,50,7,LW,1991
30485,15,24,Rob DiMaio,9,54,24,RW,1992
30486,12,25,Rob DiMaio,11,53,23,LW,1993
30487,1,26,Rob DiMaio,3,36,4,LW,1994
30488,15,27,Rob DiMaio,6,59,21,RW,1995
30489,15,28,Rob DiMaio,13,72,28,C,1996
30490,17,29,Rob DiMaio,10,79,27,RW,1997
30491,14,30,Rob DiMaio,7,71,21,C,1998
30492,19,31,Rob DiMaio,6,62,25,RW,1999
30493,18,32,Rob DiMaio,6,74,24,RW,2000
30494,6,33,Rob DiMaio,6,61,12,LW,2001
30495,9,34,Rob DiMaio,10,69,19,LW,2002
30496,15,35,Rob DiMaio,9,69,24,RW,2003
30497,13,37,Rob DiMaio,4,61,17,RW,2005
30498,0,20,Rob Flockhart,0,5,0,RW,1976
30499,1,21,Rob Flockhart,0,24,1,RW,1977
30500,1,22,Rob Flockhart,1,14,2,RW,1978
30501,3,23,Rob Flockhart,1,10,4,C,1979
30502,0,24,Rob Flockhart,0,2,0,RW,1980
30503,0,24,Rob Garner,0,1,0,C,1982
30504,20,23,Rob Gaudreau,23,59,43,RW,1992
30505,20,24,Rob Gaudreau,15,84,35,RW,1993
30506,9,25,Rob Gaudreau,5,36,14,RW,1994
30507,5,26,Rob Gaudreau,8,52,13,RW,1995
30508,0,23,Rob Globke,1,18,1,RW,2005
30509,1,24,Rob Globke,0,19,1,C,2006
30510,0,25,Rob Globke,0,9,0,C,2007
30511,0,21,Rob H Palmer,0,1,0,C,1973
30512,2,22,Rob H Palmer,0,13,2,C,1974
30513,1,23,Rob H Palmer,0,2,1,C,1975
30514,0,24,Rob Klinkhammer,0,1,0,LW,2010
30515,2,25,Rob Klinkhammer,0,15,2,LW,2011
30516,6,26,Rob Klinkhammer,5,22,11,LW,2012
30517,9,27,Rob Klinkhammer,11,72,20,C,2013
30518,4,28,Rob Klinkhammer,5,69,9,LW,2014
30519,0,29,Rob Klinkhammer,1,14,1,LW,2015
30520,5,22,Rob McClanahan,2,13,7,LW,1979
30521,12,23,Rob McClanahan,3,53,15,C,1980
30522,12,24,Rob McClanahan,5,39,17,C,1981
30523,26,25,Rob McClanahan,22,78,48,LW,1982
30524,8,26,Rob McClanahan,6,41,14,RW,1983
30525,0,18,Rob Murphy,0,5,0,C,1987
30526,1,19,Rob Murphy,0,8,1,LW,1988
30527,1,20,Rob Murphy,1,12,2,LW,1989
30528,1,21,Rob Murphy,5,42,6,LW,1990
30529,1,22,Rob Murphy,0,6,1,LW,1991
30530,7,23,Rob Murphy,3,44,10,LW,1992
30531,1,24,Rob Murphy,0,8,1,C,1993
30532,7,22,Rob Murray,2,41,9,C,1989
30533,3,23,Rob Murray,0,17,3,C,1990
30534,1,24,Rob Murray,0,9,1,C,1991
30535,0,25,Rob Murray,1,10,1,C,1992
30536,0,26,Rob Murray,0,6,0,C,1993
30537,2,27,Rob Murray,0,10,2,C,1994
30538,0,28,Rob Murray,0,1,0,C,1995
30539,2,31,Rob Murray,1,13,3,C,1998
30540,17,19,Rob Niedermayer,9,65,26,C,1993
30541,6,20,Rob Niedermayer,4,48,10,C,1994
30542,35,21,Rob Niedermayer,26,82,61,C,1995
30543,24,22,Rob Niedermayer,14,60,38,C,1996
30544,7,23,Rob Niedermayer,8,33,15,C,1997
30545,33,24,Rob Niedermayer,18,82,51,C,1998
30546,23,25,Rob Niedermayer,10,81,33,C,1999
30547,20,26,Rob Niedermayer,12,67,32,C,2000
30548,14,27,Rob Niedermayer,6,57,20,LW,2001
30549,12,28,Rob Niedermayer,10,66,22,LW,2002
30550,16,29,Rob Niedermayer,12,55,28,LW,2003
30551,24,31,Rob Niedermayer,15,76,39,C,2005
30552,11,32,Rob Niedermayer,5,82,16,C,2006
30553,8,33,Rob Niedermayer,8,78,16,C,2007
30554,7,34,Rob Niedermayer,14,79,21,C,2008
30555,12,35,Rob Niedermayer,10,71,22,C,2009
30556,14,36,Rob Niedermayer,5,71,19,C,2010
30557,0,23,Rob O'Gara,0,3,0,D,2016
30558,0,24,Rob O'Gara,0,8,0,D,2017
30559,10,20,Rob Pearson,14,47,24,RW,1991
30560,14,21,Rob Pearson,23,78,37,RW,1992
30561,18,22,Rob Pearson,12,67,30,RW,1993
30562,6,23,Rob Pearson,0,32,6,RW,1994
30563,4,24,Rob Pearson,6,27,10,RW,1995
30564,2,25,Rob Pearson,1,18,3,RW,1996
30565,1,20,Rob Plumb,2,7,3,LW,1977
30566,1,21,Rob Plumb,1,7,2,LW,1978
30567,36,20,Rob Ramage,12,80,48,D,1978
30568,20,21,Rob Ramage,8,75,28,D,1979
30569,42,22,Rob Ramage,20,79,62,D,1980
30570,29,23,Rob Ramage,13,80,42,D,1981
30571,35,24,Rob Ramage,16,78,51,D,1982
30572,45,25,Rob Ramage,15,80,60,D,1983
30573,31,26,Rob Ramage,7,80,38,D,1984
30574,56,27,Rob Ramage,10,77,66,D,1985
30575,28,28,Rob Ramage,11,59,39,D,1986
30576,40,29,Rob Ramage,9,79,49,D,1987
30577,13,30,Rob Ramage,3,68,16,D,1988
30578,41,31,Rob Ramage,8,80,49,D,1989
30579,25,32,Rob Ramage,10,80,35,D,1990
30580,5,33,Rob Ramage,4,34,9,D,1991
30581,13,34,Rob Ramage,5,74,18,D,1992
30582,2,35,Rob Ramage,0,21,2,D,1993
30583,1,21,Rob Ray,2,27,3,LW,1989
30584,8,22,Rob Ray,8,66,16,LW,1990
30585,3,23,Rob Ray,5,63,8,LW,1991
30586,2,24,Rob Ray,3,68,5,LW,1992
30587,4,25,Rob Ray,3,82,7,LW,1993
30588,3,26,Rob Ray,0,47,3,LW,1994
30589,6,27,Rob Ray,3,71,9,LW,1995
30590,3,28,Rob Ray,7,82,10,LW,1996
30591,4,29,Rob Ray,2,63,6,RW,1997
30592,4,30,Rob Ray,0,76,4,RW,1998
30593,3,31,Rob Ray,1,69,4,LW,1999
30594,6,32,Rob Ray,4,63,10,RW,2000
30595,3,33,Rob Ray,2,71,5,RW,2001
30596,0,34,Rob Ray,0,46,0,RW,2002
30597,0,35,Rob Ray,1,6,1,RW,2003
30598,1,24,Rob Robinson,0,22,1,D,1991
30599,0,20,Rob Schremp,0,1,0,C,2006
30600,0,21,Rob Schremp,0,2,0,C,2007
30601,3,22,Rob Schremp,0,4,3,C,2008
30602,18,23,Rob Schremp,7,44,25,C,2009
30603,13,24,Rob Schremp,13,63,26,C,2010
30604,2,25,Rob Scuderi,1,13,3,D,2003
30605,4,27,Rob Scuderi,0,57,4,D,2005
30606,10,28,Rob Scuderi,1,78,11,D,2006
30607,5,29,Rob Scuderi,0,71,5,D,2007
30608,15,30,Rob Scuderi,1,81,16,D,2008
30609,11,31,Rob Scuderi,0,73,11,D,2009
30610,13,32,Rob Scuderi,2,82,15,D,2010
30611,8,33,Rob Scuderi,1,82,9,D,2011
30612,11,34,Rob Scuderi,1,48,12,D,2012
30613,4,35,Rob Scuderi,0,53,4,D,2013
30614,9,36,Rob Scuderi,1,82,10,D,2014
30615,10,37,Rob Scuderi,0,63,10,D,2015
30616,0,24,Rob Shearer,0,2,0,C,2000
30617,0,27,Rob Skrlac,1,8,1,RW,2003
30618,4,22,Rob Tudor,4,24,8,RW,1978
30619,0,23,Rob Tudor,0,2,0,RW,1979
30620,0,26,Rob Tudor,0,2,0,RW,1982
30621,2,28,Rob Valicevic,4,19,6,C,1998
30622,11,29,Rob Valicevic,14,80,25,C,1999
30623,6,30,Rob Valicevic,8,60,14,LW,2000
30624,1,31,Rob Valicevic,1,17,2,RW,2001
30625,0,32,Rob Valicevic,1,10,1,RW,2002
30626,0,33,Rob Valicevic,0,7,0,C,2003
30627,38,24,Rob Walton,16,73,54,C,1973
30628,23,24,Rob Walton,8,45,31,C,1973
30629,15,24,Rob Walton,8,28,23,C,1973
30630,15,24,Rob Walton,8,28,23,C,1973
30631,33,25,Rob Walton,24,75,57,C,1974
30632,33,25,Rob Walton,24,75,57,C,1974
30633,0,26,Rob Walton,0,2,0,C,1975
30634,0,26,Rob Walton,0,2,0,C,1975
30635,2,24,Rob Whistle,4,32,6,D,1985
30636,3,26,Rob Whistle,3,19,6,D,1987
30637,2,22,Rob Zamuner,1,9,3,C,1991
30638,28,23,Rob Zamuner,15,84,43,LW,1992
30639,6,24,Rob Zamuner,6,59,12,LW,1993
30640,6,25,Rob Zamuner,9,43,15,LW,1994
30641,20,26,Rob Zamuner,15,72,35,LW,1995
30642,33,27,Rob Zamuner,17,82,50,LW,1996
30643,12,28,Rob Zamuner,14,77,26,LW,1997
30644,11,29,Rob Zamuner,8,58,19,LW,1998
30645,12,30,Rob Zamuner,9,57,21,LW,1999
30646,18,31,Rob Zamuner,19,79,37,LW,2000
30647,13,32,Rob Zamuner,12,66,25,LW,2001
30648,6,33,Rob Zamuner,10,55,16,LW,2002
30649,5,34,Rob Zamuner,4,57,9,LW,2003
30650,0,20,Rob Zettler,0,2,0,D,1988
30651,8,21,Rob Zettler,0,31,8,D,1989
30652,4,22,Rob Zettler,1,47,5,D,1990
30653,8,23,Rob Zettler,1,74,9,D,1991
30654,7,24,Rob Zettler,0,80,7,D,1992
30655,7,25,Rob Zettler,0,75,7,D,1993
30656,1,26,Rob Zettler,0,32,1,D,1994
30657,1,27,Rob Zettler,0,29,1,D,1995
30658,12,28,Rob Zettler,2,48,14,D,1996
30659,7,29,Rob Zettler,0,59,7,D,1997
30660,0,30,Rob Zettler,0,2,0,D,1998
30661,2,31,Rob Zettler,0,12,2,D,1999
30662,4,32,Rob Zettler,0,29,4,D,2000
30663,4,33,Rob Zettler,1,49,5,D,2001
30664,0,23,Robb Gordon,0,4,0,C,1998
30665,1,22,Robbie Earl,0,9,1,LW,2007
30666,0,24,Robbie Earl,6,32,6,LW,2009
30667,0,25,Robbie Earl,0,6,0,LW,2010
30668,0,21,Robbie Ftorek,0,3,0,C,1972
30669,5,22,Robbie Ftorek,2,12,7,C,1973
30670,37,23,Robbie Ftorek,31,53,68,C,1974
30671,37,23,Robbie Ftorek,31,53,68,C,1974
30672,72,24,Robbie Ftorek,41,80,113,C,1975
30673,72,24,Robbie Ftorek,41,80,113,C,1975
30674,71,25,Robbie Ftorek,46,80,117,C,1976
30675,50,26,Robbie Ftorek,59,80,109,C,1977
30676,77,27,Robbie Ftorek,39,80,116,C,1978
30677,77,27,Robbie Ftorek,39,80,116,C,1978
30678,33,28,Robbie Ftorek,18,52,51,C,1979
30679,49,29,Robbie Ftorek,24,78,73,C,1980
30680,32,30,Robbie Ftorek,9,49,41,C,1981
30681,19,31,Robbie Ftorek,12,61,31,C,1982
30682,2,32,Robbie Ftorek,3,31,5,C,1983
30683,10,33,Robbie Ftorek,9,48,19,C,1984
30684,0,25,Robbie Laird,0,1,0,LW,1979
30685,9,20,Robbie Neale,8,43,17,C,1973
30686,9,20,Robbie Neale,8,43,17,C,1973
30687,5,21,Robbie Neale,1,16,6,C,1974
30688,3,21,Robbie Neale,1,9,4,C,1974
30689,2,21,Robbie Neale,0,7,2,C,1974
30690,5,21,Robbie Neale,1,16,6,C,1974
30691,3,21,Robbie Neale,1,9,4,C,1974
30692,2,21,Robbie Neale,0,7,2,C,1974
30693,0,23,Robbie Russo,0,19,0,D,2016
30694,19,20,Robby Fabbri,18,72,37,C,2015
30695,18,21,Robby Fabbri,11,51,29,C,2016
30696,0,22,Robert Bortuzzo,0,6,0,D,2011
30697,2,23,Robert Bortuzzo,2,15,4,D,2012
30698,10,24,Robert Bortuzzo,0,54,10,D,2013
30699,5,25,Robert Bortuzzo,3,51,8,D,2014
30700,1,26,Robert Bortuzzo,2,40,3,D,2015
30701,3,27,Robert Bortuzzo,1,38,4,D,2016
30702,9,28,Robert Bortuzzo,4,72,13,D,2017
30703,3,27,Robert Burakovsky,2,23,5,RW,1993
30704,1,21,Robert Dirk,0,7,1,D,1987
30705,1,22,Robert Dirk,0,9,1,D,1988
30706,1,23,Robert Dirk,1,37,2,D,1989
30707,3,24,Robert Dirk,2,52,5,D,1990
30708,7,25,Robert Dirk,2,72,9,D,1991
30709,8,26,Robert Dirk,4,69,12,D,1992
30710,3,27,Robert Dirk,2,71,5,D,1993
30711,3,28,Robert Dirk,1,38,4,D,1994
30712,2,29,Robert Dirk,1,47,3,D,1995
30713,2,19,Robert Dome,5,30,7,RW,1997
30714,5,21,Robert Dome,2,22,7,C,1999
30715,0,24,Robert Dome,0,1,0,RW,2002
30716,0,21,Robert Hagg,0,1,0,D,2016
30717,6,22,Robert Hagg,3,70,9,D,2017
30718,20,23,Robert Kron,12,76,32,RW,1990
30719,2,24,Robert Kron,2,36,4,LW,1991
30720,13,25,Robert Kron,14,45,27,RW,1992
30721,26,26,Robert Kron,24,77,50,RW,1993
30722,8,27,Robert Kron,10,37,18,RW,1994
30723,28,28,Robert Kron,22,77,50,RW,1995
30724,12,29,Robert Kron,10,68,22,C,1996
30725,20,30,Robert Kron,16,81,36,C,1997
30726,16,31,Robert Kron,9,75,25,LW,1998
30727,27,32,Robert Kron,13,81,40,LW,1999
30728,11,33,Robert Kron,8,59,19,LW,2000
30729,11,34,Robert Kron,4,59,15,C,2001
30730,5,22,Robert Lang,0,11,5,C,1992
30731,10,23,Robert Lang,9,32,19,C,1993
30732,8,24,Robert Lang,4,36,12,C,1994
30733,16,25,Robert Lang,6,68,22,RW,1995
30734,13,27,Robert Lang,9,54,22,C,1997
30735,23,28,Robert Lang,21,72,44,C,1998
30736,42,29,Robert Lang,23,78,65,C,1999
30737,48,30,Robert Lang,32,82,80,C,2000
30738,32,31,Robert Lang,18,62,50,C,2001
30739,47,32,Robert Lang,22,82,69,C,2002
30740,49,33,Robert Lang,30,69,79,C,2003
30741,42,35,Robert Lang,20,72,62,C,2005
30742,33,36,Robert Lang,19,81,52,C,2006
30743,33,37,Robert Lang,21,76,54,C,2007
30744,21,38,Robert Lang,18,50,39,C,2008
30745,20,39,Robert Lang,9,64,29,C,2009
30746,3,22,Robert Logan,7,22,10,RW,1986
30747,2,23,Robert Logan,3,16,5,RW,1987
30748,0,24,Robert Logan,0,4,0,RW,1988
30749,14,21,Robert Nilsson,6,53,20,C,2005
30750,0,22,Robert Nilsson,1,4,1,C,2006
30751,31,23,Robert Nilsson,10,71,41,LW,2007
30752,20,24,Robert Nilsson,9,64,29,LW,2008
30753,16,25,Robert Nilsson,11,60,27,C,2009
30754,18,25,Robert Nordmark,3,67,21,D,1987
30755,35,26,Robert Nordmark,6,80,41,D,1988
30756,11,27,Robert Nordmark,2,44,13,D,1989
30757,6,28,Robert Nordmark,2,45,8,D,1990
30758,3,21,Robert Palmer,0,48,3,D,1977
30759,41,22,Robert Palmer,4,78,45,D,1978
30760,36,23,Robert Palmer,4,78,40,D,1979
30761,4,24,Robert Palmer,0,13,4,D,1980
30762,2,25,Robert Palmer,0,5,2,D,1981
30763,10,26,Robert Palmer,1,60,11,D,1982
30764,5,27,Robert Palmer,0,38,5,D,1983
30765,6,19,Robert Petrovicky,3,42,9,C,1992
30766,5,20,Robert Petrovicky,6,33,11,C,1993
30767,0,21,Robert Petrovicky,0,2,0,C,1994
30768,1,22,Robert Petrovicky,1,5,2,C,1995
30769,12,23,Robert Petrovicky,7,44,19,C,1996
30770,4,25,Robert Petrovicky,3,28,7,C,1998
30771,10,26,Robert Petrovicky,7,43,17,LW,1999
30772,0,27,Robert Petrovicky,0,11,0,C,2000
30773,27,20,Robert Picard,10,75,37,D,1977
30774,44,21,Robert Picard,21,77,65,D,1978
30775,43,22,Robert Picard,11,78,54,D,1979
30776,21,23,Robert Picard,8,67,29,D,1980
30777,26,24,Robert Picard,2,62,28,D,1981
30778,31,25,Robert Picard,7,64,38,D,1982
30779,18,26,Robert Picard,6,69,24,D,1983
30780,22,27,Robert Picard,12,78,34,D,1984
30781,32,28,Robert Picard,9,68,41,D,1985
30782,20,29,Robert Picard,8,78,28,D,1986
30783,13,30,Robert Picard,3,65,16,D,1987
30784,14,31,Robert Picard,7,74,21,D,1988
30785,8,32,Robert Picard,0,44,8,D,1989
30786,22,19,Robert Reichel,19,66,41,LW,1990
30787,34,20,Robert Reichel,20,77,54,C,1991
30788,48,21,Robert Reichel,40,80,88,C,1992
30789,53,22,Robert Reichel,40,84,93,C,1993
30790,17,23,Robert Reichel,18,48,35,C,1994
30791,41,25,Robert Reichel,21,82,62,C,1996
30792,40,26,Robert Reichel,25,82,65,C,1997
30793,43,27,Robert Reichel,26,83,69,C,1998
30794,31,30,Robert Reichel,20,78,51,C,2001
30795,30,31,Robert Reichel,12,81,42,C,2002
30796,19,32,Robert Reichel,11,69,30,C,2003
30797,0,23,Robert Schnabel,0,1,0,D,2001
30798,0,24,Robert Schnabel,0,1,0,D,2002
30799,3,25,Robert Schnabel,0,20,3,D,2003
30800,1,26,Robert Svehla,1,5,2,D,1994
30801,49,27,Robert Svehla,8,81,57,D,1995
30802,32,28,Robert Svehla,13,82,45,D,1996
30803,34,29,Robert Svehla,9,79,43,D,1997
30804,29,30,Robert Svehla,8,80,37,D,1998
30805,40,31,Robert Svehla,9,82,49,D,1999
30806,22,32,Robert Svehla,6,82,28,D,2000
30807,22,33,Robert Svehla,7,82,29,D,2001
30808,38,34,Robert Svehla,7,82,45,D,2002
30809,0,24,Robin Bartel,0,1,0,D,1985
30810,1,25,Robin Bartel,0,40,1,D,1986
30811,0,23,Robin Bawa,1,5,1,RW,1989
30812,0,25,Robin Bawa,0,2,0,RW,1991
30813,0,26,Robin Bawa,5,42,5,RW,1992
30814,1,27,Robin Bawa,0,12,1,RW,1993
30815,3,24,Robin Burns,0,10,3,LW,1970
30816,0,25,Robin Burns,0,5,0,LW,1971
30817,2,26,Robin Burns,0,26,2,LW,1972
30818,15,28,Robin Burns,18,71,33,LW,1974
30819,18,29,Robin Burns,13,78,31,LW,1975
30820,7,19,Robyn Regehr,5,57,12,D,1999
30821,3,20,Robyn Regehr,1,71,4,D,2000
30822,6,21,Robyn Regehr,2,77,8,D,2001
30823,12,22,Robyn Regehr,0,76,12,D,2002
30824,14,23,Robyn Regehr,4,82,18,D,2003
30825,20,25,Robyn Regehr,6,68,26,D,2005
30826,19,26,Robyn Regehr,2,78,21,D,2006
30827,15,27,Robyn Regehr,5,82,20,D,2007
30828,8,28,Robyn Regehr,0,75,8,D,2008
30829,15,29,Robyn Regehr,2,81,17,D,2009
30830,15,30,Robyn Regehr,2,79,17,D,2010
30831,4,31,Robyn Regehr,1,76,5,D,2011
30832,4,32,Robyn Regehr,0,41,4,D,2012
30833,11,33,Robyn Regehr,3,79,14,D,2013
30834,10,34,Robyn Regehr,3,67,13,D,2014
30835,0,21,Rocco Grimaldi,1,7,1,C,2014
30836,2,22,Rocco Grimaldi,3,20,5,C,2015
30837,1,23,Rocco Grimaldi,0,4,1,C,2016
30838,2,24,Rocco Grimaldi,1,6,3,C,2017
30839,0,23,Rocky Dundas,0,5,0,RW,1989
30840,5,21,Rocky Saganiuk,3,16,8,RW,1978
30841,23,22,Rocky Saganiuk,24,75,47,RW,1979
30842,18,23,Rocky Saganiuk,12,71,30,RW,1980
30843,16,24,Rocky Saganiuk,17,65,33,RW,1981
30844,0,25,Rocky Saganiuk,0,3,0,RW,1982
30845,3,26,Rocky Saganiuk,1,29,4,RW,1983
30846,0,20,Rocky Thompson,0,12,0,D,1997
30847,0,21,Rocky Thompson,0,3,0,RW,1998
30848,0,23,Rocky Thompson,0,4,0,RW,2000
30849,0,24,Rocky Thompson,0,6,0,RW,2001
30850,1,19,Rocky Trottier,1,5,2,RW,1983
30851,3,20,Rocky Trottier,5,33,8,RW,1984
30852,35,19,Rod Brind'Amour,26,79,61,LW,1989
30853,32,20,Rod Brind'Amour,17,78,49,LW,1990
30854,44,21,Rod Brind'Amour,33,80,77,C,1991
30855,49,22,Rod Brind'Amour,37,81,86,C,1992
30856,62,23,Rod Brind'Amour,35,84,97,LW,1993
30857,27,24,Rod Brind'Amour,12,48,39,C,1994
30858,61,25,Rod Brind'Amour,26,82,87,LW,1995
30859,32,26,Rod Brind'Amour,27,82,59,C,1996
30860,38,27,Rod Brind'Amour,36,82,74,LW,1997
30861,50,28,Rod Brind'Amour,24,82,74,C,1998
30862,13,29,Rod Brind'Amour,9,45,22,C,1999
30863,36,30,Rod Brind'Amour,20,79,56,C,2000
30864,32,31,Rod Brind'Amour,23,81,55,C,2001
30865,23,32,Rod Brind'Amour,14,48,37,C,2002
30866,26,33,Rod Brind'Amour,12,78,38,C,2003
30867,39,35,Rod Brind'Amour,31,78,70,C,2005
30868,56,36,Rod Brind'Amour,26,78,82,C,2006
30869,32,37,Rod Brind'Amour,19,59,51,C,2007
30870,35,38,Rod Brind'Amour,16,80,51,C,2008
30871,10,39,Rod Brind'Amour,9,80,19,C,2009
30872,2,22,Rod Buskas,2,41,4,D,1982
30873,4,23,Rod Buskas,2,47,6,D,1983
30874,7,24,Rod Buskas,2,69,9,D,1984
30875,7,25,Rod Buskas,2,72,9,D,1985
30876,15,26,Rod Buskas,3,68,18,D,1986
30877,8,27,Rod Buskas,4,76,12,D,1987
30878,5,28,Rod Buskas,1,52,6,D,1988
30879,3,29,Rod Buskas,0,23,3,D,1989
30880,8,30,Rod Buskas,3,57,11,D,1990
30881,4,31,Rod Buskas,0,47,4,D,1991
30882,0,32,Rod Buskas,0,4,0,D,1992
30883,0,21,Rod Dallman,1,3,1,LW,1987
30884,0,22,Rod Dallman,0,1,0,LW,1988
30885,0,25,Rod Dallman,0,2,0,LW,1991
30886,48,26,Rod Gilbert,29,73,77,RW,1967
30887,49,27,Rod Gilbert,28,66,77,RW,1968
30888,37,28,Rod Gilbert,16,72,53,RW,1969
30889,31,29,Rod Gilbert,30,78,61,RW,1970
30890,54,30,Rod Gilbert,43,73,97,RW,1971
30891,59,31,Rod Gilbert,25,76,84,RW,1972
30892,41,32,Rod Gilbert,36,75,77,RW,1973
30893,61,33,Rod Gilbert,36,76,97,RW,1974
30894,50,34,Rod Gilbert,36,70,86,RW,1975
30895,48,35,Rod Gilbert,27,77,75,RW,1976
30896,7,36,Rod Gilbert,2,19,9,RW,1977
30897,1,28,Rod Graham,2,14,3,LW,1974
30898,4,21,Rod Langway,3,45,7,D,1978
30899,29,22,Rod Langway,7,77,36,D,1979
30900,34,23,Rod Langway,11,80,45,D,1980
30901,34,24,Rod Langway,5,66,39,D,1981
30902,29,25,Rod Langway,3,80,32,D,1982
30903,24,26,Rod Langway,9,80,33,D,1983
30904,22,27,Rod Langway,4,79,26,D,1984
30905,17,28,Rod Langway,1,71,18,D,1985
30906,25,29,Rod Langway,2,78,27,D,1986
30907,13,30,Rod Langway,3,63,16,D,1987
30908,19,31,Rod Langway,2,76,21,D,1988
30909,8,32,Rod Langway,0,58,8,D,1989
30910,7,33,Rod Langway,1,56,8,D,1990
30911,13,34,Rod Langway,0,64,13,D,1991
30912,0,35,Rod Langway,0,21,0,D,1992
30913,18,20,Rod Langway*,3,52,21,D,1977
30914,1,22,Rod Norrish,2,9,3,LW,1973
30915,2,23,Rod Norrish,1,12,3,LW,1974
30916,0,22,Rod Pelley,0,9,0,C,2006
30917,4,23,Rod Pelley,2,58,6,C,2007
30918,8,25,Rod Pelley,2,63,10,C,2009
30919,7,26,Rod Pelley,3,74,10,C,2010
30920,1,27,Rod Pelley,2,52,3,C,2011
30921,0,21,Rod Schutt,0,2,0,LW,1977
30922,21,22,Rod Schutt,24,74,45,LW,1978
30923,21,23,Rod Schutt,18,73,39,LW,1979
30924,35,24,Rod Schutt,25,80,60,LW,1980
30925,12,25,Rod Schutt,9,35,21,LW,1981
30926,0,26,Rod Schutt,0,5,0,LW,1982
30927,3,27,Rod Schutt,1,11,4,LW,1983
30928,0,29,Rod Schutt,0,6,0,LW,1985
30929,11,23,Rod Seiling,5,71,16,D,1967
30930,17,24,Rod Seiling,4,73,21,D,1968
30931,21,25,Rod Seiling,5,76,26,D,1969
30932,22,26,Rod Seiling,5,68,27,D,1970
30933,36,27,Rod Seiling,5,78,41,D,1971
30934,33,28,Rod Seiling,9,72,42,D,1972
30935,23,29,Rod Seiling,7,68,30,D,1973
30936,13,30,Rod Seiling,5,65,18,D,1974
30937,16,31,Rod Seiling,3,77,19,D,1975
30938,26,32,Rod Seiling,3,79,29,D,1976
30939,11,33,Rod Seiling,1,78,12,D,1977
30940,5,34,Rod Seiling,0,39,5,D,1978
30941,0,22,Rod Willard,0,1,0,LW,1982
30942,5,24,Rod Zaine,8,37,13,C,1970
30943,1,25,Rod Zaine,2,24,3,C,1971
30944,14,26,Rod Zaine,3,74,17,C,1972
30945,14,26,Rod Zaine,3,74,17,C,1972
30946,13,27,Rod Zaine,5,77,18,C,1973
30947,13,27,Rod Zaine,5,77,18,C,1973
30948,6,28,Rod Zaine,3,68,9,C,1974
30949,5,19,Roger Belanger,3,44,8,RW,1984
30950,5,33,Roger Cote,3,60,8,D,1972
30951,5,33,Roger Cote,3,60,8,D,1972
30952,3,34,Roger Cote,0,59,3,D,1973
30953,3,34,Roger Cote,0,59,3,D,1973
30954,6,35,Roger Cote,0,36,6,D,1974
30955,6,35,Roger Cote,0,36,6,D,1974
30956,0,23,Roger Hagglund,0,3,0,D,1984
30957,5,22,Roger Johansson,0,35,5,D,1989
30958,13,23,Roger Johansson,4,38,17,D,1990
30959,16,25,Roger Johansson,4,77,20,D,1992
30960,0,27,Roger Johansson,1,11,1,D,1994
30961,9,21,Roger Kortko,2,27,11,C,1984
30962,8,22,Roger Kortko,5,52,13,C,1985
30963,0,30,Roger Lafreniere,0,10,0,LW,1972
30964,1,20,Roger Lemelin,0,8,1,D,1974
30965,0,21,Roger Lemelin,0,11,0,D,1975
30966,1,22,Roger Lemelin,1,14,2,D,1976
30967,0,23,Roger Lemelin,0,3,0,D,1977
30968,0,24,Roger Melin,0,1,0,LW,1980
30969,0,25,Roger Melin,0,2,0,LW,1981
30970,0,22,Roger Pelletier,0,1,0,D,1967
30971,2,33,Roger Picard,2,15,4,RW,1967
30972,2,28,Roger Wilson,0,7,2,D,1974
30973,0,20,Roland Cloutier,0,1,0,C,1977
30974,6,21,Roland Cloutier,6,19,12,C,1978
30975,3,22,Roland Cloutier,2,14,5,C,1979
30976,44,22,Roland Eriksson,25,80,69,C,1976
30977,39,23,Roland Eriksson,21,78,60,C,1977
30978,12,24,Roland Eriksson,2,35,14,C,1978
30979,10,24,Roland Eriksson,5,33,15,C,1978
30980,10,24,Roland Eriksson,5,33,15,C,1978
30981,3,22,Roland McKeown,0,10,3,D,2017
30982,2,27,Roland Stoltz,2,14,4,RW,1981
30983,27,28,Rolf Edberg,14,76,41,C,1978
30984,23,29,Rolf Edberg,23,63,46,C,1979
30985,8,30,Rolf Edberg,8,45,16,LW,1980
30986,8,27,Roman Cervenka,9,39,17,C,2012
30987,15,18,Roman Hamrlik,6,67,21,D,1992
30988,18,19,Roman Hamrlik,3,64,21,D,1993
30989,11,20,Roman Hamrlik,12,48,23,D,1994
30990,49,21,Roman Hamrlik,16,82,65,D,1995
30991,28,22,Roman Hamrlik,12,79,40,D,1996
30992,32,23,Roman Hamrlik,9,78,41,D,1997
30993,24,24,Roman Hamrlik,8,75,32,D,1998
30994,37,25,Roman Hamrlik,8,80,45,D,1999
30995,30,26,Roman Hamrlik,16,76,46,D,2000
30996,26,27,Roman Hamrlik,11,70,37,D,2001
30997,32,28,Roman Hamrlik,9,73,41,D,2002
30998,22,29,Roman Hamrlik,7,81,29,D,2003
30999,19,31,Roman Hamrlik,7,51,26,D,2005
31000,31,32,Roman Hamrlik,7,75,38,D,2006
31001,21,33,Roman Hamrlik,5,77,26,D,2007
31002,27,34,Roman Hamrlik,6,81,33,D,2008
31003,20,35,Roman Hamrlik,6,75,26,D,2009
31004,29,36,Roman Hamrlik,5,79,34,D,2010
31005,11,37,Roman Hamrlik,2,68,13,D,2011
31006,1,38,Roman Hamrlik,0,16,1,D,2012
31007,8,20,Roman Horak,3,61,11,C,2011
31008,5,21,Roman Horak,2,20,7,C,2012
31009,0,22,Roman Horak,1,3,1,C,2013
31010,11,21,Roman Josi,5,52,16,D,2011
31011,13,22,Roman Josi,5,48,18,D,2012
31012,27,23,Roman Josi,13,72,40,D,2013
31013,40,24,Roman Josi,15,81,55,D,2014
31014,47,25,Roman Josi,14,81,61,D,2015
31015,37,26,Roman Josi,12,72,49,D,2016
31016,39,27,Roman Josi,14,75,53,D,2017
31017,6,20,Roman Lyashenko,6,58,12,C,1999
31018,3,21,Roman Lyashenko,6,60,9,C,2000
31019,0,22,Roman Lyashenko,2,19,2,C,2001
31020,0,23,Roman Lyashenko,0,2,0,C,2002
31021,2,25,Roman Lyubimov,4,47,6,LW,2016
31022,2,23,Roman Oksiuta,1,10,3,RW,1993
31023,4,24,Roman Oksiuta,16,38,20,RW,1994
31024,28,25,Roman Oksiuta,23,70,51,RW,1995
31025,7,26,Roman Oksiuta,6,35,13,RW,1996
31026,0,20,Roman Polak,0,19,0,D,2006
31027,1,21,Roman Polak,0,6,1,D,2007
31028,14,22,Roman Polak,1,69,15,D,2008
31029,17,23,Roman Polak,4,78,21,D,2009
31030,9,24,Roman Polak,3,55,12,D,2010
31031,11,25,Roman Polak,0,77,11,D,2011
31032,5,26,Roman Polak,1,48,6,D,2012
31033,9,27,Roman Polak,4,72,13,D,2013
31034,4,28,Roman Polak,5,56,9,D,2014
31035,15,29,Roman Polak,1,79,16,D,2015
31036,7,30,Roman Polak,4,75,11,D,2016
31037,10,31,Roman Polak,2,54,12,D,2017
31038,10,29,Roman Simicek,5,57,15,C,2000
31039,0,30,Roman Simicek,2,6,2,LW,2001
31040,1,23,Roman Tvrdon,0,9,1,RW,2003
31041,3,19,Roman Vopat,2,25,5,C,1995
31042,5,20,Roman Vopat,4,29,9,C,1996
31043,3,21,Roman Vopat,0,25,3,C,1997
31044,3,22,Roman Vopat,0,54,3,C,1998
31045,0,25,Roman Wick,0,7,0,RW,2010
31046,2,28,Ron  C Anderson,5,19,7,RW,1973
31047,2,28,Ron  C Anderson,5,19,7,RW,1973
31048,0,21,Ron Andruff,0,5,0,C,1974
31049,0,22,Ron Andruff,0,1,0,C,1975
31050,18,23,Ron Andruff,4,66,22,C,1976
31051,18,24,Ron Andruff,15,78,33,C,1977
31052,0,25,Ron Andruff,0,3,0,C,1978
31053,0,22,Ron Areshenkoff,0,4,0,C,1979
31054,3,20,Ron Ashton,1,36,4,LW,1974
31055,7,32,Ron Attwell,1,22,8,C,1967
31056,1,24,Ron Boehm,2,16,3,LW,1967
31057,0,25,Ron Buchanan,0,2,0,C,1969
31058,44,28,Ron Buchanan,37,75,81,C,1972
31059,44,28,Ron Buchanan,37,75,81,C,1972
31060,27,29,Ron Buchanan,18,49,45,C,1973
31061,27,29,Ron Buchanan,18,49,45,C,1973
31062,24,30,Ron Buchanan,24,58,48,RW,1974
31063,15,30,Ron Buchanan,16,32,31,RW,1974
31064,9,30,Ron Buchanan,6,22,15,RW,1974
31065,0,30,Ron Buchanan,2,4,2,RW,1974
31066,24,30,Ron Buchanan,24,58,48,RW,1974
31067,15,30,Ron Buchanan,16,32,31,RW,1974
31068,9,30,Ron Buchanan,6,22,15,RW,1974
31069,0,30,Ron Buchanan,2,4,2,RW,1974
31070,7,31,Ron Buchanan,4,23,11,C,1975
31071,0,24,Ron Busniuk,0,1,0,D,1972
31072,3,25,Ron Busniuk,0,5,3,D,1973
31073,21,26,Ron Busniuk,2,73,23,D,1974
31074,21,26,Ron Busniuk,2,73,23,D,1974
31075,14,27,Ron Busniuk,2,70,16,D,1975
31076,14,27,Ron Busniuk,2,70,16,D,1975
31077,11,28,Ron Busniuk,3,84,14,RW,1976
31078,9,28,Ron Busniuk,1,55,10,RW,1976
31079,2,28,Ron Busniuk,2,29,4,RW,1976
31080,11,28,Ron Busniuk,3,84,14,RW,1976
31081,9,28,Ron Busniuk,1,55,10,RW,1976
31082,2,28,Ron Busniuk,2,29,4,RW,1976
31083,18,29,Ron Busniuk,2,59,20,D,1977
31084,18,29,Ron Busniuk,2,59,20,D,1977
31085,0,22,Ron C Anderson,2,18,2,RW,1967
31086,5,23,Ron C Anderson,3,63,8,RW,1968
31087,9,24,Ron C Anderson,9,59,18,RW,1969
31088,12,25,Ron C Anderson,14,74,26,RW,1970
31089,4,26,Ron C Anderson,0,37,4,RW,1971
31090,15,27,Ron C Anderson,14,73,29,RW,1972
31091,15,27,Ron C Anderson,14,73,29,RW,1972
31092,0,21,Ron Carter,0,2,0,RW,1979
31093,20,20,Ron Chipperfield,19,78,39,C,1974
31094,20,20,Ron Chipperfield,19,78,39,C,1974
31095,41,21,Ron Chipperfield,42,75,83,C,1975
31096,41,21,Ron Chipperfield,42,75,83,C,1975
31097,27,22,Ron Chipperfield,27,81,54,C,1976
31098,27,22,Ron Chipperfield,27,81,54,C,1976
31099,52,23,Ron Chipperfield,33,80,85,C,1977
31100,52,23,Ron Chipperfield,33,80,85,C,1977
31101,37,24,Ron Chipperfield,32,55,69,C,1978
31102,37,24,Ron Chipperfield,32,55,69,C,1978
31103,23,25,Ron Chipperfield,22,79,45,C,1979
31104,1,26,Ron Chipperfield,0,4,1,C,1980
31105,19,22,Ron Climie,12,31,31,LW,1972
31106,19,22,Ron Climie,12,31,31,LW,1972
31107,36,23,Ron Climie,38,76,74,LW,1973
31108,36,23,Ron Climie,38,76,74,LW,1973
31109,31,24,Ron Climie,23,74,54,LW,1974
31110,27,24,Ron Climie,15,49,42,LW,1974
31111,4,24,Ron Climie,8,25,12,LW,1974
31112,31,24,Ron Climie,23,74,54,LW,1974
31113,27,24,Ron Climie,15,49,42,LW,1974
31114,4,24,Ron Climie,8,25,12,LW,1974
31115,20,25,Ron Climie,25,65,45,LW,1975
31116,20,25,Ron Climie,25,65,45,LW,1975
31117,0,26,Ron Climie,0,3,0,LW,1976
31118,0,26,Ron Climie,0,3,0,LW,1976
31119,3,20,Ron Delorme,1,22,4,C,1975
31120,3,20,Ron Delorme,1,22,4,C,1975
31121,4,21,Ron Delorme,6,29,10,C,1976
31122,11,22,Ron Delorme,10,68,21,RW,1977
31123,8,23,Ron Delorme,20,77,28,RW,1978
31124,24,24,Ron Delorme,19,75,43,RW,1979
31125,16,25,Ron Delorme,11,65,27,C,1980
31126,8,26,Ron Delorme,9,59,17,RW,1981
31127,8,27,Ron Delorme,5,56,13,RW,1982
31128,2,28,Ron Delorme,2,64,4,RW,1983
31129,2,29,Ron Delorme,1,31,3,C,1984
31130,20,20,Ron Duguay,20,71,40,C,1977
31131,36,21,Ron Duguay,27,79,63,C,1978
31132,22,22,Ron Duguay,28,73,50,C,1979
31133,21,23,Ron Duguay,17,50,38,C,1980
31134,36,24,Ron Duguay,40,72,76,RW,1981
31135,25,25,Ron Duguay,19,72,44,RW,1982
31136,47,26,Ron Duguay,33,80,80,RW,1983
31137,51,27,Ron Duguay,38,80,89,RW,1984
31138,36,28,Ron Duguay,25,80,61,RW,1985
31139,25,29,Ron Duguay,14,74,39,C,1986
31140,10,30,Ron Duguay,6,63,16,C,1987
31141,17,31,Ron Duguay,7,70,24,C,1988
31142,20,23,Ron Ellis,28,74,48,RW,1967
31143,21,24,Ron Ellis,25,72,46,RW,1968
31144,19,25,Ron Ellis,35,76,54,RW,1969
31145,29,26,Ron Ellis,24,78,53,RW,1970
31146,24,27,Ron Ellis,23,78,47,RW,1971
31147,29,28,Ron Ellis,22,78,51,RW,1972
31148,25,29,Ron Ellis,23,70,48,RW,1973
31149,29,30,Ron Ellis,32,79,61,RW,1974
31150,24,33,Ron Ellis,26,80,50,RW,1977
31151,12,34,Ron Ellis,16,63,28,RW,1978
31152,11,35,Ron Ellis,12,59,23,RW,1979
31153,3,36,Ron Ellis,2,27,5,RW,1980
31154,26,24,Ron F. Anderson,3,74,29,D,1972
31155,26,24,Ron F. Anderson,3,74,29,D,1972
31156,0,25,Ron F. Anderson,0,2,0,D,1973
31157,0,25,Ron F. Anderson,0,2,0,D,1973
31158,9,26,Ron F. Anderson,0,39,9,D,1974
31159,9,26,Ron F. Anderson,0,39,9,D,1974
31160,7,22,Ron Fischer,0,15,7,D,1981
31161,0,23,Ron Fischer,0,3,0,D,1982
31162,7,20,Ron Flockhart,3,14,10,C,1980
31163,39,21,Ron Flockhart,33,72,72,C,1981
31164,31,22,Ron Flockhart,29,73,60,RW,1982
31165,21,23,Ron Flockhart,27,76,48,RW,1983
31166,17,24,Ron Flockhart,10,54,27,RW,1984
31167,45,25,Ron Flockhart,22,79,67,LW,1985
31168,19,26,Ron Flockhart,16,60,35,LW,1986
31169,4,27,Ron Flockhart,5,21,9,LW,1987
31170,0,28,Ron Flockhart,0,4,0,C,1988
31171,43,18,Ron Francis,25,59,68,C,1981
31172,59,19,Ron Francis,31,79,90,C,1982
31173,60,20,Ron Francis,23,72,83,C,1983
31174,57,21,Ron Francis,24,80,81,C,1984
31175,53,22,Ron Francis,24,53,77,C,1985
31176,63,23,Ron Francis,30,75,93,C,1986
31177,50,24,Ron Francis,25,80,75,C,1987
31178,48,25,Ron Francis,29,69,77,C,1988
31179,69,26,Ron Francis,32,80,101,C,1989
31180,64,27,Ron Francis,23,81,87,C,1990
31181,33,28,Ron Francis,21,70,54,C,1991
31182,76,29,Ron Francis,24,84,100,C,1992
31183,66,30,Ron Francis,27,82,93,C,1993
31184,48,31,Ron Francis,11,44,59,C,1994
31185,92,32,Ron Francis,27,77,119,C,1995
31186,63,33,Ron Francis,27,81,90,C,1996
31187,62,34,Ron Francis,25,81,87,C,1997
31188,31,35,Ron Francis,21,82,52,C,1998
31189,50,36,Ron Francis,23,78,73,C,1999
31190,50,37,Ron Francis,15,82,65,C,2000
31191,50,38,Ron Francis,27,80,77,C,2001
31192,35,39,Ron Francis,22,82,57,C,2002
31193,27,40,Ron Francis,13,80,40,C,2003
31194,0,22,Ron Friest,1,4,1,LW,1980
31195,0,23,Ron Friest,0,10,0,LW,1981
31196,7,24,Ron Friest,6,50,13,LW,1982
31197,13,24,Ron Garwasiuk,6,51,19,D,1973
31198,13,24,Ron Garwasiuk,6,51,19,D,1973
31199,37,20,Ron Greschner,8,70,45,D,1974
31200,21,21,Ron Greschner,6,77,27,D,1975
31201,36,22,Ron Greschner,11,80,47,D,1976
31202,48,23,Ron Greschner,24,78,72,D,1977
31203,36,24,Ron Greschner,17,60,53,D,1978
31204,37,25,Ron Greschner,21,76,58,D,1979
31205,41,26,Ron Greschner,27,74,68,D,1980
31206,11,27,Ron Greschner,5,29,16,D,1981
31207,5,28,Ron Greschner,3,10,8,D,1982
31208,44,29,Ron Greschner,12,77,56,D,1983
31209,29,30,Ron Greschner,16,48,45,D,1984
31210,28,31,Ron Greschner,20,78,48,D,1985
31211,34,32,Ron Greschner,6,61,40,D,1986
31212,5,33,Ron Greschner,1,51,6,D,1987
31213,10,34,Ron Greschner,1,58,11,D,1988
31214,9,35,Ron Greschner,1,55,10,D,1989
31215,7,25,Ron H Anderson,9,28,16,RW,1974
31216,0,21,Ron Hainsey,0,21,0,D,2002
31217,1,22,Ron Hainsey,1,11,2,D,2003
31218,15,24,Ron Hainsey,2,55,17,D,2005
31219,25,25,Ron Hainsey,9,80,34,D,2006
31220,24,26,Ron Hainsey,8,78,32,D,2007
31221,33,27,Ron Hainsey,6,81,39,D,2008
31222,21,28,Ron Hainsey,5,80,26,D,2009
31223,16,29,Ron Hainsey,3,82,19,D,2010
31224,10,30,Ron Hainsey,0,56,10,D,2011
31225,13,31,Ron Hainsey,0,47,13,D,2012
31226,11,32,Ron Hainsey,4,82,15,D,2013
31227,8,33,Ron Hainsey,2,81,10,D,2014
31228,14,34,Ron Hainsey,5,81,19,D,2015
31229,3,35,Ron Hainsey,0,16,3,D,2016
31230,19,36,Ron Hainsey,4,80,23,D,2017
31231,2,22,Ron Handy,0,10,2,LW,1984
31232,1,25,Ron Handy,0,4,1,LW,1987
31233,3,24,Ron Hansis,4,22,7,RW,1976
31234,3,24,Ron Hansis,4,22,7,RW,1976
31235,9,25,Ron Hansis,13,78,22,RW,1977
31236,9,25,Ron Hansis,13,78,22,RW,1977
31237,6,25,Ron Harris,4,54,10,D,1967
31238,13,26,Ron Harris,3,73,16,D,1968
31239,19,27,Ron Harris,2,72,21,D,1969
31240,8,28,Ron Harris,2,42,10,D,1970
31241,10,29,Ron Harris,1,61,11,D,1971
31242,14,30,Ron Harris,5,70,19,D,1972
31243,12,31,Ron Harris,2,63,14,D,1973
31244,7,32,Ron Harris,1,34,8,D,1974
31245,1,33,Ron Harris,0,3,1,D,1975
31246,0,21,Ron Homenuke,0,1,0,RW,1972
31247,0,23,Ron Hoover,0,2,0,C,1989
31248,0,24,Ron Hoover,4,15,4,C,1990
31249,0,25,Ron Hoover,0,1,0,C,1991
31250,10,28,Ron Huston,3,23,13,C,1973
31251,21,29,Ron Huston,12,56,33,C,1974
31252,44,30,Ron Huston,22,79,66,C,1975
31253,44,30,Ron Huston,22,79,66,C,1975
31254,39,31,Ron Huston,20,80,59,C,1976
31255,39,31,Ron Huston,20,80,59,C,1976
31256,0,20,Ron Jones,0,1,0,D,1971
31257,0,21,Ron Jones,0,7,0,D,1972
31258,3,22,Ron Jones,0,25,3,D,1973
31259,1,23,Ron Jones,1,19,2,D,1974
31260,0,24,Ron Jones,0,2,0,D,1975
31261,1,22,Ron L Wilson,2,13,3,D,1977
31262,12,23,Ron L Wilson,5,46,17,D,1978
31263,2,24,Ron L Wilson,0,5,2,D,1979
31264,8,29,Ron L Wilson,4,13,12,D,1984
31265,3,30,Ron L Wilson,1,11,4,LW,1985
31266,29,31,Ron L Wilson,12,65,41,D,1986
31267,12,32,Ron L Wilson,2,24,14,D,1987
31268,0,20,Ron Lalonde,0,9,0,C,1972
31269,17,21,Ron Lalonde,10,73,27,C,1973
31270,17,22,Ron Lalonde,12,74,29,C,1974
31271,19,23,Ron Lalonde,9,80,28,C,1975
31272,17,24,Ron Lalonde,12,76,29,C,1976
31273,5,25,Ron Lalonde,1,67,6,C,1977
31274,3,26,Ron Lalonde,1,18,4,C,1978
31275,1,18,Ron Meighan,1,7,2,D,1981
31276,6,19,Ron Meighan,2,41,8,D,1982
31277,1,22,Ron Morgan,0,4,1,LW,1973
31278,1,22,Ron Morgan,0,4,1,LW,1973
31279,1,34,Ron Murphy,0,12,1,LW,1967
31280,38,35,Ron Murphy,16,60,54,LW,1968
31281,5,36,Ron Murphy,2,20,7,LW,1969
31282,41,22,Ron Plumb,10,78,51,D,1972
31283,41,22,Ron Plumb,10,78,51,D,1972
31284,32,23,Ron Plumb,6,75,38,D,1973
31285,32,23,Ron Plumb,6,75,38,D,1973
31286,38,24,Ron Plumb,10,78,48,D,1974
31287,38,24,Ron Plumb,10,78,48,D,1974
31288,36,25,Ron Plumb,10,80,46,D,1975
31289,36,25,Ron Plumb,10,80,46,D,1975
31290,58,26,Ron Plumb,11,79,69,D,1976
31291,58,26,Ron Plumb,11,79,69,D,1976
31292,43,27,Ron Plumb,14,81,57,D,1977
31293,34,27,Ron Plumb,13,54,47,D,1977
31294,9,27,Ron Plumb,1,27,10,D,1977
31295,34,27,Ron Plumb,13,54,47,D,1977
31296,9,27,Ron Plumb,1,27,10,D,1977
31297,16,28,Ron Plumb,4,78,20,D,1978
31298,4,29,Ron Plumb,3,26,7,D,1979
31299,5,24,Ron Riley,0,22,5,LW,1972
31300,5,24,Ron Riley,0,22,5,LW,1972
31301,9,24,Ron Schock,9,55,18,C,1967
31302,27,25,Ron Schock,12,67,39,C,1968
31303,21,26,Ron Schock,8,76,29,C,1969
31304,26,27,Ron Schock,14,71,40,C,1970
31305,29,28,Ron Schock,17,77,46,C,1971
31306,36,29,Ron Schock,13,78,49,C,1972
31307,29,30,Ron Schock,14,77,43,C,1973
31308,63,31,Ron Schock,23,80,86,C,1974
31309,44,32,Ron Schock,18,80,62,C,1975
31310,32,33,Ron Schock,17,80,49,C,1976
31311,4,34,Ron Schock,4,40,8,C,1977
31312,4,20,Ron Sedlbauer,3,26,7,LW,1974
31313,13,21,Ron Sedlbauer,19,56,32,LW,1975
31314,20,22,Ron Sedlbauer,18,70,38,LW,1976
31315,12,23,Ron Sedlbauer,18,62,30,LW,1977
31316,16,24,Ron Sedlbauer,40,79,56,LW,1978
31317,14,25,Ron Sedlbauer,23,77,37,LW,1979
31318,7,26,Ron Sedlbauer,22,60,29,LW,1980
31319,0,20,Ron Serafini,0,2,0,D,1973
31320,2,22,Ron Serafini,0,16,2,D,1975
31321,2,22,Ron Serafini,0,16,2,D,1975
31322,5,20,Ron Shudra,0,10,5,D,1987
31323,1,20,Ron Smith,1,11,2,D,1972
31324,1,20,Ron Snell,3,4,4,RW,1968
31325,1,21,Ron Snell,0,3,1,RW,1969
31326,25,25,Ron Snell,24,70,49,RW,1973
31327,25,25,Ron Snell,24,70,49,RW,1973
31328,0,26,Ron Snell,0,20,0,RW,1974
31329,0,26,Ron Snell,0,20,0,RW,1974
31330,24,21,Ron Stackhouse,8,78,32,D,1970
31331,28,22,Ron Stackhouse,6,79,34,D,1971
31332,29,23,Ron Stackhouse,5,78,34,D,1972
31333,29,24,Ron Stackhouse,6,69,35,D,1973
31334,45,25,Ron Stackhouse,15,72,60,D,1974
31335,60,26,Ron Stackhouse,11,80,71,D,1975
31336,34,27,Ron Stackhouse,7,80,41,D,1976
31337,15,28,Ron Stackhouse,5,50,20,D,1977
31338,33,29,Ron Stackhouse,10,75,43,D,1978
31339,27,30,Ron Stackhouse,6,78,33,D,1979
31340,29,31,Ron Stackhouse,6,74,35,D,1980
31341,19,32,Ron Stackhouse,2,76,21,D,1981
31342,0,21,Ron Stern,0,15,0,RW,1987
31343,0,22,Ron Stern,1,17,1,RW,1988
31344,3,23,Ron Stern,2,34,5,RW,1989
31345,6,24,Ron Stern,3,44,9,RW,1990
31346,9,25,Ron Stern,13,72,22,RW,1991
31347,15,26,Ron Stern,10,70,25,RW,1992
31348,20,27,Ron Stern,9,71,29,RW,1993
31349,4,28,Ron Stern,9,39,13,RW,1994
31350,5,29,Ron Stern,10,52,15,RW,1995
31351,10,30,Ron Stern,7,79,17,RW,1996
31352,9,32,Ron Stern,7,78,16,RW,1998
31353,5,33,Ron Stern,4,67,9,RW,1999
31354,12,35,Ron Stewart,14,74,26,RW,1967
31355,11,36,Ron Stewart,18,75,29,RW,1968
31356,10,37,Ron Stewart,14,76,24,RW,1969
31357,6,38,Ron Stewart,5,76,11,C,1970
31358,3,39,Ron Stewart,3,55,6,RW,1971
31359,3,40,Ron Stewart,2,33,5,RW,1972
31360,1,19,Ron Sutter,1,10,2,C,1982
31361,32,20,Ron Sutter,19,79,51,C,1983
31362,29,21,Ron Sutter,16,73,45,C,1984
31363,42,22,Ron Sutter,18,75,60,C,1985
31364,17,23,Ron Sutter,10,39,27,C,1986
31365,25,24,Ron Sutter,8,69,33,C,1987
31366,22,25,Ron Sutter,26,55,48,C,1988
31367,26,26,Ron Sutter,22,75,48,C,1989
31368,28,27,Ron Sutter,17,80,45,C,1990
31369,27,28,Ron Sutter,19,68,46,C,1991
31370,15,29,Ron Sutter,12,59,27,C,1992
31371,25,30,Ron Sutter,15,73,40,C,1993
31372,4,31,Ron Sutter,1,27,5,C,1994
31373,7,32,Ron Sutter,5,18,12,C,1995
31374,7,33,Ron Sutter,5,78,12,C,1996
31375,7,34,Ron Sutter,2,57,9,RW,1997
31376,6,35,Ron Sutter,3,59,9,C,1998
31377,6,36,Ron Sutter,5,78,11,C,1999
31378,3,37,Ron Sutter,1,21,4,C,2000
31379,0,24,Ron Talakoski,0,3,0,RW,1986
31380,1,25,Ron Talakoski,0,6,1,RW,1987
31381,26,24,Ron Walters,28,78,54,C,1972
31382,26,24,Ron Walters,28,78,54,C,1972
31383,14,25,Ron Walters,14,71,28,C,1973
31384,14,25,Ron Walters,14,71,28,C,1973
31385,1,26,Ron Walters,2,17,3,RW,1974
31386,1,26,Ron Walters,2,17,3,RW,1974
31387,1,25,Ron Ward,0,18,1,C,1969
31388,4,27,Ron Ward,2,71,6,C,1971
31389,67,28,Ron Ward,51,77,118,C,1972
31390,67,28,Ron Ward,51,77,118,C,1972
31391,28,29,Ron Ward,33,70,61,C,1973
31392,19,29,Ron Ward,14,40,33,C,1973
31393,7,29,Ron Ward,19,23,26,C,1973
31394,2,29,Ron Ward,0,7,2,C,1973
31395,28,29,Ron Ward,33,70,61,C,1973
31396,19,29,Ron Ward,14,40,33,C,1973
31397,7,29,Ron Ward,19,23,26,C,1973
31398,2,29,Ron Ward,0,7,2,C,1973
31399,32,30,Ron Ward,30,73,62,C,1974
31400,32,30,Ron Ward,30,73,62,C,1974
31401,50,31,Ron Ward,32,75,82,C,1975
31402,50,31,Ron Ward,32,75,82,C,1975
31403,33,32,Ron Ward,24,64,57,C,1976
31404,21,32,Ron Ward,15,41,36,C,1976
31405,7,32,Ron Ward,4,14,11,C,1976
31406,5,32,Ron Ward,5,9,10,C,1976
31407,33,32,Ron Ward,24,64,57,C,1976
31408,21,32,Ron Ward,15,41,36,C,1976
31409,7,32,Ron Ward,4,14,11,C,1976
31410,5,32,Ron Ward,5,9,10,C,1976
31411,36,23,Ron Wilson,21,79,57,LW,1979
31412,33,24,Ron Wilson,18,77,51,C,1980
31413,13,25,Ron Wilson,3,39,16,C,1981
31414,3,26,Ron Wilson,6,12,9,C,1982
31415,12,27,Ron Wilson,3,51,15,C,1983
31416,9,28,Ron Wilson,10,75,19,C,1984
31417,7,29,Ron Wilson,6,54,13,C,1985
31418,13,30,Ron Wilson,3,80,16,C,1986
31419,8,31,Ron Wilson,5,69,13,C,1987
31420,17,33,Ron Wilson,3,33,20,C,1989
31421,27,34,Ron Wilson,10,73,37,C,1990
31422,17,35,Ron Wilson,12,64,29,C,1991
31423,11,36,Ron Wilson,8,78,19,C,1992
31424,10,37,Ron Wilson,2,48,12,C,1993
31425,17,21,Ron Zanussi,15,68,32,RW,1977
31426,16,22,Ron Zanussi,14,63,30,RW,1978
31427,31,23,Ron Zanussi,14,72,45,RW,1979
31428,11,24,Ron Zanussi,9,53,20,RW,1980
31429,8,25,Ron Zanussi,0,43,8,RW,1981
31430,5,23,Ronald Petrovicky,4,30,9,RW,2000
31431,7,24,Ronald Petrovicky,5,77,12,RW,2001
31432,9,25,Ronald Petrovicky,5,66,14,LW,2002
31433,15,26,Ronald Petrovicky,16,78,31,RW,2003
31434,12,28,Ronald Petrovicky,8,60,20,RW,2005
31435,3,29,Ronald Petrovicky,3,31,6,RW,2006
31436,8,23,Ronalds Kenins,4,30,12,LW,2014
31437,0,24,Ronalds Kenins,0,8,0,LW,2015
31438,0,27,Ronnie Sundin,0,1,0,D,1997
31439,2,21,Rory Fitzpatrick,0,42,2,D,1995
31440,1,22,Rory Fitzpatrick,0,8,1,D,1996
31441,0,24,Rory Fitzpatrick,0,1,0,D,1998
31442,0,26,Rory Fitzpatrick,0,2,0,D,2000
31443,0,27,Rory Fitzpatrick,0,5,0,D,2001
31444,3,28,Rory Fitzpatrick,1,36,4,D,2002
31445,7,29,Rory Fitzpatrick,4,60,11,D,2003
31446,5,31,Rory Fitzpatrick,4,56,9,D,2005
31447,6,32,Rory Fitzpatrick,1,58,7,D,2006
31448,1,33,Rory Fitzpatrick,0,19,1,D,2007
31449,0,22,Rosaire Paiement,1,7,1,RW,1967
31450,4,23,Rosaire Paiement,2,27,6,RW,1968
31451,1,24,Rosaire Paiement,1,9,2,RW,1969
31452,28,25,Rosaire Paiement,34,78,62,RW,1970
31453,19,26,Rosaire Paiement,10,69,29,RW,1971
31454,36,27,Rosaire Paiement,33,78,69,RW,1972
31455,43,28,Rosaire Paiement,30,78,73,RW,1973
31456,48,29,Rosaire Paiement,26,78,74,RW,1974
31457,48,29,Rosaire Paiement,26,78,74,RW,1974
31458,43,30,Rosaire Paiement,28,80,71,C,1975
31459,43,30,Rosaire Paiement,28,80,71,C,1975
31460,27,31,Rosaire Paiement,23,80,50,C,1976
31461,25,31,Rosaire Paiement,18,67,43,C,1976
31462,2,31,Rosaire Paiement,5,13,7,C,1976
31463,27,31,Rosaire Paiement,23,80,50,C,1976
31464,25,31,Rosaire Paiement,18,67,43,C,1976
31465,2,31,Rosaire Paiement,5,13,7,C,1976
31466,24,32,Rosaire Paiement,6,61,30,RW,1977
31467,24,32,Rosaire Paiement,6,61,30,RW,1977
31468,9,22,Ross Cory,2,46,11,D,1979
31469,1,23,Ross Cory,0,5,1,D,1980
31470,0,22,Ross Fitzpatrick,0,1,0,C,1982
31471,2,23,Ross Fitzpatrick,4,12,6,C,1983
31472,0,24,Ross Fitzpatrick,1,5,1,C,1984
31473,0,25,Ross Fitzpatrick,0,2,0,C,1985
31474,0,21,Ross Johnston,0,1,0,LW,2015
31475,3,23,Ross Johnston,3,24,6,LW,2017
31476,2,20,Ross Lonsberry,2,19,4,LW,1967
31477,0,21,Ross Lonsberry,0,6,0,LW,1968
31478,22,22,Ross Lonsberry,20,76,42,LW,1969
31479,28,23,Ross Lonsberry,25,76,53,LW,1970
31480,21,24,Ross Lonsberry,16,82,37,LW,1971
31481,29,25,Ross Lonsberry,21,77,50,LW,1972
31482,19,26,Ross Lonsberry,32,75,51,LW,1973
31483,25,27,Ross Lonsberry,24,80,49,LW,1974
31484,28,28,Ross Lonsberry,19,80,47,LW,1975
31485,32,29,Ross Lonsberry,23,75,55,LW,1976
31486,30,30,Ross Lonsberry,18,78,48,LW,1977
31487,22,31,Ross Lonsberry,24,80,46,LW,1978
31488,18,32,Ross Lonsberry,15,76,33,LW,1979
31489,33,33,Ross Lonsberry,17,80,50,LW,1980
31490,0,22,Ross Lupaschuk,0,3,0,D,2002
31491,37,26,Ross Perkins,21,71,58,C,1972
31492,40,27,Ross Perkins,16,78,56,C,1973
31493,40,27,Ross Perkins,16,78,56,C,1973
31494,16,28,Ross Perkins,7,76,23,C,1974
31495,16,28,Ross Perkins,7,76,23,C,1974
31496,6,21,Ross Smith,1,15,7,LW,1974
31497,1,24,Ross Yates,1,7,2,C,1983
31498,0,18,Rostislav Klesla,2,8,2,D,2000
31499,8,19,Rostislav Klesla,8,75,16,D,2001
31500,14,20,Rostislav Klesla,2,72,16,D,2002
31501,11,21,Rostislav Klesla,2,47,13,D,2003
31502,13,23,Rostislav Klesla,6,51,19,D,2005
31503,13,24,Rostislav Klesla,9,75,22,D,2006
31504,12,25,Rostislav Klesla,6,82,18,D,2007
31505,8,26,Rostislav Klesla,1,34,9,D,2008
31506,6,27,Rostislav Klesla,2,26,8,D,2009
31507,7,28,Rostislav Klesla,4,61,11,D,2010
31508,10,29,Rostislav Klesla,3,65,13,D,2011
31509,6,30,Rostislav Klesla,2,38,8,D,2012
31510,3,31,Rostislav Klesla,1,25,4,D,2013
31511,13,20,Rostislav Olesz,8,59,21,C,2005
31512,19,21,Rostislav Olesz,11,75,30,C,2006
31513,12,22,Rostislav Olesz,14,56,26,LW,2007
31514,5,23,Rostislav Olesz,4,37,9,LW,2008
31515,15,24,Rostislav Olesz,14,78,29,C,2009
31516,11,25,Rostislav Olesz,6,44,17,C,2010
31517,0,26,Rostislav Olesz,0,6,0,C,2011
31518,2,28,Rostislav Olesz,0,10,2,LW,2013
31519,0,23,Roy Mitchell,0,3,0,D,1992
31520,0,23,Roy Sommer,1,3,1,C,1980
31521,0,,Rudolf Slavik,0,5,0,RW,1977
31522,0,,Rudolf Slavik,0,5,0,RW,1977
31523,0,21,Rudy Poeschek,0,1,0,D,1987
31524,2,22,Rudy Poeschek,0,52,2,D,1988
31525,0,23,Rudy Poeschek,0,15,0,RW,1989
31526,0,24,Rudy Poeschek,0,1,0,D,1990
31527,0,25,Rudy Poeschek,0,4,0,D,1991
31528,6,27,Rudy Poeschek,3,71,9,D,1993
31529,1,28,Rudy Poeschek,1,25,2,D,1994
31530,3,29,Rudy Poeschek,1,57,4,RW,1995
31531,6,30,Rudy Poeschek,0,60,6,RW,1996
31532,7,31,Rudy Poeschek,1,50,8,D,1997
31533,0,32,Rudy Poeschek,0,16,0,D,1998
31534,0,33,Rudy Poeschek,0,12,0,D,1999
31535,0,30,Rudy Tajcnar,0,2,0,D,1978
31536,0,30,Rudy Tajcnar,0,2,0,D,1978
31537,0,21,Rumun Ndur,0,2,0,D,1996
31538,0,22,Rumun Ndur,0,1,0,D,1997
31539,3,23,Rumun Ndur,1,39,4,D,1998
31540,0,24,Rumun Ndur,1,27,1,D,1999
31541,0,20,Ruslan Batyrshin,0,2,0,D,1995
31542,20,22,Ruslan Fedotenko,16,74,36,LW,2000
31543,9,23,Ruslan Fedotenko,17,78,26,RW,2001
31544,13,24,Ruslan Fedotenko,19,76,32,LW,2002
31545,22,25,Ruslan Fedotenko,17,77,39,LW,2003
31546,15,27,Ruslan Fedotenko,26,80,41,LW,2005
31547,20,28,Ruslan Fedotenko,12,80,32,LW,2006
31548,17,29,Ruslan Fedotenko,16,67,33,LW,2007
31549,23,30,Ruslan Fedotenko,16,65,39,LW,2008
31550,19,31,Ruslan Fedotenko,11,80,30,LW,2009
31551,15,32,Ruslan Fedotenko,10,66,25,LW,2010
31552,11,33,Ruslan Fedotenko,9,73,20,LW,2011
31553,9,34,Ruslan Fedotenko,4,47,13,LW,2012
31554,1,22,Ruslan Salei,0,30,1,D,1996
31555,10,23,Ruslan Salei,5,66,15,D,1997
31556,14,24,Ruslan Salei,2,74,16,D,1998
31557,5,25,Ruslan Salei,5,71,10,D,1999
31558,5,26,Ruslan Salei,1,50,6,D,2000
31559,7,27,Ruslan Salei,4,82,11,D,2001
31560,8,28,Ruslan Salei,4,61,12,D,2002
31561,11,29,Ruslan Salei,4,82,15,D,2003
31562,18,31,Ruslan Salei,1,78,19,D,2005
31563,26,32,Ruslan Salei,6,82,32,D,2006
31564,24,33,Ruslan Salei,6,82,30,D,2007
31565,17,34,Ruslan Salei,4,70,21,D,2008
31566,5,35,Ruslan Salei,1,14,6,D,2009
31567,8,36,Ruslan Salei,2,75,10,D,2010
31568,2,21,Russ Adam,1,8,3,C,1982
31569,11,21,Russ Anderson,2,66,13,D,1976
31570,16,22,Russ Anderson,2,74,18,D,1977
31571,13,23,Russ Anderson,3,72,16,D,1978
31572,22,24,Russ Anderson,5,76,27,D,1979
31573,14,25,Russ Anderson,3,34,17,D,1980
31574,4,26,Russ Anderson,1,56,5,D,1981
31575,6,27,Russ Anderson,0,57,6,D,1982
31576,12,28,Russ Anderson,5,70,17,D,1983
31577,1,29,Russ Anderson,1,14,2,D,1984
31578,9,18,Russ Courtnall,3,14,12,C,1983
31579,10,19,Russ Courtnall,12,69,22,C,1984
31580,38,20,Russ Courtnall,22,73,60,C,1985
31581,44,21,Russ Courtnall,29,79,73,C,1986
31582,26,22,Russ Courtnall,23,65,49,C,1987
31583,18,23,Russ Courtnall,23,73,41,RW,1988
31584,32,24,Russ Courtnall,27,80,59,RW,1989
31585,50,25,Russ Courtnall,26,79,76,RW,1990
31586,14,26,Russ Courtnall,7,27,21,RW,1991
31587,43,27,Russ Courtnall,36,84,79,RW,1992
31588,57,28,Russ Courtnall,23,84,80,RW,1993
31589,24,29,Russ Courtnall,11,45,35,RW,1994
31590,39,30,Russ Courtnall,26,81,65,RW,1995
31591,24,31,Russ Courtnall,11,61,35,RW,1996
31592,6,32,Russ Courtnall,12,58,18,RW,1997
31593,13,33,Russ Courtnall,6,57,19,RW,1998
31594,14,20,Russ Walker,15,76,29,RW,1973
31595,14,20,Russ Walker,15,76,29,RW,1973
31596,11,21,Russ Walker,14,66,25,RW,1974
31597,11,21,Russ Walker,14,66,25,RW,1974
31598,15,22,Russ Walker,23,72,38,RW,1975
31599,15,22,Russ Walker,23,72,38,RW,1975
31600,0,23,Russ Walker,1,16,1,RW,1976
31601,0,24,Russ Walker,0,1,0,RW,1977
31602,5,21,Russell Romaniuk,3,27,8,LW,1991
31603,1,22,Russell Romaniuk,3,28,4,LW,1992
31604,8,23,Russell Romaniuk,4,24,12,LW,1993
31605,0,24,Russell Romaniuk,0,6,0,LW,1994
31606,0,25,Russell Romaniuk,3,17,3,LW,1995
31607,0,22,Rusty Fitzgerald,1,4,1,LW,1994
31608,2,23,Rusty Fitzgerald,1,21,3,C,1995
31609,27,23,Rusty Patenaude,29,78,56,RW,1972
31610,27,23,Rusty Patenaude,29,78,56,RW,1972
31611,23,24,Rusty Patenaude,20,71,43,RW,1973
31612,23,24,Rusty Patenaude,20,71,43,RW,1973
31613,16,25,Rusty Patenaude,20,56,36,RW,1974
31614,16,25,Rusty Patenaude,20,56,36,RW,1974
31615,30,26,Rusty Patenaude,42,77,72,RW,1975
31616,30,26,Rusty Patenaude,42,77,72,RW,1975
31617,16,27,Rusty Patenaude,25,73,41,RW,1976
31618,16,27,Rusty Patenaude,25,73,41,RW,1976
31619,19,28,Rusty Patenaude,23,76,42,RW,1977
31620,19,28,Rusty Patenaude,23,76,42,RW,1977
31621,0,24,Ryan Barnes,0,2,0,LW,2003
31622,1,23,Ryan Bast,0,2,1,D,1998
31623,10,22,Ryan Bayda,4,25,14,LW,2002
31624,3,23,Ryan Bayda,3,44,6,LW,2003
31625,1,26,Ryan Bayda,1,9,2,LW,2006
31626,3,27,Ryan Bayda,3,31,6,LW,2007
31627,7,28,Ryan Bayda,5,70,12,LW,2008
31628,0,20,Ryan Bonni,0,3,0,D,1999
31629,0,24,Ryan Bourque,0,1,0,LW,2014
31630,0,24,Ryan Caldwell,0,2,0,D,2005
31631,0,26,Ryan Caldwell,0,2,0,D,2007
31632,2,21,Ryan Callahan,4,14,6,RW,2006
31633,5,22,Ryan Callahan,8,52,13,RW,2007
31634,18,23,Ryan Callahan,22,81,40,RW,2008
31635,18,24,Ryan Callahan,19,77,37,RW,2009
31636,25,25,Ryan Callahan,23,60,48,RW,2010
31637,25,26,Ryan Callahan,29,76,54,RW,2011
31638,15,27,Ryan Callahan,16,45,31,RW,2012
31639,19,28,Ryan Callahan,17,65,36,RW,2013
31640,30,29,Ryan Callahan,24,77,54,RW,2014
31641,18,30,Ryan Callahan,10,73,28,RW,2015
31642,2,31,Ryan Callahan,2,18,4,RW,2016
31643,13,32,Ryan Callahan,5,67,18,RW,2017
31644,0,25,Ryan Carpenter,0,1,0,C,2015
31645,2,26,Ryan Carpenter,2,11,4,C,2016
31646,1,27,Ryan Carpenter,0,16,1,C,2017
31647,4,24,Ryan Carter,4,34,8,C,2007
31648,6,25,Ryan Carter,3,48,9,C,2008
31649,5,26,Ryan Carter,4,38,9,C,2009
31650,6,27,Ryan Carter,3,62,9,C,2010
31651,4,28,Ryan Carter,4,72,8,C,2011
31652,9,29,Ryan Carter,6,44,15,C,2012
31653,3,30,Ryan Carter,7,62,10,C,2013
31654,10,31,Ryan Carter,3,53,13,C,2014
31655,5,32,Ryan Carter,7,60,12,LW,2015
31656,0,21,Ryan Christie,0,5,0,LW,1999
31657,0,23,Ryan Christie,0,2,0,LW,2001
31658,13,24,Ryan Craig,15,48,28,C,2005
31659,13,25,Ryan Craig,14,72,27,C,2006
31660,1,26,Ryan Craig,1,7,2,C,2007
31661,4,27,Ryan Craig,2,54,6,C,2008
31662,0,28,Ryan Craig,0,3,0,C,2009
31663,0,29,Ryan Craig,0,6,0,C,2010
31664,0,32,Ryan Craig,0,6,0,C,2013
31665,0,33,Ryan Craig,0,2,0,C,2014
31666,4,21,Ryan Donato,5,12,9,C,2017
31667,6,,Ryan Dzingel,3,30,9,LW,2015
31668,18,24,Ryan Dzingel,14,81,32,LW,2016
31669,18,25,Ryan Dzingel,23,79,41,LW,2017
31670,8,21,Ryan Ellis,3,32,11,D,2011
31671,4,22,Ryan Ellis,2,32,6,D,2012
31672,21,23,Ryan Ellis,6,80,27,D,2013
31673,18,24,Ryan Ellis,9,58,27,D,2014
31674,22,25,Ryan Ellis,10,79,32,D,2015
31675,22,26,Ryan Ellis,16,71,38,D,2016
31676,23,27,Ryan Ellis,9,44,32,D,2017
31677,0,21,Ryan Flinn,0,10,0,LW,2001
31678,0,22,Ryan Flinn,1,19,1,LW,2002
31679,0,25,Ryan Flinn,0,2,0,LW,2005
31680,1,26,Ryan Garbutt,2,20,3,C,2011
31681,7,27,Ryan Garbutt,3,36,10,C,2012
31682,15,28,Ryan Garbutt,17,75,32,LW,2013
31683,17,29,Ryan Garbutt,8,67,25,LW,2014
31684,7,30,Ryan Garbutt,7,80,14,C,2015
31685,1,31,Ryan Garbutt,2,27,3,LW,2016
31686,25,20,Ryan Getzlaf,14,57,39,C,2005
31687,33,21,Ryan Getzlaf,25,82,58,C,2006
31688,58,22,Ryan Getzlaf,24,77,82,C,2007
31689,66,23,Ryan Getzlaf,25,81,91,C,2008
31690,50,24,Ryan Getzlaf,19,66,69,C,2009
31691,57,25,Ryan Getzlaf,19,67,76,C,2010
31692,46,26,Ryan Getzlaf,11,82,57,C,2011
31693,34,27,Ryan Getzlaf,15,44,49,C,2012
31694,56,28,Ryan Getzlaf,31,77,87,C,2013
31695,45,29,Ryan Getzlaf,25,77,70,C,2014
31696,50,30,Ryan Getzlaf,13,77,63,C,2015
31697,58,31,Ryan Getzlaf,15,74,73,C,2016
31698,50,32,Ryan Getzlaf,11,56,61,C,2017
31699,1,26,Ryan Hamilton,0,2,1,LW,2011
31700,2,27,Ryan Hamilton,0,10,2,LW,2012
31701,0,28,Ryan Hamilton,0,2,0,LW,2013
31702,1,29,Ryan Hamilton,1,16,2,LW,2014
31703,0,20,Ryan Hartman,0,5,0,RW,2014
31704,1,21,Ryan Hartman,0,3,1,RW,2015
31705,12,22,Ryan Hartman,19,76,31,LW,2016
31706,3,23,Ryan Hartman,3,21,6,RW,2017
31707,3,22,Ryan Hollweg,2,52,5,C,2005
31708,2,23,Ryan Hollweg,1,78,3,C,2006
31709,2,24,Ryan Hollweg,2,70,4,LW,2007
31710,2,25,Ryan Hollweg,0,25,2,LW,2008
31711,0,27,Ryan Hollweg,0,3,0,C,2010
31712,0,24,Ryan Hughes,0,3,0,C,1995
31713,0,22,Ryan Huska,0,1,0,LW,1997
31714,2,21,Ryan Jardine,0,8,2,LW,2001
31715,12,19,Ryan Johansen,9,67,21,C,2011
31716,7,20,Ryan Johansen,5,40,12,C,2012
31717,30,21,Ryan Johansen,33,82,63,C,2013
31718,45,22,Ryan Johansen,26,82,71,C,2014
31719,46,23,Ryan Johansen,14,80,60,C,2015
31720,47,24,Ryan Johansen,14,82,61,C,2016
31721,39,25,Ryan Johansen,15,79,54,C,2017
31722,2,21,Ryan Johnson,0,10,2,C,1997
31723,0,22,Ryan Johnson,1,1,1,C,1998
31724,14,23,Ryan Johnson,4,80,18,C,1999
31725,14,24,Ryan Johnson,7,80,21,C,2000
31726,3,25,Ryan Johnson,1,29,4,C,2001
31727,5,26,Ryan Johnson,2,75,7,C,2002
31728,7,27,Ryan Johnson,4,69,11,C,2003
31729,6,29,Ryan Johnson,3,65,9,C,2005
31730,4,30,Ryan Johnson,7,59,11,C,2006
31731,13,31,Ryan Johnson,5,79,18,C,2007
31732,7,32,Ryan Johnson,2,62,9,C,2008
31733,4,33,Ryan Johnson,1,58,5,C,2009
31734,5,34,Ryan Johnson,1,34,6,C,2010
31735,0,23,Ryan Johnston,0,3,0,D,2015
31736,0,24,Ryan Johnston,0,7,0,D,2016
31737,10,24,Ryan Jones,7,46,17,LW,2008
31738,4,25,Ryan Jones,8,49,12,LW,2009
31739,7,26,Ryan Jones,18,81,25,LW,2010
31740,16,27,Ryan Jones,17,79,33,LW,2011
31741,5,28,Ryan Jones,2,27,7,LW,2012
31742,4,29,Ryan Jones,2,52,6,LW,2013
31743,0,26,Ryan Keller,0,6,0,RW,2009
31744,3,19,Ryan Kesler,2,28,5,C,2003
31745,13,21,Ryan Kesler,10,82,23,C,2005
31746,10,22,Ryan Kesler,6,48,16,C,2006
31747,16,23,Ryan Kesler,21,80,37,C,2007
31748,33,24,Ryan Kesler,26,82,59,C,2008
31749,50,25,Ryan Kesler,25,82,75,C,2009
31750,32,26,Ryan Kesler,41,82,73,C,2010
31751,27,27,Ryan Kesler,22,77,49,C,2011
31752,9,28,Ryan Kesler,4,17,13,C,2012
31753,18,29,Ryan Kesler,25,77,43,C,2013
31754,27,30,Ryan Kesler,20,81,47,C,2014
31755,32,31,Ryan Kesler,21,79,53,C,2015
31756,36,32,Ryan Kesler,22,82,58,C,2016
31757,6,33,Ryan Kesler,8,44,14,C,2017
31758,1,27,Ryan Kraft,0,7,1,C,2002
31759,1,23,Ryan Lomberg,0,7,1,LW,2017
31760,21,24,Ryan Malone,22,81,43,LW,2003
31761,22,26,Ryan Malone,22,77,44,LW,2005
31762,15,27,Ryan Malone,16,64,31,LW,2006
31763,24,28,Ryan Malone,27,77,51,LW,2007
31764,19,29,Ryan Malone,26,70,45,LW,2008
31765,26,30,Ryan Malone,21,69,47,LW,2009
31766,24,31,Ryan Malone,14,54,38,LW,2010
31767,28,32,Ryan Malone,20,68,48,LW,2011
31768,2,33,Ryan Malone,6,24,8,LW,2012
31769,10,34,Ryan Malone,5,57,15,LW,2013
31770,0,35,Ryan Malone,0,6,0,LW,2014
31771,8,21,Ryan McDonagh,1,40,9,D,2010
31772,25,22,Ryan McDonagh,7,82,32,D,2011
31773,15,23,Ryan McDonagh,4,47,19,D,2012
31774,29,24,Ryan McDonagh,14,77,43,D,2013
31775,25,25,Ryan McDonagh,8,71,33,D,2014
31776,25,26,Ryan McDonagh,9,73,34,D,2015
31777,36,27,Ryan McDonagh,6,77,42,D,2016
31778,1,28,Ryan McDonagh,2,14,3,D,2017
31779,2,22,Ryan McGill,0,9,2,D,1991
31780,10,23,Ryan McGill,3,72,13,D,1992
31781,3,24,Ryan McGill,1,50,4,D,1993
31782,0,25,Ryan McGill,0,20,0,D,1994
31783,0,25,Ryan Mulhern,0,3,0,C,1997
31784,0,19,Ryan Murphy,0,4,0,D,2012
31785,10,20,Ryan Murphy,2,48,12,D,2013
31786,9,21,Ryan Murphy,4,37,13,D,2014
31787,10,22,Ryan Murphy,0,35,10,D,2015
31788,2,23,Ryan Murphy,0,27,2,D,2016
31789,3,24,Ryan Murphy,2,21,5,D,2017
31790,17,20,Ryan Murray,4,66,21,D,2013
31791,2,21,Ryan Murray,1,12,3,D,2014
31792,21,22,Ryan Murray,4,82,25,D,2015
31793,9,23,Ryan Murray,2,60,11,D,2016
31794,11,24,Ryan Murray,1,44,12,D,2017
31795,34,18,Ryan Nugent-Hopkins,18,62,52,C,2011
31796,20,19,Ryan Nugent-Hopkins,4,40,24,C,2012
31797,37,20,Ryan Nugent-Hopkins,19,80,56,C,2013
31798,32,21,Ryan Nugent-Hopkins,24,76,56,C,2014
31799,22,22,Ryan Nugent-Hopkins,12,55,34,C,2015
31800,25,23,Ryan Nugent-Hopkins,18,82,43,C,2016
31801,24,24,Ryan Nugent-Hopkins,24,62,48,C,2017
31802,6,23,Ryan O'Byrne,1,33,7,D,2007
31803,5,24,Ryan O'Byrne,0,37,5,D,2008
31804,3,25,Ryan O'Byrne,1,55,4,D,2009
31805,10,26,Ryan O'Byrne,0,67,10,D,2010
31806,6,27,Ryan O'Byrne,1,74,7,D,2011
31807,4,28,Ryan O'Byrne,2,42,6,D,2012
31808,1,22,Ryan O'Marra,0,3,1,C,2009
31809,4,23,Ryan O'Marra,1,21,5,C,2010
31810,1,24,Ryan O'Marra,0,9,1,C,2011
31811,18,18,Ryan O'Reilly,8,81,26,C,2009
31812,13,19,Ryan O'Reilly,13,74,26,C,2010
31813,37,20,Ryan O'Reilly,18,81,55,C,2011
31814,14,21,Ryan O'Reilly,6,29,20,C,2012
31815,36,22,Ryan O'Reilly,28,80,64,C,2013
31816,38,23,Ryan O'Reilly,17,82,55,C,2014
31817,39,24,Ryan O'Reilly,21,71,60,C,2015
31818,35,25,Ryan O'Reilly,20,72,55,C,2016
31819,37,26,Ryan O'Reilly,24,81,61,C,2017
31820,0,19,Ryan Parent,0,1,0,D,2006
31821,0,20,Ryan Parent,0,22,0,D,2007
31822,4,21,Ryan Parent,0,31,4,D,2008
31823,2,22,Ryan Parent,1,48,3,D,2009
31824,0,23,Ryan Parent,0,4,0,D,2010
31825,1,21,Ryan Potulny,0,2,1,C,2005
31826,5,22,Ryan Potulny,7,35,12,C,2006
31827,1,23,Ryan Potulny,0,7,1,C,2007
31828,3,24,Ryan Potulny,0,8,3,C,2008
31829,17,25,Ryan Potulny,15,64,32,C,2009
31830,0,26,Ryan Potulny,0,10,0,C,2010
31831,2,21,Ryan Pulock,2,15,4,D,2015
31832,0,22,Ryan Pulock,0,1,0,D,2016
31833,22,23,Ryan Pulock,10,68,32,D,2017
31834,1,27,Ryan Ready,0,7,1,LW,2005
31835,2,24,Ryan Reaves,2,28,4,RW,2010
31836,1,25,Ryan Reaves,3,60,4,RW,2011
31837,2,26,Ryan Reaves,4,43,6,RW,2012
31838,6,27,Ryan Reaves,2,63,8,RW,2013
31839,6,28,Ryan Reaves,6,81,12,RW,2014
31840,1,29,Ryan Reaves,3,64,4,RW,2015
31841,6,30,Ryan Reaves,7,80,13,RW,2016
31842,2,31,Ryan Reaves,0,21,2,RW,2017
31843,0,24,Ryan Russell,2,41,2,C,2011
31844,0,25,Ryan Savoia,0,3,0,C,1998
31845,9,23,Ryan Shannon,2,53,11,RW,2006
31846,8,24,Ryan Shannon,5,27,13,RW,2007
31847,12,25,Ryan Shannon,8,35,20,RW,2008
31848,11,26,Ryan Shannon,5,66,16,RW,2009
31849,16,27,Ryan Shannon,11,79,27,RW,2010
31850,8,28,Ryan Shannon,4,45,12,RW,2011
31851,0,18,Ryan Smyth,0,3,0,LW,1994
31852,9,19,Ryan Smyth,2,48,11,LW,1995
31853,22,20,Ryan Smyth,39,82,61,LW,1996
31854,13,21,Ryan Smyth,20,65,33,LW,1997
31855,18,22,Ryan Smyth,13,71,31,LW,1998
31856,26,23,Ryan Smyth,28,82,54,LW,1999
31857,39,24,Ryan Smyth,31,82,70,RW,2000
31858,35,25,Ryan Smyth,15,61,50,LW,2001
31859,34,26,Ryan Smyth,27,66,61,LW,2002
31860,36,27,Ryan Smyth,23,82,59,LW,2003
31861,30,29,Ryan Smyth,36,75,66,LW,2005
31862,32,30,Ryan Smyth,36,71,68,LW,2006
31863,23,31,Ryan Smyth,14,55,37,LW,2007
31864,33,32,Ryan Smyth,26,77,59,LW,2008
31865,31,33,Ryan Smyth,22,67,53,LW,2009
31866,24,34,Ryan Smyth,23,82,47,LW,2010
31867,27,35,Ryan Smyth,19,82,46,LW,2011
31868,11,36,Ryan Smyth,2,47,13,LW,2012
31869,13,37,Ryan Smyth,10,72,23,LW,2013
31870,0,21,Ryan Spooner,0,4,0,C,2012
31871,11,22,Ryan Spooner,0,23,11,C,2013
31872,10,23,Ryan Spooner,8,29,18,C,2014
31873,36,24,Ryan Spooner,13,80,49,C,2015
31874,28,25,Ryan Spooner,11,78,39,C,2016
31875,12,26,Ryan Spooner,4,20,16,C,2017
31876,0,21,Ryan Sproul,0,1,0,D,2013
31877,6,24,Ryan Sproul,1,27,7,D,2016
31878,4,25,Ryan Sproul,1,16,5,D,2017
31879,0,23,Ryan Stanton,0,1,0,D,2012
31880,15,24,Ryan Stanton,1,64,16,D,2013
31881,8,25,Ryan Stanton,3,54,11,D,2014
31882,0,26,Ryan Stanton,0,1,0,D,2015
31883,0,18,Ryan Stewart,1,3,1,RW,1985
31884,1,22,Ryan Stoa,2,12,3,C,2009
31885,2,23,Ryan Stoa,2,25,4,C,2010
31886,0,26,Ryan Stoa,0,3,0,C,2013
31887,1,22,Ryan Stone,0,6,1,C,2007
31888,0,23,Ryan Stone,0,2,0,C,2008
31889,6,24,Ryan Stone,0,27,6,C,2009
31890,11,20,Ryan Strome,7,37,18,C,2013
31891,33,21,Ryan Strome,17,81,50,C,2014
31892,20,22,Ryan Strome,8,71,28,RW,2015
31893,17,23,Ryan Strome,13,69,30,RW,2016
31894,21,24,Ryan Strome,13,82,34,RW,2017
31895,15,21,Ryan Suter,1,71,16,D,2005
31896,16,22,Ryan Suter,8,82,24,D,2006
31897,24,23,Ryan Suter,7,76,31,D,2007
31898,38,24,Ryan Suter,7,82,45,D,2008
31899,33,25,Ryan Suter,4,82,37,D,2009
31900,35,26,Ryan Suter,4,70,39,D,2010
31901,39,27,Ryan Suter,7,79,46,D,2011
31902,28,28,Ryan Suter,4,48,32,D,2012
31903,35,29,Ryan Suter,8,82,43,D,2013
31904,36,30,Ryan Suter,2,77,38,D,2014
31905,43,31,Ryan Suter,8,82,51,D,2015
31906,31,32,Ryan Suter,9,82,40,D,2016
31907,45,33,Ryan Suter,6,78,51,D,2017
31908,0,24,Ryan Thang,0,1,0,LW,2011
31909,0,25,Ryan Tobler,0,4,0,LW,2001
31910,0,23,Ryan VandenBussche,1,11,1,RW,1996
31911,1,24,Ryan VandenBussche,1,20,2,RW,1997
31912,0,25,Ryan VandenBussche,0,6,0,RW,1998
31913,1,26,Ryan VandenBussche,0,52,1,RW,1999
31914,5,27,Ryan VandenBussche,2,64,7,RW,2000
31915,2,28,Ryan VandenBussche,1,50,3,RW,2001
31916,0,29,Ryan VandenBussche,0,22,0,RW,2002
31917,1,30,Ryan VandenBussche,4,65,5,RW,2003
31918,0,32,Ryan VandenBussche,1,20,1,RW,2005
31919,0,26,Ryan Vesce,0,10,0,RW,2008
31920,2,27,Ryan Vesce,3,9,5,RW,2009
31921,28,20,Ryan Walter,28,69,56,C,1978
31922,42,21,Ryan Walter,24,80,66,C,1979
31923,44,22,Ryan Walter,24,80,68,C,1980
31924,49,23,Ryan Walter,38,78,87,LW,1981
31925,46,24,Ryan Walter,29,80,75,LW,1982
31926,29,25,Ryan Walter,20,73,49,LW,1983
31927,19,26,Ryan Walter,19,72,38,LW,1984
31928,34,27,Ryan Walter,15,69,49,LW,1985
31929,23,28,Ryan Walter,23,76,46,LW,1986
31930,23,29,Ryan Walter,13,61,36,LW,1987
31931,17,30,Ryan Walter,14,78,31,LW,1988
31932,16,31,Ryan Walter,8,70,24,LW,1989
31933,1,32,Ryan Walter,0,25,1,C,1990
31934,11,33,Ryan Walter,6,67,17,C,1991
31935,0,34,Ryan Walter,3,25,3,C,1992
31936,2,21,Ryan White,0,16,2,RW,2009
31937,3,22,Ryan White,2,27,5,RW,2010
31938,3,23,Ryan White,0,20,3,RW,2011
31939,0,24,Ryan White,1,26,1,RW,2012
31940,4,25,Ryan White,2,52,6,C,2013
31941,6,26,Ryan White,6,34,12,C,2014
31942,5,27,Ryan White,11,73,16,C,2015
31943,1,28,Ryan White,2,19,3,C,2016
31944,32,22,Ryan Whitney,6,68,38,D,2005
31945,45,23,Ryan Whitney,14,81,59,D,2006
31946,28,24,Ryan Whitney,12,76,40,D,2007
31947,21,25,Ryan Whitney,2,48,23,D,2008
31948,32,26,Ryan Whitney,7,81,39,D,2009
31949,25,27,Ryan Whitney,2,35,27,D,2010
31950,17,28,Ryan Whitney,3,51,20,D,2011
31951,9,29,Ryan Whitney,4,34,13,D,2012
31952,0,30,Ryan Whitney,0,7,0,D,2013
31953,18,22,Ryan Wilson,3,61,21,D,2009
31954,13,23,Ryan Wilson,3,67,16,D,2010
31955,20,24,Ryan Wilson,1,59,21,D,2011
31956,3,25,Ryan Wilson,0,12,3,D,2012
31957,6,26,Ryan Wilson,0,28,6,D,2013
31958,0,27,Ryan Wilson,0,3,0,D,2014
31959,2,23,Ryane Clowe,0,18,2,RW,2005
31960,18,24,Ryane Clowe,16,58,34,LW,2006
31961,5,25,Ryane Clowe,3,15,8,LW,2007
31962,30,26,Ryane Clowe,22,71,52,LW,2008
31963,38,27,Ryane Clowe,19,82,57,LW,2009
31964,38,28,Ryane Clowe,24,75,62,LW,2010
31965,28,29,Ryane Clowe,17,76,45,LW,2011
31966,16,30,Ryane Clowe,3,40,19,LW,2012
31967,19,31,Ryane Clowe,7,43,26,LW,2013
31968,3,32,Ryane Clowe,1,13,4,LW,2014
31969,18,20,Rychard Campeau,1,75,19,D,1972
31970,18,20,Rychard Campeau,1,75,19,D,1972
31971,0,21,Rychard Campeau,0,7,0,D,1973
31972,0,21,Rychard Campeau,0,7,0,D,1973
31973,25,21,Saku Koivu,20,82,45,C,1995
31974,39,22,Saku Koivu,17,50,56,C,1996
31975,43,23,Saku Koivu,14,69,57,C,1997
31976,30,24,Saku Koivu,14,65,44,C,1998
31977,18,25,Saku Koivu,3,24,21,C,1999
31978,30,26,Saku Koivu,17,54,47,C,2000
31979,2,27,Saku Koivu,0,3,2,C,2001
31980,50,28,Saku Koivu,21,82,71,C,2002
31981,41,29,Saku Koivu,14,68,55,C,2003
31982,45,31,Saku Koivu,17,72,62,C,2005
31983,53,32,Saku Koivu,22,81,75,C,2006
31984,40,33,Saku Koivu,16,77,56,C,2007
31985,34,34,Saku Koivu,16,65,50,C,2008
31986,33,35,Saku Koivu,19,71,52,C,2009
31987,30,36,Saku Koivu,15,75,45,C,2010
31988,27,37,Saku Koivu,11,74,38,C,2011
31989,19,38,Saku Koivu,8,47,27,C,2012
31990,18,39,Saku Koivu,11,65,29,C,2013
31991,1,18,Sam Bennett,0,1,1,C,2014
31992,18,19,Sam Bennett,18,77,36,C,2015
31993,13,20,Sam Bennett,13,81,26,C,2016
31994,15,21,Sam Bennett,11,82,26,C,2017
31995,1,22,Sam Carrick,1,16,2,C,2014
31996,0,23,Sam Carrick,0,3,0,C,2015
31997,36,18,Sam Gagner,13,79,49,C,2007
31998,25,19,Sam Gagner,16,76,41,C,2008
31999,26,20,Sam Gagner,15,68,41,C,2009
32000,27,21,Sam Gagner,15,68,42,C,2010
32001,29,22,Sam Gagner,18,75,47,C,2011
32002,24,23,Sam Gagner,14,48,38,C,2012
32003,27,24,Sam Gagner,10,67,37,C,2013
32004,26,25,Sam Gagner,15,81,41,C,2014
32005,8,26,Sam Gagner,8,53,16,C,2015
32006,32,27,Sam Gagner,18,81,50,C,2016
32007,21,28,Sam Gagner,10,74,31,C,2017
32008,0,22,Sam Gellard,0,5,0,LW,1972
32009,0,22,Sam Gellard,0,5,0,LW,1972
32010,4,23,Sam Gellard,7,23,11,LW,1973
32011,4,23,Sam Gellard,7,23,11,LW,1973
32012,1,19,Sam Reinhart,0,9,1,C,2014
32013,19,20,Sam Reinhart,23,79,42,C,2015
32014,30,21,Sam Reinhart,17,79,47,C,2016
32015,25,22,Sam Reinhart,25,82,50,C,2017
32016,1,23,Sami Helenius,0,3,1,D,1996
32017,0,25,Sami Helenius,1,8,1,D,1998
32018,0,26,Sami Helenius,0,33,0,D,1999
32019,2,27,Sami Helenius,1,57,3,D,2000
32020,0,28,Sami Helenius,0,39,0,D,2001
32021,1,29,Sami Helenius,0,15,1,D,2002
32022,4,22,Sami Kapanen,5,35,9,LW,1995
32023,12,23,Sami Kapanen,13,45,25,RW,1996
32024,37,24,Sami Kapanen,26,81,63,RW,1997
32025,35,25,Sami Kapanen,24,81,59,LW,1998
32026,24,26,Sami Kapanen,24,76,48,RW,1999
32027,37,27,Sami Kapanen,20,82,57,LW,2000
32028,42,28,Sami Kapanen,27,77,69,RW,2001
32029,21,29,Sami Kapanen,10,71,31,RW,2002
32030,18,30,Sami Kapanen,12,74,30,RW,2003
32031,22,32,Sami Kapanen,12,58,34,RW,2005
32032,14,33,Sami Kapanen,11,77,25,RW,2006
32033,3,34,Sami Kapanen,5,74,8,RW,2007
32034,1,23,Sami Lepisto,0,7,1,D,2007
32035,4,24,Sami Lepisto,0,7,4,D,2008
32036,10,25,Sami Lepisto,1,66,11,D,2009
32037,12,26,Sami Lepisto,4,70,16,D,2010
32038,2,27,Sami Lepisto,1,26,3,D,2011
32039,0,21,Sami Niku,1,1,1,D,2017
32040,12,24,Sami Salo,7,61,19,D,1998
32041,8,25,Sami Salo,6,37,14,D,1999
32042,16,26,Sami Salo,2,31,18,D,2000
32043,14,27,Sami Salo,4,66,18,D,2001
32044,21,28,Sami Salo,9,79,30,D,2002
32045,19,29,Sami Salo,7,74,26,D,2003
32046,23,31,Sami Salo,10,59,33,D,2005
32047,23,32,Sami Salo,14,67,37,D,2006
32048,17,33,Sami Salo,8,63,25,D,2007
32049,20,34,Sami Salo,5,60,25,D,2008
32050,19,35,Sami Salo,9,68,28,D,2009
32051,4,36,Sami Salo,3,27,7,D,2010
32052,16,37,Sami Salo,9,69,25,D,2011
32053,15,38,Sami Salo,2,46,17,D,2012
32054,13,39,Sami Salo,4,71,17,D,2013
32055,0,21,Sami Vatanen,2,8,2,D,2012
32056,15,22,Sami Vatanen,6,48,21,D,2013
32057,25,23,Sami Vatanen,12,67,37,D,2014
32058,29,24,Sami Vatanen,9,71,38,D,2015
32059,21,25,Sami Vatanen,3,71,24,D,2016
32060,3,26,Sami Vatanen,1,15,4,D,2017
32061,2,21,Samuel Blais,1,11,3,LW,2017
32062,2,19,Samuel Girard,1,5,3,D,2017
32063,0,23,Samuel Henley,1,1,1,C,2016
32064,0,21,Samuel Morin,0,1,0,D,2016
32065,0,22,Samuel Morin,0,2,0,D,2017
32066,5,23,Samuel Pahlsson,4,76,9,C,2000
32067,14,24,Samuel Pahlsson,6,80,20,C,2001
32068,11,25,Samuel Pahlsson,4,34,15,C,2002
32069,14,26,Samuel Pahlsson,8,82,22,C,2003
32070,10,28,Samuel Pahlsson,11,82,21,C,2005
32071,18,29,Samuel Pahlsson,8,82,26,C,2006
32072,9,30,Samuel Pahlsson,6,56,15,C,2007
32073,11,31,Samuel Pahlsson,7,65,18,C,2008
32074,13,32,Samuel Pahlsson,3,79,16,C,2009
32075,13,33,Samuel Pahlsson,7,82,20,C,2010
32076,13,34,Samuel Pahlsson,4,80,17,C,2011
32077,16,20,Sandis Ozolinsh,7,37,23,D,1992
32078,38,21,Sandis Ozolinsh,26,81,64,D,1993
32079,16,22,Sandis Ozolinsh,9,48,25,D,1994
32080,40,23,Sandis Ozolinsh,14,73,54,D,1995
32081,45,24,Sandis Ozolinsh,23,80,68,D,1996
32082,38,25,Sandis Ozolinsh,13,66,51,D,1997
32083,25,26,Sandis Ozolinsh,7,39,32,D,1998
32084,36,27,Sandis Ozolinsh,16,82,52,D,1999
32085,32,28,Sandis Ozolinsh,12,72,44,D,2000
32086,38,29,Sandis Ozolinsh,14,83,52,D,2001
32087,32,30,Sandis Ozolinsh,12,82,44,D,2002
32088,11,31,Sandis Ozolinsh,5,36,16,D,2003
32089,14,33,Sandis Ozolinsh,6,36,20,D,2005
32090,3,34,Sandis Ozolinsh,0,21,3,D,2006
32091,13,35,Sandis Ozolinsh,3,39,16,D,2007
32092,0,20,Sandy Beadle,1,6,1,LW,1980
32093,6,23,Sandy Fitzpatrick,3,18,9,C,1967
32094,5,21,Sandy McCarthy,5,79,10,RW,1993
32095,3,22,Sandy McCarthy,5,37,8,RW,1994
32096,7,23,Sandy McCarthy,9,75,16,RW,1995
32097,5,24,Sandy McCarthy,3,33,8,RW,1996
32098,10,25,Sandy McCarthy,8,66,18,RW,1997
32099,8,26,Sandy McCarthy,5,80,13,RW,1998
32100,5,27,Sandy McCarthy,6,71,11,RW,1999
32101,10,28,Sandy McCarthy,11,81,21,RW,2000
32102,13,29,Sandy McCarthy,10,82,23,RW,2001
32103,9,30,Sandy McCarthy,6,82,15,RW,2002
32104,1,31,Sandy McCarthy,4,50,5,RW,2003
32105,6,25,Sandy Moger,2,18,8,RW,1994
32106,14,26,Sandy Moger,15,80,29,RW,1995
32107,3,27,Sandy Moger,10,34,13,RW,1996
32108,13,28,Sandy Moger,11,62,24,RW,1997
32109,2,29,Sandy Moger,3,42,5,C,1998
32110,0,22,Sandy Snow,0,3,0,RW,1968
32111,0,21,Sascha Goc,0,11,0,D,2000
32112,0,22,Sascha Goc,0,11,0,D,2001
32113,1,25,Sasha Lakovic,0,19,1,LW,1996
32114,0,26,Sasha Lakovic,0,2,0,LW,1997
32115,3,27,Sasha Lakovic,0,16,3,LW,1998
32116,9,23,Scot Kleinendorst,2,30,11,D,1982
32117,2,24,Scot Kleinendorst,0,23,2,D,1983
32118,8,25,Scot Kleinendorst,1,35,9,D,1984
32119,7,26,Scot Kleinendorst,2,41,9,D,1985
32120,9,27,Scot Kleinendorst,3,66,12,D,1986
32121,6,28,Scot Kleinendorst,3,44,9,D,1987
32122,2,29,Scot Kleinendorst,0,27,2,D,1988
32123,3,30,Scot Kleinendorst,1,15,4,D,1989
32124,8,19,Scott Arniel,1,17,9,C,1981
32125,5,20,Scott Arniel,13,75,18,LW,1982
32126,35,21,Scott Arniel,21,80,56,LW,1983
32127,22,22,Scott Arniel,22,79,44,RW,1984
32128,25,23,Scott Arniel,18,80,43,LW,1985
32129,14,24,Scott Arniel,11,63,25,LW,1986
32130,23,25,Scott Arniel,17,73,40,LW,1987
32131,23,26,Scott Arniel,18,80,41,LW,1988
32132,14,27,Scott Arniel,18,79,32,LW,1989
32133,17,28,Scott Arniel,5,75,22,C,1990
32134,3,29,Scott Arniel,5,29,8,LW,1991
32135,0,23,Scott Barney,0,5,0,RW,2002
32136,6,24,Scott Barney,5,19,11,C,2003
32137,0,26,Scott Barney,0,3,0,C,2005
32138,0,22,Scott Bjugstad,0,5,0,C,1983
32139,4,23,Scott Bjugstad,11,72,15,C,1984
32140,33,24,Scott Bjugstad,43,80,76,LW,1985
32141,9,25,Scott Bjugstad,4,39,13,LW,1986
32142,12,26,Scott Bjugstad,10,33,22,LW,1987
32143,0,27,Scott Bjugstad,3,24,3,RW,1988
32144,2,28,Scott Bjugstad,1,11,3,RW,1989
32145,4,29,Scott Bjugstad,2,31,6,RW,1990
32146,4,30,Scott Bjugstad,2,22,6,RW,1991
32147,29,20,Scott Campbell,8,75,37,D,1977
32148,29,20,Scott Campbell,8,75,37,D,1977
32149,15,21,Scott Campbell,3,74,18,D,1978
32150,15,21,Scott Campbell,3,74,18,D,1978
32151,17,22,Scott Campbell,3,63,20,D,1979
32152,4,23,Scott Campbell,1,14,5,D,1980
32153,0,24,Scott Campbell,0,3,0,D,1981
32154,0,23,Scott Daniels,0,1,0,LW,1992
32155,2,25,Scott Daniels,0,12,2,LW,1994
32156,4,26,Scott Daniels,3,53,7,LW,1995
32157,3,27,Scott Daniels,5,56,8,RW,1996
32158,3,28,Scott Daniels,0,26,3,LW,1997
32159,0,29,Scott Daniels,0,1,0,LW,1998
32160,0,25,Scott Ferguson,0,1,0,D,1997
32161,1,26,Scott Ferguson,0,2,1,D,1998
32162,1,28,Scott Ferguson,0,20,1,D,2000
32163,2,29,Scott Ferguson,3,50,5,D,2001
32164,5,30,Scott Ferguson,3,78,8,D,2002
32165,5,31,Scott Ferguson,1,52,6,D,2003
32166,0,33,Scott Ferguson,0,15,0,D,2005
32167,0,23,Scott Fraser,2,15,2,C,1995
32168,11,25,Scott Fraser,12,29,23,RW,1997
32169,4,26,Scott Fraser,2,28,6,RW,1998
32170,3,23,Scott Garland,4,16,7,C,1975
32171,20,24,Scott Garland,9,69,29,RW,1976
32172,1,26,Scott Garland,0,6,1,D,1978
32173,0,20,Scott Glennie,0,1,0,RW,2011
32174,51,20,Scott Gomez,19,82,70,C,1999
32175,49,21,Scott Gomez,14,76,63,C,2000
32176,38,22,Scott Gomez,10,76,48,C,2001
32177,42,23,Scott Gomez,13,80,55,C,2002
32178,56,24,Scott Gomez,14,80,70,C,2003
32179,51,26,Scott Gomez,33,82,84,C,2005
32180,47,27,Scott Gomez,13,72,60,C,2006
32181,54,28,Scott Gomez,16,81,70,C,2007
32182,42,29,Scott Gomez,16,77,58,C,2008
32183,47,30,Scott Gomez,12,78,59,C,2009
32184,31,31,Scott Gomez,7,80,38,C,2010
32185,9,32,Scott Gomez,2,38,11,C,2011
32186,13,33,Scott Gomez,2,39,15,C,2012
32187,10,34,Scott Gomez,2,46,12,C,2013
32188,27,35,Scott Gomez,7,58,34,C,2014
32189,8,36,Scott Gomez,1,34,9,C,2015
32190,1,22,Scott Gruhl,2,7,3,LW,1981
32191,2,23,Scott Gruhl,0,7,2,LW,1982
32192,0,28,Scott Gruhl,1,6,1,LW,1987
32193,2,20,Scott Hannan,0,5,2,D,1998
32194,2,21,Scott Hannan,1,30,3,D,1999
32195,14,22,Scott Hannan,3,75,17,D,2000
32196,12,23,Scott Hannan,2,75,14,D,2001
32197,19,24,Scott Hannan,3,81,22,D,2002
32198,15,25,Scott Hannan,6,82,21,D,2003
32199,18,27,Scott Hannan,6,81,24,D,2005
32200,20,28,Scott Hannan,4,79,24,D,2006
32201,19,29,Scott Hannan,2,82,21,D,2007
32202,9,30,Scott Hannan,1,81,10,D,2008
32203,14,31,Scott Hannan,2,81,16,D,2009
32204,10,32,Scott Hannan,1,78,11,D,2010
32205,10,33,Scott Hannan,2,78,12,D,2011
32206,1,34,Scott Hannan,0,33,1,D,2012
32207,9,35,Scott Hannan,3,56,12,D,2013
32208,5,36,Scott Hannan,2,58,7,D,2014
32209,1,24,Scott Harlow,0,1,1,LW,1987
32210,0,21,Scott Harrington,0,10,0,D,2014
32211,1,22,Scott Harrington,0,15,1,D,2015
32212,2,23,Scott Harrington,1,22,3,D,2016
32213,3,24,Scott Harrington,2,32,5,D,2017
32214,14,18,Scott Hartnell,2,75,16,RW,2000
32215,27,19,Scott Hartnell,14,75,41,RW,2001
32216,22,20,Scott Hartnell,12,82,34,RW,2002
32217,15,21,Scott Hartnell,18,59,33,LW,2003
32218,23,23,Scott Hartnell,25,81,48,LW,2005
32219,17,24,Scott Hartnell,22,64,39,RW,2006
32220,19,25,Scott Hartnell,24,80,43,LW,2007
32221,30,26,Scott Hartnell,30,82,60,LW,2008
32222,30,27,Scott Hartnell,14,81,44,RW,2009
32223,25,28,Scott Hartnell,24,82,49,RW,2010
32224,30,29,Scott Hartnell,37,82,67,RW,2011
32225,3,30,Scott Hartnell,8,32,11,RW,2012
32226,32,31,Scott Hartnell,20,78,52,LW,2013
32227,32,32,Scott Hartnell,28,77,60,LW,2014
32228,26,33,Scott Hartnell,23,79,49,LW,2015
32229,24,34,Scott Hartnell,13,78,37,LW,2016
32230,11,35,Scott Hartnell,13,62,24,LW,2017
32231,1,24,Scott Howson,4,8,5,C,1984
32232,2,25,Scott Howson,1,10,3,C,1985
32233,0,22,Scott Jackson,0,1,0,D,2009
32234,3,22,Scott Kosmachuk,0,8,3,RW,2015
32235,4,19,Scott Lachance,1,17,5,D,1991
32236,17,20,Scott Lachance,7,75,24,D,1992
32237,11,21,Scott Lachance,3,74,14,D,1993
32238,7,22,Scott Lachance,6,26,13,D,1994
32239,10,23,Scott Lachance,3,55,13,D,1995
32240,11,24,Scott Lachance,3,81,14,D,1996
32241,11,25,Scott Lachance,2,63,13,D,1997
32242,9,26,Scott Lachance,2,76,11,D,1998
32243,6,27,Scott Lachance,0,57,6,D,1999
32244,11,28,Scott Lachance,3,76,14,D,2000
32245,10,29,Scott Lachance,1,81,11,D,2001
32246,1,30,Scott Lachance,0,61,1,D,2002
32247,4,31,Scott Lachance,0,77,4,D,2003
32248,0,18,Scott Laughton,0,5,0,C,2012
32249,4,20,Scott Laughton,2,31,6,C,2014
32250,14,21,Scott Laughton,7,71,21,C,2015
32251,0,22,Scott Laughton,0,2,0,C,2016
32252,10,23,Scott Laughton,10,81,20,C,2017
32253,0,23,Scott Lehman,0,1,0,D,2008
32254,1,23,Scott Levins,0,9,1,RW,1992
32255,11,24,Scott Levins,8,62,19,RW,1993
32256,6,25,Scott Levins,5,24,11,RW,1994
32257,2,26,Scott Levins,0,27,2,RW,1995
32258,0,28,Scott Levins,0,2,0,RW,1997
32259,0,21,Scott Mayfield,0,5,0,D,2013
32260,0,23,Scott Mayfield,1,6,1,D,2015
32261,7,24,Scott Mayfield,2,25,9,D,2016
32262,10,25,Scott Mayfield,2,47,12,D,2017
32263,0,22,Scott McKay,0,1,0,C,1993
32264,0,19,Scott McLellan,0,2,0,RW,1982
32265,0,19,Scott Mellanby,0,2,0,RW,1985
32266,21,20,Scott Mellanby,11,71,32,RW,1986
32267,26,21,Scott Mellanby,25,75,51,RW,1987
32268,29,22,Scott Mellanby,21,76,50,RW,1988
32269,17,23,Scott Mellanby,6,57,23,RW,1989
32270,21,24,Scott Mellanby,20,74,41,RW,1990
32271,27,25,Scott Mellanby,23,80,50,RW,1991
32272,17,26,Scott Mellanby,15,69,32,RW,1992
32273,30,27,Scott Mellanby,30,80,60,RW,1993
32274,12,28,Scott Mellanby,13,48,25,RW,1994
32275,38,29,Scott Mellanby,32,79,70,RW,1995
32276,29,30,Scott Mellanby,27,82,56,RW,1996
32277,24,31,Scott Mellanby,15,79,39,RW,1997
32278,27,32,Scott Mellanby,18,67,45,RW,1998
32279,28,33,Scott Mellanby,18,77,46,RW,1999
32280,10,34,Scott Mellanby,11,63,21,RW,2000
32281,26,35,Scott Mellanby,15,64,41,RW,2001
32282,31,36,Scott Mellanby,26,80,57,RW,2002
32283,17,37,Scott Mellanby,14,68,31,RW,2003
32284,22,39,Scott Mellanby,12,71,34,RW,2005
32285,24,40,Scott Mellanby,12,69,36,RW,2006
32286,1,21,Scott Metcalfe,0,3,1,LW,1987
32287,1,22,Scott Metcalfe,1,9,2,LW,1988
32288,0,23,Scott Metcalfe,0,7,0,LW,1989
32289,0,25,Scott Morrow,0,4,0,LW,1994
32290,0,21,Scott Nichol,0,2,0,C,1995
32291,0,23,Scott Nichol,0,3,0,C,1997
32292,9,27,Scott Nichol,8,60,17,C,2001
32293,5,28,Scott Nichol,5,68,10,C,2002
32294,11,29,Scott Nichol,7,75,18,C,2003
32295,3,31,Scott Nichol,3,34,6,C,2005
32296,6,32,Scott Nichol,7,59,13,C,2006
32297,8,33,Scott Nichol,10,73,18,C,2007
32298,6,34,Scott Nichol,4,43,10,C,2008
32299,15,35,Scott Nichol,4,79,19,C,2009
32300,3,36,Scott Nichol,4,56,7,C,2010
32301,5,37,Scott Nichol,3,80,8,C,2011
32302,0,38,Scott Nichol,1,30,1,C,2012
32303,1,18,Scott Niedermayer,0,4,1,D,1991
32304,29,19,Scott Niedermayer,11,80,40,D,1992
32305,36,20,Scott Niedermayer,10,81,46,D,1993
32306,15,21,Scott Niedermayer,4,48,19,D,1994
32307,25,22,Scott Niedermayer,8,79,33,D,1995
32308,30,23,Scott Niedermayer,5,81,35,D,1996
32309,43,24,Scott Niedermayer,14,81,57,D,1997
32310,35,25,Scott Niedermayer,11,72,46,D,1998
32311,31,26,Scott Niedermayer,7,71,38,D,1999
32312,29,27,Scott Niedermayer,6,57,35,D,2000
32313,22,28,Scott Niedermayer,11,76,33,D,2001
32314,28,29,Scott Niedermayer,11,81,39,D,2002
32315,40,30,Scott Niedermayer,14,81,54,D,2003
32316,50,32,Scott Niedermayer,13,82,63,D,2005
32317,54,33,Scott Niedermayer,15,79,69,D,2006
32318,17,34,Scott Niedermayer,8,48,25,D,2007
32319,45,35,Scott Niedermayer,14,82,59,D,2008
32320,38,36,Scott Niedermayer,10,80,48,D,2009
32321,0,21,Scott Parker,0,27,0,RW,1998
32322,3,23,Scott Parker,2,69,5,RW,2000
32323,4,24,Scott Parker,1,63,5,LW,2001
32324,3,25,Scott Parker,1,43,4,LW,2002
32325,3,26,Scott Parker,1,50,4,RW,2003
32326,0,28,Scott Parker,1,10,1,LW,2005
32327,1,29,Scott Parker,1,21,2,RW,2006
32328,0,30,Scott Parker,0,25,0,RW,2007
32329,13,25,Scott Parse,11,59,24,C,2009
32330,3,26,Scott Parse,1,5,4,C,2010
32331,0,27,Scott Parse,2,9,2,C,2011
32332,1,19,Scott Pearson,0,9,1,LW,1988
32333,10,20,Scott Pearson,5,41,15,LW,1989
32334,4,21,Scott Pearson,11,47,15,LW,1990
32335,2,22,Scott Pearson,1,10,3,LW,1991
32336,1,23,Scott Pearson,13,41,14,RW,1992
32337,18,24,Scott Pearson,19,72,37,LW,1993
32338,5,25,Scott Pearson,3,42,8,RW,1994
32339,0,26,Scott Pearson,4,27,4,LW,1995
32340,0,27,Scott Pearson,0,1,0,LW,1996
32341,1,30,Scott Pearson,0,2,1,LW,1999
32342,11,23,Scott Pellerin,10,45,21,LW,1992
32343,0,24,Scott Pellerin,0,1,0,LW,1993
32344,1,26,Scott Pellerin,2,6,3,RW,1995
32345,10,27,Scott Pellerin,8,54,18,LW,1996
32346,21,28,Scott Pellerin,8,80,29,LW,1997
32347,21,29,Scott Pellerin,20,80,41,LW,1998
32348,15,30,Scott Pellerin,8,80,23,LW,1999
32349,33,31,Scott Pellerin,11,77,44,RW,2000
32350,10,32,Scott Pellerin,4,68,14,LW,2001
32351,4,33,Scott Pellerin,1,43,5,LW,2002
32352,0,34,Scott Pellerin,0,2,0,LW,2003
32353,0,25,Scott Robinson,0,1,0,RW,1989
32354,0,22,Scott Sandelin,0,1,0,D,1986
32355,1,23,Scott Sandelin,0,8,1,D,1987
32356,3,26,Scott Sandelin,0,15,3,D,1990
32357,0,27,Scott Sandelin,0,1,0,D,1991
32358,0,19,Scott Scissons,0,1,0,C,1990
32359,0,22,Scott Scissons,0,1,0,C,1993
32360,0,23,Scott Shaunessy,0,3,0,D,1986
32361,0,25,Scott Shaunessy,0,4,0,D,1988
32362,16,18,Scott Stevens,9,77,25,D,1982
32363,32,19,Scott Stevens,13,78,45,D,1983
32364,44,20,Scott Stevens,21,80,65,D,1984
32365,38,21,Scott Stevens,15,73,53,D,1985
32366,51,22,Scott Stevens,10,77,61,D,1986
32367,60,23,Scott Stevens,12,80,72,D,1987
32368,61,24,Scott Stevens,7,80,68,D,1988
32369,29,25,Scott Stevens,11,56,40,D,1989
32370,44,26,Scott Stevens,5,78,49,D,1990
32371,42,27,Scott Stevens,17,68,59,D,1991
32372,45,28,Scott Stevens,12,81,57,D,1992
32373,60,29,Scott Stevens,18,83,78,D,1993
32374,20,30,Scott Stevens,2,48,22,D,1994
32375,23,31,Scott Stevens,5,82,28,D,1995
32376,19,32,Scott Stevens,5,79,24,D,1996
32377,22,33,Scott Stevens,4,80,26,D,1997
32378,22,34,Scott Stevens,5,75,27,D,1998
32379,21,35,Scott Stevens,8,78,29,D,1999
32380,22,36,Scott Stevens,9,81,31,D,2000
32381,16,37,Scott Stevens,1,82,17,D,2001
32382,16,38,Scott Stevens,4,81,20,D,2002
32383,9,39,Scott Stevens,3,38,12,D,2003
32384,1,23,Scott Thomas,1,7,2,RW,1992
32385,2,24,Scott Thomas,2,32,4,RW,1993
32386,1,31,Scott Thomas,3,24,4,LW,2000
32387,3,20,Scott Thornton,1,33,4,C,1990
32388,1,21,Scott Thornton,0,15,1,C,1991
32389,1,22,Scott Thornton,0,9,1,C,1992
32390,7,23,Scott Thornton,4,61,11,C,1993
32391,12,24,Scott Thornton,10,47,22,LW,1994
32392,9,25,Scott Thornton,9,77,18,C,1995
32393,10,26,Scott Thornton,10,73,20,C,1996
32394,9,27,Scott Thornton,6,67,15,C,1997
32395,4,28,Scott Thornton,7,47,11,C,1998
32396,6,29,Scott Thornton,8,65,14,C,1999
32397,17,30,Scott Thornton,19,73,36,LW,2000
32398,16,31,Scott Thornton,26,77,42,LW,2001
32399,12,32,Scott Thornton,9,41,21,LW,2002
32400,14,33,Scott Thornton,13,80,27,LW,2003
32401,11,35,Scott Thornton,10,71,21,LW,2005
32402,6,36,Scott Thornton,7,58,13,LW,2006
32403,3,37,Scott Thornton,5,47,8,LW,2007
32404,0,21,Scott Timmins,1,19,1,C,2010
32405,0,23,Scott Timmins,0,5,0,C,2012
32406,1,21,Scott Walker,0,11,1,D,1994
32407,8,22,Scott Walker,4,63,12,D,1995
32408,15,23,Scott Walker,3,64,18,RW,1996
32409,10,24,Scott Walker,3,59,13,C,1997
32410,25,25,Scott Walker,15,71,40,C,1998
32411,21,26,Scott Walker,7,69,28,RW,1999
32412,29,27,Scott Walker,25,74,54,RW,2000
32413,5,28,Scott Walker,4,28,9,RW,2001
32414,18,29,Scott Walker,15,60,33,RW,2002
32415,42,30,Scott Walker,25,75,67,RW,2003
32416,11,32,Scott Walker,5,33,16,RW,2005
32417,30,33,Scott Walker,21,81,51,RW,2006
32418,18,34,Scott Walker,14,58,32,RW,2007
32419,10,35,Scott Walker,5,41,15,RW,2008
32420,3,36,Scott Walker,5,42,8,RW,2009
32421,0,22,Scott Wilson,0,1,0,C,2014
32422,1,23,Scott Wilson,5,24,6,LW,2015
32423,18,24,Scott Wilson,8,78,26,LW,2016
32424,0,25,Scott Wilson,0,3,0,LW,2017
32425,0,20,Scott Young,0,7,0,RW,1987
32426,40,21,Scott Young,19,76,59,RW,1988
32427,40,22,Scott Young,24,80,64,RW,1989
32428,25,23,Scott Young,17,77,42,RW,1990
32429,30,25,Scott Young,30,82,60,RW,1992
32430,25,26,Scott Young,26,76,51,RW,1993
32431,21,27,Scott Young,18,48,39,RW,1994
32432,39,28,Scott Young,21,81,60,RW,1995
32433,19,29,Scott Young,18,72,37,RW,1996
32434,20,30,Scott Young,13,73,33,RW,1997
32435,28,31,Scott Young,24,75,52,RW,1998
32436,15,32,Scott Young,24,75,39,RW,1999
32437,33,33,Scott Young,40,81,73,RW,2000
32438,22,34,Scott Young,19,67,41,RW,2001
32439,19,35,Scott Young,23,79,42,RW,2002
32440,8,36,Scott Young,8,53,16,RW,2003
32441,31,38,Scott Young,18,79,49,RW,2005
32442,0,19,Scottie Upshall,1,8,1,RW,2002
32443,1,20,Scottie Upshall,0,7,1,LW,2003
32444,16,22,Scottie Upshall,8,48,24,RW,2005
32445,8,23,Scottie Upshall,8,32,16,RW,2006
32446,16,24,Scottie Upshall,14,61,30,RW,2007
32447,19,25,Scottie Upshall,15,74,34,RW,2008
32448,14,26,Scottie Upshall,18,49,32,RW,2009
32449,12,27,Scottie Upshall,22,82,34,RW,2010
32450,3,28,Scottie Upshall,2,26,5,RW,2011
32451,1,29,Scottie Upshall,4,27,5,RW,2012
32452,22,30,Scottie Upshall,15,76,37,LW,2013
32453,7,31,Scottie Upshall,8,63,15,LW,2014
32454,8,32,Scottie Upshall,6,70,14,RW,2015
32455,8,33,Scottie Upshall,10,73,18,RW,2016
32456,12,34,Scottie Upshall,7,63,19,RW,2017
32457,2,21,Sean Avery,2,36,4,C,2001
32458,9,22,Sean Avery,6,51,15,C,2002
32459,19,23,Sean Avery,9,76,28,LW,2003
32460,24,25,Sean Avery,15,75,39,C,2005
32461,30,26,Sean Avery,18,84,48,LW,2006
32462,18,27,Sean Avery,15,57,33,LW,2007
32463,14,28,Sean Avery,8,41,22,LW,2008
32464,20,29,Sean Avery,11,69,31,C,2009
32465,21,30,Sean Avery,3,76,24,C,2010
32466,0,31,Sean Avery,3,15,3,C,2011
32467,0,23,Sean Bentivoglio,0,1,0,LW,2008
32468,1,19,Sean Bergenheim,1,18,2,LW,2003
32469,5,21,Sean Bergenheim,4,28,9,LW,2005
32470,12,23,Sean Bergenheim,10,78,22,LW,2007
32471,9,24,Sean Bergenheim,15,59,24,LW,2008
32472,13,25,Sean Bergenheim,10,63,23,LW,2009
32473,15,26,Sean Bergenheim,14,80,29,LW,2010
32474,6,27,Sean Bergenheim,17,62,23,LW,2011
32475,13,29,Sean Bergenheim,16,62,29,LW,2013
32476,10,30,Sean Bergenheim,9,56,19,LW,2014
32477,0,20,Sean Brown,0,5,0,D,1996
32478,1,21,Sean Brown,0,18,1,D,1997
32479,7,22,Sean Brown,0,51,7,D,1998
32480,8,23,Sean Brown,4,72,12,D,1999
32481,3,24,Sean Brown,2,62,5,D,2000
32482,5,25,Sean Brown,6,73,11,D,2001
32483,5,26,Sean Brown,1,69,6,LW,2002
32484,3,27,Sean Brown,0,39,3,D,2003
32485,11,29,Sean Brown,1,47,12,D,2005
32486,1,25,Sean Collins,1,15,2,D,2008
32487,0,27,Sean Collins,1,4,1,D,2010
32488,0,28,Sean Collins,0,2,0,D,2011
32489,0,24,Sean Collins,0,5,0,C,2012
32490,1,25,Sean Collins,0,6,1,C,2013
32491,2,26,Sean Collins,0,8,2,C,2014
32492,0,27,Sean Collins,0,2,0,C,2015
32493,14,19,Sean Couturier,13,77,27,C,2011
32494,11,20,Sean Couturier,4,46,15,C,2012
32495,26,21,Sean Couturier,13,82,39,C,2013
32496,22,22,Sean Couturier,15,82,37,C,2014
32497,28,23,Sean Couturier,11,63,39,C,2015
32498,20,24,Sean Couturier,14,66,34,C,2016
32499,45,25,Sean Couturier,31,82,76,C,2017
32500,1,24,Sean Gagnon,0,5,1,D,1997
32501,0,25,Sean Gagnon,0,2,0,D,1998
32502,0,27,Sean Gagnon,0,5,0,D,2000
32503,0,19,Sean Haggerty,0,1,0,LW,1995
32504,0,21,Sean Haggerty,0,5,0,LW,1997
32505,1,23,Sean Haggerty,1,5,2,LW,1999
32506,1,24,Sean Haggerty,0,3,1,LW,2000
32507,6,22,Sean Hill,2,31,8,D,1992
32508,20,23,Sean Hill,7,68,27,D,1993
32509,14,24,Sean Hill,1,45,15,D,1994
32510,14,25,Sean Hill,7,80,21,D,1995
32511,0,26,Sean Hill,0,5,0,D,1996
32512,6,27,Sean Hill,1,55,7,D,1997
32513,10,28,Sean Hill,0,54,10,D,1998
32514,31,29,Sean Hill,13,62,44,D,1999
32515,10,30,Sean Hill,1,48,11,D,2000
32516,26,31,Sean Hill,7,72,33,D,2001
32517,24,32,Sean Hill,5,82,29,D,2002
32518,26,33,Sean Hill,13,80,39,D,2003
32519,18,35,Sean Hill,2,78,20,D,2005
32520,24,36,Sean Hill,1,81,25,D,2006
32521,7,37,Sean Hill,2,35,9,D,2007
32522,1,24,Sean Kuraly,0,8,1,C,2016
32523,8,25,Sean Kuraly,6,75,14,C,2017
32524,0,21,Sean Malone,0,1,0,C,2016
32525,1,19,Sean McKenna,0,3,1,RW,1981
32526,14,20,Sean McKenna,10,46,24,RW,1982
32527,10,21,Sean McKenna,20,78,30,RW,1983
32528,16,22,Sean McKenna,20,65,36,RW,1984
32529,12,23,Sean McKenna,10,75,22,RW,1985
32530,19,24,Sean McKenna,14,69,33,RW,1986
32531,7,25,Sean McKenna,8,70,15,RW,1987
32532,1,26,Sean McKenna,0,3,1,RW,1988
32533,0,27,Sean McKenna,0,5,0,RW,1989
32534,0,21,Sean McMorrow,0,1,0,LW,2002
32535,12,19,Sean Monahan,22,75,34,C,2013
32536,31,20,Sean Monahan,31,81,62,C,2014
32537,36,21,Sean Monahan,27,81,63,C,2015
32538,31,22,Sean Monahan,27,82,58,C,2016
32539,33,23,Sean Monahan,31,74,64,C,2017
32540,2,23,Sean O'Donnell,0,15,2,D,1994
32541,5,24,Sean O'Donnell,2,71,7,D,1995
32542,12,25,Sean O'Donnell,5,55,17,D,1996
32543,15,26,Sean O'Donnell,2,80,17,D,1997
32544,13,27,Sean O'Donnell,1,80,14,D,1998
32545,12,28,Sean O'Donnell,2,80,14,D,1999
32546,13,29,Sean O'Donnell,4,80,17,D,2000
32547,22,30,Sean O'Donnell,3,80,25,D,2001
32548,15,31,Sean O'Donnell,1,70,16,D,2002
32549,10,32,Sean O'Donnell,1,82,11,D,2003
32550,9,34,Sean O'Donnell,2,78,11,D,2005
32551,15,35,Sean O'Donnell,2,79,17,D,2006
32552,7,36,Sean O'Donnell,2,82,9,D,2007
32553,12,37,Sean O'Donnell,0,82,12,D,2008
32554,12,38,Sean O'Donnell,3,78,15,D,2009
32555,17,39,Sean O'Donnell,1,81,18,D,2010
32556,7,40,Sean O'Donnell,0,51,7,D,2011
32557,1,23,Sean Pronger,0,7,1,C,1995
32558,7,24,Sean Pronger,7,39,14,C,1996
32559,15,25,Sean Pronger,6,67,21,LW,1997
32560,4,26,Sean Pronger,0,29,4,C,1998
32561,1,27,Sean Pronger,0,11,1,C,1999
32562,1,29,Sean Pronger,3,26,4,C,2001
32563,6,30,Sean Pronger,7,78,13,RW,2002
32564,1,31,Sean Pronger,0,3,1,C,2003
32565,0,26,Sean Selmser,0,1,0,LW,2000
32566,0,24,Sean Shanahan,0,4,0,LW,1975
32567,3,25,Sean Shanahan,1,30,4,LW,1976
32568,0,26,Sean Shanahan,0,6,0,RW,1977
32569,0,27,Sean Shanahan,0,4,0,LW,1978
32570,0,27,Sean Shanahan,0,4,0,LW,1978
32571,0,21,Sean Toomey,0,1,0,LW,1986
32572,0,21,Sean Whyte,0,3,0,RW,1991
32573,2,22,Sean Whyte,0,18,2,RW,1992
32574,0,24,Sean Williams,0,2,0,C,1991
32575,25,19,Sebastian Aho,24,82,49,RW,2016
32576,36,20,Sebastian Aho,29,78,65,RW,2017
32577,3,21,Sebastian D Aho,1,22,4,D,2017
32578,0,20,Sebastien Bisaillon,0,2,0,D,2006
32579,0,20,Sebastien Bordeleau,0,4,0,C,1995
32580,9,21,Sebastien Bordeleau,2,28,11,C,1996
32581,8,22,Sebastien Bordeleau,6,53,14,C,1997
32582,24,23,Sebastien Bordeleau,16,72,40,C,1998
32583,13,24,Sebastien Bordeleau,10,60,23,C,1999
32584,3,25,Sebastien Bordeleau,2,14,5,C,2000
32585,4,26,Sebastien Bordeleau,1,20,5,C,2001
32586,0,19,Selmar Odelein,0,4,0,D,1985
32587,2,21,Selmar Odelein,0,12,2,D,1987
32588,0,22,Selmar Odelein,0,2,0,D,1988
32589,0,28,Seppo Ahokainen,0,1,0,RW,1978
32590,0,28,Seppo Ahokainen,0,1,0,RW,1978
32591,31,29,Seppo Repo,29,80,60,C,1976
32592,0,31,Seppo Repo,0,1,0,RW,1978
32593,0,31,Seppo Repo,0,1,0,RW,1978
32594,0,28,Seppo Suoraniemi,0,1,0,RW,1978
32595,0,23,Serge Aubin,0,1,0,C,1998
32596,1,24,Serge Aubin,2,15,3,LW,1999
32597,17,25,Serge Aubin,13,81,30,C,2000
32598,8,26,Serge Aubin,8,71,16,C,2001
32599,6,27,Serge Aubin,4,66,10,C,2002
32600,15,28,Serge Aubin,10,66,25,LW,2003
32601,17,30,Serge Aubin,7,74,24,C,2005
32602,11,21,Serge Beaudoin,1,26,12,D,1973
32603,11,21,Serge Beaudoin,1,26,12,D,1973
32604,0,22,Serge Beaudoin,0,4,0,D,1974
32605,0,22,Serge Beaudoin,0,4,0,D,1974
32606,21,23,Serge Beaudoin,0,76,21,D,1975
32607,21,23,Serge Beaudoin,0,76,21,D,1975
32608,24,24,Serge Beaudoin,6,77,30,D,1976
32609,24,24,Serge Beaudoin,6,77,30,D,1976
32610,26,25,Serge Beaudoin,8,77,34,D,1977
32611,25,25,Serge Beaudoin,8,64,33,D,1977
32612,1,25,Serge Beaudoin,0,13,1,D,1977
32613,1,25,Serge Beaudoin,0,13,1,D,1977
32614,21,26,Serge Beaudoin,5,72,26,D,1978
32615,21,26,Serge Beaudoin,5,72,26,D,1978
32616,0,27,Serge Beaudoin,0,3,0,D,1979
32617,0,21,Serge Bernier,0,1,0,C,1968
32618,1,22,Serge Bernier,0,1,1,C,1969
32619,28,23,Serge Bernier,23,77,51,RW,1970
32620,22,24,Serge Bernier,23,70,45,C,1971
32621,46,25,Serge Bernier,22,75,68,RW,1972
32622,49,26,Serge Bernier,37,74,86,C,1973
32623,49,26,Serge Bernier,37,74,86,C,1973
32624,68,27,Serge Bernier,54,76,122,C,1974
32625,68,27,Serge Bernier,54,76,122,C,1974
32626,68,28,Serge Bernier,34,70,102,C,1975
32627,68,28,Serge Bernier,34,70,102,C,1975
32628,53,29,Serge Bernier,43,74,96,C,1976
32629,53,29,Serge Bernier,43,74,96,C,1976
32630,52,30,Serge Bernier,26,58,78,C,1977
32631,52,30,Serge Bernier,26,58,78,C,1977
32632,46,31,Serge Bernier,36,65,82,C,1978
32633,46,31,Serge Bernier,36,65,82,C,1978
32634,14,32,Serge Bernier,8,32,22,C,1979
32635,8,33,Serge Bernier,2,46,10,RW,1980
32636,2,23,Serge Boisvert,0,17,2,RW,1982
32637,2,25,Serge Boisvert,2,14,4,RW,1984
32638,2,26,Serge Boisvert,2,9,4,RW,1985
32639,0,27,Serge Boisvert,0,1,0,RW,1986
32640,1,28,Serge Boisvert,1,5,2,RW,1987
32641,3,20,Serge Lajeunesse,1,62,4,D,1970
32642,0,21,Serge Lajeunesse,0,7,0,D,1971
32643,1,22,Serge Lajeunesse,0,28,1,D,1972
32644,0,23,Serge Lajeunesse,0,1,0,D,1973
32645,0,24,Serge Lajeunesse,0,5,0,D,1974
32646,1,21,Serge Payer,5,43,6,C,2000
32647,1,24,Serge Payer,0,5,1,C,2003
32648,4,26,Serge Payer,2,71,6,RW,2005
32649,0,27,Serge Payer,0,5,0,C,2006
32650,0,25,Serge Roberge,0,9,0,RW,1990
32651,13,22,Serge Savard,2,67,15,D,1967
32652,23,23,Serge Savard,8,74,31,D,1968
32653,19,24,Serge Savard,12,64,31,D,1969
32654,10,25,Serge Savard,5,37,15,D,1970
32655,8,26,Serge Savard,1,23,9,D,1971
32656,32,27,Serge Savard,7,74,39,D,1972
32657,14,28,Serge Savard,4,67,18,D,1973
32658,40,29,Serge Savard,20,80,60,D,1974
32659,39,30,Serge Savard,8,71,47,D,1975
32660,33,31,Serge Savard,9,78,42,D,1976
32661,34,32,Serge Savard,8,77,42,D,1977
32662,26,33,Serge Savard,7,80,33,D,1978
32663,8,34,Serge Savard,5,46,13,D,1979
32664,13,35,Serge Savard,4,77,17,D,1980
32665,5,36,Serge Savard,2,47,7,D,1981
32666,16,37,Serge Savard,4,76,20,D,1982
32667,18,25,Sergei Bautin,5,71,23,D,1992
32668,7,26,Sergei Bautin,0,60,7,D,1993
32669,0,28,Sergei Bautin,0,1,0,D,1995
32670,16,25,Sergei Berezin,25,73,41,LW,1996
32671,15,26,Sergei Berezin,16,68,31,LW,1997
32672,22,27,Sergei Berezin,37,76,59,RW,1998
32673,13,28,Sergei Berezin,26,61,39,LW,1999
32674,28,29,Sergei Berezin,22,79,50,LW,2000
32675,15,30,Sergei Berezin,11,70,26,LW,2001
32676,17,31,Sergei Berezin,23,75,40,LW,2002
32677,8,21,Sergei Brylin,6,26,14,C,1994
32678,5,22,Sergei Brylin,4,50,9,C,1995
32679,2,23,Sergei Brylin,2,29,4,C,1996
32680,3,24,Sergei Brylin,2,18,5,C,1997
32681,10,25,Sergei Brylin,5,47,15,C,1998
32682,11,26,Sergei Brylin,9,64,20,C,1999
32683,29,27,Sergei Brylin,23,75,52,LW,2000
32684,28,28,Sergei Brylin,16,76,44,LW,2001
32685,8,29,Sergei Brylin,11,52,19,LW,2002
32686,19,30,Sergei Brylin,14,82,33,C,2003
32687,22,32,Sergei Brylin,15,82,37,LW,2005
32688,24,33,Sergei Brylin,16,82,40,C,2006
32689,10,34,Sergei Brylin,6,82,16,C,2007
32690,48,21,Sergei Fedorov,31,77,79,C,1990
32691,54,22,Sergei Fedorov,32,80,86,C,1991
32692,53,23,Sergei Fedorov,34,73,87,C,1992
32693,64,24,Sergei Fedorov,56,82,120,C,1993
32694,30,25,Sergei Fedorov,20,42,50,C,1994
32695,68,26,Sergei Fedorov,39,78,107,RW,1995
32696,33,27,Sergei Fedorov,30,74,63,C,1996
32697,11,28,Sergei Fedorov,6,21,17,RW,1997
32698,37,29,Sergei Fedorov,26,77,63,C,1998
32699,35,30,Sergei Fedorov,27,68,62,C,1999
32700,37,31,Sergei Fedorov,32,75,69,C,2000
32701,37,32,Sergei Fedorov,31,81,68,C,2001
32702,47,33,Sergei Fedorov,36,80,83,C,2002
32703,34,34,Sergei Fedorov,31,80,65,C,2003
32704,32,36,Sergei Fedorov,12,67,44,C,2005
32705,24,37,Sergei Fedorov,18,73,42,C,2006
32706,30,38,Sergei Fedorov,11,68,41,C,2007
32707,22,39,Sergei Fedorov,11,52,33,C,2008
32708,0,28,Sergei Gimaev,0,6,0,RW,1977
32709,0,28,Sergei Gimaev,0,6,0,RW,1977
32710,2,28,Sergei Gimaev,3,6,5,RW,1978
32711,2,28,Sergei Gimaev,3,6,5,RW,1978
32712,5,20,Sergei Gonchar,2,31,7,D,1994
32713,26,21,Sergei Gonchar,15,78,41,D,1995
32714,17,22,Sergei Gonchar,13,57,30,D,1996
32715,16,23,Sergei Gonchar,5,72,21,D,1997
32716,10,24,Sergei Gonchar,21,53,31,D,1998
32717,36,25,Sergei Gonchar,18,73,54,D,1999
32718,38,26,Sergei Gonchar,19,76,57,D,2000
32719,33,27,Sergei Gonchar,26,76,59,D,2001
32720,49,28,Sergei Gonchar,18,82,67,D,2002
32721,47,29,Sergei Gonchar,11,71,58,D,2003
32722,46,31,Sergei Gonchar,12,75,58,D,2005
32723,54,32,Sergei Gonchar,13,82,67,D,2006
32724,53,33,Sergei Gonchar,12,78,65,D,2007
32725,13,34,Sergei Gonchar,6,25,19,D,2008
32726,39,35,Sergei Gonchar,11,62,50,D,2009
32727,20,36,Sergei Gonchar,7,67,27,D,2010
32728,32,37,Sergei Gonchar,5,74,37,D,2011
32729,24,38,Sergei Gonchar,3,45,27,D,2012
32730,20,39,Sergei Gonchar,2,76,22,D,2013
32731,13,40,Sergei Gonchar,1,48,14,D,2014
32732,0,25,Sergei Kapustin,2,5,2,RW,1978
32733,0,25,Sergei Kapustin,2,5,2,RW,1978
32734,3,27,Sergei Kharin,2,7,5,RW,1990
32735,0,22,Sergei Klimovich,0,1,0,C,1996
32736,0,,Sergei Korotov,0,6,0,D,1977
32737,0,,Sergei Korotov,0,6,0,D,1977
32738,18,20,Sergei Kostitsyn,9,52,27,LW,2007
32739,15,21,Sergei Kostitsyn,8,56,23,LW,2008
32740,11,22,Sergei Kostitsyn,7,47,18,LW,2009
32741,27,23,Sergei Kostitsyn,23,77,50,LW,2010
32742,26,24,Sergei Kostitsyn,17,75,43,LW,2011
32743,12,25,Sergei Kostitsyn,3,46,15,LW,2012
32744,0,18,Sergei Krivokrasov,0,4,0,RW,1992
32745,0,19,Sergei Krivokrasov,1,9,1,RW,1993
32746,7,20,Sergei Krivokrasov,12,41,19,LW,1994
32747,10,21,Sergei Krivokrasov,6,46,16,LW,1995
32748,11,22,Sergei Krivokrasov,13,67,24,LW,1996
32749,13,23,Sergei Krivokrasov,10,58,23,LW,1997
32750,23,24,Sergei Krivokrasov,25,70,48,RW,1998
32751,27,25,Sergei Krivokrasov,10,75,37,RW,1999
32752,15,26,Sergei Krivokrasov,7,54,22,RW,2000
32753,3,27,Sergei Krivokrasov,2,26,5,RW,2001
32754,62,31,Sergei Makarov,24,80,86,RW,1989
32755,49,32,Sergei Makarov,30,78,79,RW,1990
32756,48,33,Sergei Makarov,22,68,70,RW,1991
32757,39,34,Sergei Makarov,18,71,57,RW,1992
32758,38,35,Sergei Makarov,30,80,68,RW,1993
32759,14,36,Sergei Makarov,10,43,24,RW,1994
32760,0,38,Sergei Makarov,0,4,0,RW,1996
32761,28,28,Sergei Nemchinov,30,73,58,C,1991
32762,31,29,Sergei Nemchinov,23,81,54,C,1992
32763,27,30,Sergei Nemchinov,22,76,49,C,1993
32764,6,31,Sergei Nemchinov,7,47,13,LW,1994
32765,15,32,Sergei Nemchinov,17,78,32,C,1995
32766,16,33,Sergei Nemchinov,8,69,24,C,1996
32767,19,34,Sergei Nemchinov,10,74,29,C,1997
32768,8,35,Sergei Nemchinov,12,77,20,C,1998
32769,16,36,Sergei Nemchinov,10,53,26,C,1999
32770,22,37,Sergei Nemchinov,8,65,30,C,2000
32771,5,38,Sergei Nemchinov,5,68,10,LW,2001
32772,4,25,Sergei Petrenko,0,14,4,LW,1993
32773,3,25,Sergei Plotnikov,0,45,3,LW,2015
32774,1,,Sergei Podgortsev,0,2,1,LW,1977
32775,1,,Sergei Podgortsev,0,2,1,LW,1977
32776,0,25,Sergei Priakin,0,2,0,RW,1988
32777,2,26,Sergei Priakin,2,20,4,RW,1989
32778,6,27,Sergei Priakin,1,24,7,RW,1990
32779,25,19,Sergei Samsonov,22,81,47,LW,1997
32780,26,20,Sergei Samsonov,25,79,51,LW,1998
32781,26,21,Sergei Samsonov,19,77,45,LW,1999
32782,46,22,Sergei Samsonov,29,82,75,LW,2000
32783,41,23,Sergei Samsonov,29,74,70,LW,2001
32784,6,24,Sergei Samsonov,5,8,11,LW,2002
32785,23,25,Sergei Samsonov,17,58,40,LW,2003
32786,30,27,Sergei Samsonov,23,74,53,LW,2005
32787,17,28,Sergei Samsonov,9,63,26,LW,2006
32788,22,29,Sergei Samsonov,14,61,36,LW,2007
32789,32,30,Sergei Samsonov,16,81,48,LW,2008
32790,15,31,Sergei Samsonov,14,72,29,LW,2009
32791,27,32,Sergei Samsonov,13,78,40,LW,2010
32792,0,23,Sergei Shirokov,0,6,0,LW,2009
32793,0,24,Sergei Shirokov,1,2,1,LW,2010
32794,1,31,Sergei Starikov,0,16,1,D,1989
32795,2,28,Sergei Tyznyk,0,6,2,RW,1978
32796,2,28,Sergei Tyznyk,0,6,2,RW,1978
32797,0,19,Sergei Varlamov,0,1,0,LW,1997
32798,0,21,Sergei Varlamov,3,7,3,RW,1999
32799,7,23,Sergei Varlamov,5,52,12,LW,2001
32800,0,24,Sergei Varlamov,0,3,0,LW,2002
32801,3,25,Sergei Vyshedkevich,1,7,4,D,1999
32802,2,26,Sergei Vyshedkevich,1,23,3,D,2000
32803,1,20,Sergei Zholtok,0,1,1,LW,1992
32804,1,21,Sergei Zholtok,2,24,3,LW,1993
32805,16,24,Sergei Zholtok,12,57,28,C,1996
32806,13,25,Sergei Zholtok,10,78,23,RW,1997
32807,15,26,Sergei Zholtok,7,70,22,C,1998
32808,12,27,Sergei Zholtok,26,68,38,C,1999
32809,26,28,Sergei Zholtok,5,69,31,C,2000
32810,20,29,Sergei Zholtok,19,73,39,C,2001
32811,26,30,Sergei Zholtok,16,78,42,C,2002
32812,17,31,Sergei Zholtok,14,70,31,C,2003
32813,1,23,Sergei Zinovjev,0,10,1,C,2003
32814,23,22,Sergei Zubov,8,49,31,D,1992
32815,77,23,Sergei Zubov,12,78,89,D,1993
32816,26,24,Sergei Zubov,10,38,36,D,1994
32817,55,25,Sergei Zubov,11,64,66,D,1995
32818,30,26,Sergei Zubov,13,78,43,D,1996
32819,47,27,Sergei Zubov,10,73,57,D,1997
32820,41,28,Sergei Zubov,10,81,51,D,1998
32821,33,29,Sergei Zubov,9,77,42,D,1999
32822,41,30,Sergei Zubov,10,79,51,D,2000
32823,32,31,Sergei Zubov,12,80,44,D,2001
32824,44,32,Sergei Zubov,11,82,55,D,2002
32825,35,33,Sergei Zubov,7,77,42,D,2003
32826,58,35,Sergei Zubov,13,78,71,D,2005
32827,42,36,Sergei Zubov,12,78,54,D,2006
32828,31,37,Sergei Zubov,4,46,35,D,2007
32829,4,38,Sergei Zubov,0,10,4,D,2008
32830,0,22,Sergey Gusev,0,9,0,D,1997
32831,7,23,Sergey Gusev,1,36,8,D,1998
32832,3,24,Sergey Gusev,2,28,5,D,1999
32833,0,25,Sergey Gusev,1,16,1,D,2000
32834,7,24,Sergey Kalinin,8,78,15,C,2015
32835,2,25,Sergey Kalinin,2,43,4,C,2016
32836,1,20,Sergey Tolchinsky,0,2,1,LW,2015
32837,1,21,Sergey Tolchinsky,0,2,1,LW,2016
32838,0,18,Sergio Momesso,0,1,0,C,1983
32839,7,20,Sergio Momesso,8,24,15,LW,1985
32840,17,21,Sergio Momesso,14,59,31,LW,1986
32841,14,22,Sergio Momesso,7,53,21,LW,1987
32842,17,23,Sergio Momesso,9,53,26,LW,1988
32843,32,24,Sergio Momesso,24,79,56,LW,1989
32844,20,25,Sergio Momesso,16,70,36,RW,1990
32845,23,26,Sergio Momesso,20,58,43,LW,1991
32846,20,27,Sergio Momesso,18,84,38,LW,1992
32847,13,28,Sergio Momesso,14,68,27,LW,1993
32848,15,29,Sergio Momesso,10,48,25,LW,1994
32849,12,30,Sergio Momesso,11,73,23,LW,1995
32850,3,31,Sergio Momesso,1,40,4,LW,1996
32851,4,22,Seth Griffith,6,30,10,C,2014
32852,1,23,Seth Griffith,0,4,1,C,2015
32853,0,24,Seth Griffith,0,3,0,C,2016
32854,1,25,Seth Griffith,2,21,3,C,2017
32855,2,24,Seth Helgeson,0,22,2,D,2014
32856,1,25,Seth Helgeson,0,19,1,D,2015
32857,0,26,Seth Helgeson,1,9,1,D,2016
32858,19,19,Seth Jones,6,77,25,D,2013
32859,19,20,Seth Jones,8,82,27,D,2014
32860,28,21,Seth Jones,3,81,31,D,2015
32861,30,22,Seth Jones,12,75,42,D,2016
32862,41,23,Seth Jones,16,78,57,D,2017
32863,1,21,Shane Churla,0,20,1,RW,1986
32864,5,22,Shane Churla,1,31,6,RW,1987
32865,0,23,Shane Churla,1,18,1,RW,1988
32866,3,24,Shane Churla,2,53,5,RW,1989
32867,2,25,Shane Churla,2,40,4,RW,1990
32868,1,26,Shane Churla,4,57,5,RW,1991
32869,16,27,Shane Churla,5,73,21,RW,1992
32870,7,28,Shane Churla,6,69,13,RW,1993
32871,3,29,Shane Churla,1,27,4,RW,1994
32872,6,30,Shane Churla,4,55,10,RW,1995
32873,1,31,Shane Churla,0,45,1,RW,1996
32874,10,19,Shane Doan,7,74,17,RW,1995
32875,8,20,Shane Doan,4,63,12,RW,1996
32876,6,21,Shane Doan,5,33,11,RW,1997
32877,16,22,Shane Doan,6,79,22,RW,1998
32878,25,23,Shane Doan,26,81,51,RW,1999
32879,37,24,Shane Doan,26,76,63,RW,2000
32880,29,25,Shane Doan,20,81,49,RW,2001
32881,37,26,Shane Doan,21,82,58,LW,2002
32882,41,27,Shane Doan,27,79,68,RW,2003
32883,36,29,Shane Doan,30,82,66,RW,2005
32884,28,30,Shane Doan,27,73,55,RW,2006
32885,50,31,Shane Doan,28,80,78,RW,2007
32886,42,32,Shane Doan,31,82,73,RW,2008
32887,37,33,Shane Doan,18,82,55,RW,2009
32888,40,34,Shane Doan,20,72,60,RW,2010
32889,28,35,Shane Doan,22,79,50,RW,2011
32890,14,36,Shane Doan,13,48,27,RW,2012
32891,24,37,Shane Doan,23,69,47,RW,2013
32892,22,38,Shane Doan,14,79,36,RW,2014
32893,19,39,Shane Doan,28,72,47,RW,2015
32894,21,40,Shane Doan,6,74,27,RW,2016
32895,1,20,Shane Endicott,0,4,1,C,2001
32896,1,24,Shane Endicott,1,41,2,C,2005
32897,1,21,Shane Gersich,0,3,1,LW,2017
32898,1,27,Shane Harper,2,14,3,RW,2016
32899,2,25,Shane Hnidy,3,52,5,D,2000
32900,1,26,Shane Hnidy,1,33,2,D,2001
32901,8,27,Shane Hnidy,0,67,8,D,2002
32902,7,28,Shane Hnidy,0,46,7,D,2003
32903,3,30,Shane Hnidy,0,66,3,D,2005
32904,7,31,Shane Hnidy,5,72,12,D,2006
32905,6,32,Shane Hnidy,2,76,8,D,2007
32906,9,33,Shane Hnidy,3,65,12,D,2008
32907,12,34,Shane Hnidy,2,70,14,D,2009
32908,0,35,Shane Hnidy,0,3,0,D,2010
32909,0,20,Shane MacEachern,0,1,0,C,1987
32910,14,23,Shane O'Brien,2,80,16,D,2006
32911,17,24,Shane O'Brien,4,77,21,D,2007
32912,10,25,Shane O'Brien,0,77,10,D,2008
32913,6,26,Shane O'Brien,2,65,8,D,2009
32914,7,27,Shane O'Brien,2,80,9,D,2010
32915,17,28,Shane O'Brien,3,76,20,D,2011
32916,4,29,Shane O'Brien,0,28,4,D,2012
32917,3,30,Shane O'Brien,0,45,3,D,2013
32918,1,31,Shane O'Brien,0,9,1,D,2014
32919,1,22,Shane Prince,0,2,1,LW,2014
32920,11,23,Shane Prince,6,62,17,LW,2015
32921,13,24,Shane Prince,5,50,18,LW,2016
32922,1,25,Shane Prince,1,14,2,LW,2017
32923,0,22,Shane Sims,0,1,0,D,2010
32924,0,21,Shane Willis,0,7,0,RW,1998
32925,0,22,Shane Willis,0,2,0,RW,1999
32926,24,23,Shane Willis,20,73,44,RW,2000
32927,13,24,Shane Willis,11,80,24,RW,2001
32928,6,26,Shane Willis,0,12,6,RW,2003
32929,0,20,Shaone Morrisonn,0,11,0,D,2002
32930,7,21,Shaone Morrisonn,1,33,8,D,2003
32931,13,23,Shaone Morrisonn,1,80,14,D,2005
32932,10,24,Shaone Morrisonn,3,78,13,D,2006
32933,9,25,Shaone Morrisonn,1,76,10,D,2007
32934,10,26,Shaone Morrisonn,3,72,13,D,2008
32935,11,27,Shaone Morrisonn,1,68,12,D,2009
32936,4,28,Shaone Morrisonn,1,62,5,D,2010
32937,2,24,Shaun Heshka,0,8,2,D,2009
32938,0,23,Shaun Sabol,0,2,0,D,1989
32939,0,23,Shaun Van Allen,0,2,0,C,1990
32940,4,25,Shaun Van Allen,1,21,5,C,1992
32941,25,26,Shaun Van Allen,8,80,33,C,1993
32942,21,27,Shaun Van Allen,8,45,29,C,1994
32943,17,28,Shaun Van Allen,8,49,25,C,1995
32944,14,29,Shaun Van Allen,11,80,25,C,1996
32945,15,30,Shaun Van Allen,4,80,19,C,1997
32946,11,31,Shaun Van Allen,6,79,17,C,1998
32947,19,32,Shaun Van Allen,9,75,28,C,1999
32948,16,33,Shaun Van Allen,7,59,23,C,2000
32949,13,34,Shaun Van Allen,8,73,21,C,2001
32950,20,35,Shaun Van Allen,12,78,32,C,2002
32951,10,36,Shaun Van Allen,2,73,12,LW,2003
32952,11,18,Shawn Anderson,2,41,13,D,1986
32953,2,19,Shawn Anderson,1,23,3,D,1987
32954,10,20,Shawn Anderson,2,33,12,D,1988
32955,3,21,Shawn Anderson,1,16,4,D,1989
32956,10,22,Shawn Anderson,3,31,13,D,1990
32957,6,24,Shawn Anderson,2,60,8,D,1992
32958,9,25,Shawn Anderson,0,50,9,D,1993
32959,0,26,Shawn Anderson,0,1,0,D,1994
32960,0,20,Shawn Antoski,0,2,0,LW,1990
32961,0,21,Shawn Antoski,0,4,0,LW,1991
32962,0,22,Shawn Antoski,0,2,0,LW,1992
32963,2,23,Shawn Antoski,1,55,3,LW,1993
32964,0,24,Shawn Antoski,0,32,0,LW,1994
32965,3,25,Shawn Antoski,1,64,4,LW,1995
32966,0,26,Shawn Antoski,0,15,0,LW,1996
32967,0,27,Shawn Antoski,1,9,1,LW,1997
32968,0,22,Shawn Bates,2,13,2,C,1997
32969,4,23,Shawn Bates,5,33,9,C,1998
32970,7,24,Shawn Bates,5,44,12,C,1999
32971,3,25,Shawn Bates,2,45,5,C,2000
32972,35,26,Shawn Bates,17,71,52,LW,2001
32973,29,27,Shawn Bates,13,74,42,LW,2002
32974,23,28,Shawn Bates,9,69,32,C,2003
32975,19,30,Shawn Bates,15,66,34,C,2005
32976,6,31,Shawn Bates,4,48,10,C,2006
32977,0,32,Shawn Bates,0,2,0,C,2007
32978,1,22,Shawn Belle,0,9,1,D,2006
32979,0,25,Shawn Belle,0,2,0,D,2009
32980,0,26,Shawn Belle,0,9,0,D,2010
32981,0,18,Shawn Burr,0,9,0,LW,1984
32982,0,19,Shawn Burr,1,5,1,C,1985
32983,25,20,Shawn Burr,22,80,47,C,1986
32984,23,21,Shawn Burr,17,78,40,C,1987
32985,27,22,Shawn Burr,19,79,46,LW,1988
32986,32,23,Shawn Burr,24,76,56,LW,1989
32987,30,24,Shawn Burr,20,80,50,LW,1990
32988,32,25,Shawn Burr,19,79,51,LW,1991
32989,25,26,Shawn Burr,10,80,35,LW,1992
32990,12,27,Shawn Burr,10,51,22,LW,1993
32991,8,28,Shawn Burr,6,42,14,LW,1994
32992,15,29,Shawn Burr,13,81,28,LW,1995
32993,21,30,Shawn Burr,14,74,35,LW,1996
32994,6,31,Shawn Burr,6,42,12,LW,1997
32995,1,32,Shawn Burr,0,18,1,LW,1998
32996,2,33,Shawn Burr,0,4,2,LW,1999
32997,0,22,Shawn Byram,0,4,0,LW,1990
32998,0,23,Shawn Byram,0,1,0,LW,1991
32999,7,21,Shawn Chambers,1,19,8,D,1987
33000,19,22,Shawn Chambers,5,72,24,D,1988
33001,18,23,Shawn Chambers,8,78,26,D,1989
33002,3,24,Shawn Chambers,1,29,4,D,1990
33003,0,25,Shawn Chambers,0,2,0,D,1991
33004,29,26,Shawn Chambers,10,55,39,D,1992
33005,23,27,Shawn Chambers,11,66,34,D,1993
33006,17,28,Shawn Chambers,4,45,21,D,1994
33007,21,29,Shawn Chambers,2,64,23,D,1995
33008,17,30,Shawn Chambers,4,73,21,D,1996
33009,22,31,Shawn Chambers,2,57,24,D,1997
33010,9,32,Shawn Chambers,2,61,11,D,1998
33011,0,33,Shawn Chambers,0,4,0,D,1999
33012,0,25,Shawn Cronin,0,1,0,D,1988
33013,4,26,Shawn Cronin,0,61,4,D,1989
33014,5,27,Shawn Cronin,1,67,6,D,1990
33015,4,28,Shawn Cronin,0,65,4,D,1991
33016,1,29,Shawn Cronin,2,35,3,D,1992
33017,2,30,Shawn Cronin,0,34,2,D,1993
33018,2,31,Shawn Cronin,0,29,2,D,1994
33019,0,20,Shawn Evans,0,7,0,D,1985
33020,0,24,Shawn Evans,1,2,1,D,1989
33021,0,24,Shawn Heaphy,0,1,0,C,1992
33022,0,25,Shawn Heins,0,5,0,D,1998
33023,0,26,Shawn Heins,0,1,0,D,1999
33024,4,27,Shawn Heins,3,38,7,D,2000
33025,2,28,Shawn Heins,0,17,2,D,2001
33026,2,29,Shawn Heins,1,47,3,D,2002
33027,4,30,Shawn Heins,0,17,4,D,2003
33028,7,22,Shawn Horcoff,9,49,16,RW,2000
33029,14,23,Shawn Horcoff,8,61,22,LW,2001
33030,21,24,Shawn Horcoff,12,78,33,LW,2002
33031,25,25,Shawn Horcoff,15,80,40,C,2003
33032,51,27,Shawn Horcoff,22,79,73,LW,2005
33033,35,28,Shawn Horcoff,16,80,51,C,2006
33034,29,29,Shawn Horcoff,21,53,50,C,2007
33035,36,30,Shawn Horcoff,17,80,53,C,2008
33036,23,31,Shawn Horcoff,13,77,36,C,2009
33037,18,32,Shawn Horcoff,9,47,27,C,2010
33038,21,33,Shawn Horcoff,13,81,34,C,2011
33039,5,34,Shawn Horcoff,7,31,12,C,2012
33040,13,35,Shawn Horcoff,7,77,20,C,2013
33041,18,36,Shawn Horcoff,11,76,29,C,2014
33042,9,37,Shawn Horcoff,6,59,15,C,2015
33043,0,22,Shawn Lalonde,0,1,0,D,2012
33044,0,19,Shawn Matthias,2,4,2,C,2007
33045,2,20,Shawn Matthias,0,16,2,C,2008
33046,9,21,Shawn Matthias,7,55,16,C,2009
33047,10,22,Shawn Matthias,6,51,16,C,2010
33048,14,23,Shawn Matthias,10,79,24,C,2011
33049,7,24,Shawn Matthias,14,48,21,C,2012
33050,11,25,Shawn Matthias,12,77,23,C,2013
33051,9,26,Shawn Matthias,18,78,27,C,2014
33052,16,27,Shawn Matthias,12,71,28,C,2015
33053,4,28,Shawn Matthias,8,45,12,LW,2016
33054,2,29,Shawn Matthias,1,27,3,LW,2017
33055,0,22,Shawn McCosh,0,4,0,C,1991
33056,0,25,Shawn McCosh,1,5,1,C,1994
33057,4,22,Shawn McEachern,0,15,4,C,1991
33058,33,23,Shawn McEachern,28,84,61,LW,1992
33059,22,24,Shawn McEachern,20,76,42,C,1993
33060,13,25,Shawn McEachern,13,44,26,RW,1994
33061,29,26,Shawn McEachern,24,82,53,LW,1995
33062,20,27,Shawn McEachern,11,65,31,LW,1996
33063,24,28,Shawn McEachern,24,81,48,LW,1997
33064,25,29,Shawn McEachern,31,77,56,LW,1998
33065,22,30,Shawn McEachern,29,69,51,LW,1999
33066,40,31,Shawn McEachern,32,82,72,LW,2000
33067,31,32,Shawn McEachern,15,80,46,LW,2001
33068,16,33,Shawn McEachern,10,46,26,LW,2002
33069,38,34,Shawn McEachern,17,82,55,RW,2003
33070,6,36,Shawn McEachern,2,28,8,LW,2005
33071,2,22,Shawn Rivers,0,4,2,D,1992
33072,1,25,Shawn Thornton,1,13,2,RW,2002
33073,0,26,Shawn Thornton,1,8,1,RW,2003
33074,0,28,Shawn Thornton,0,10,0,D,2005
33075,7,29,Shawn Thornton,2,48,9,LW,2006
33076,3,30,Shawn Thornton,4,58,7,LW,2007
33077,5,31,Shawn Thornton,6,79,11,LW,2008
33078,9,32,Shawn Thornton,1,74,10,RW,2009
33079,10,33,Shawn Thornton,10,79,20,RW,2010
33080,8,34,Shawn Thornton,5,81,13,RW,2011
33081,4,35,Shawn Thornton,3,45,7,RW,2012
33082,3,36,Shawn Thornton,5,64,8,LW,2013
33083,4,37,Shawn Thornton,1,46,5,LW,2014
33084,4,38,Shawn Thornton,1,50,5,LW,2015
33085,2,39,Shawn Thornton,2,50,4,LW,2016
33086,0,23,Shay Stephenson,0,2,0,LW,2006
33087,0,19,Shayne Corson,0,3,0,C,1985
33088,11,20,Shayne Corson,12,55,23,C,1986
33089,27,21,Shayne Corson,12,71,39,C,1987
33090,24,22,Shayne Corson,26,80,50,C,1988
33091,44,23,Shayne Corson,31,76,75,LW,1989
33092,24,24,Shayne Corson,23,71,47,LW,1990
33093,36,25,Shayne Corson,17,64,53,LW,1991
33094,31,26,Shayne Corson,16,80,47,LW,1992
33095,29,27,Shayne Corson,25,64,54,LW,1993
33096,24,28,Shayne Corson,12,48,36,LW,1994
33097,28,29,Shayne Corson,18,77,46,LW,1995
33098,16,30,Shayne Corson,8,58,24,LW,1996
33099,34,31,Shayne Corson,21,62,55,LW,1997
33100,20,32,Shayne Corson,12,63,32,LW,1998
33101,20,33,Shayne Corson,8,70,28,LW,1999
33102,18,34,Shayne Corson,8,77,26,C,2000
33103,21,35,Shayne Corson,12,74,33,C,2001
33104,8,36,Shayne Corson,7,46,15,LW,2002
33105,5,37,Shayne Corson,5,17,10,LW,2003
33106,0,21,Shayne Gostisbehere,0,2,0,D,2014
33107,29,22,Shayne Gostisbehere,17,64,46,D,2015
33108,32,23,Shayne Gostisbehere,7,76,39,D,2016
33109,52,24,Shayne Gostisbehere,13,78,65,D,2017
33110,0,20,Shayne Stevenson,0,14,0,RW,1990
33111,1,21,Shayne Stevenson,0,5,1,RW,1991
33112,1,22,Shayne Stevenson,0,8,1,RW,1992
33113,0,21,Shayne Toporowski,0,3,0,RW,1996
33114,5,20,Shea Theodore,3,19,8,D,2015
33115,7,21,Shea Theodore,2,34,9,D,2016
33116,23,22,Shea Theodore,6,61,29,D,2017
33117,8,20,Shea Weber,2,28,10,D,2005
33118,23,21,Shea Weber,17,79,40,D,2006
33119,14,22,Shea Weber,6,54,20,D,2007
33120,30,23,Shea Weber,23,81,53,D,2008
33121,27,24,Shea Weber,16,78,43,D,2009
33122,32,25,Shea Weber,16,82,48,D,2010
33123,30,26,Shea Weber,19,78,49,D,2011
33124,19,27,Shea Weber,9,48,28,D,2012
33125,33,28,Shea Weber,23,79,56,D,2013
33126,30,29,Shea Weber,15,78,45,D,2014
33127,31,30,Shea Weber,20,78,51,D,2015
33128,25,31,Shea Weber,17,78,42,D,2016
33129,10,32,Shea Weber,6,26,16,D,2017
33130,0,20,Shean Donovan,0,14,0,RW,1994
33131,8,21,Shean Donovan,13,74,21,RW,1995
33132,6,22,Shean Donovan,9,73,15,RW,1996
33133,10,23,Shean Donovan,8,67,18,RW,1997
33134,12,24,Shean Donovan,7,68,19,RW,1998
33135,7,25,Shean Donovan,5,51,12,RW,1999
33136,11,26,Shean Donovan,12,63,23,RW,2000
33137,7,27,Shean Donovan,8,61,15,RW,2001
33138,7,28,Shean Donovan,5,65,12,RW,2002
33139,24,29,Shean Donovan,18,82,42,RW,2003
33140,11,31,Shean Donovan,9,80,20,RW,2005
33141,11,32,Shean Donovan,6,76,17,RW,2006
33142,7,33,Shean Donovan,5,82,12,RW,2007
33143,5,34,Shean Donovan,5,65,10,RW,2008
33144,3,35,Shean Donovan,2,30,5,RW,2009
33145,1,26,Sheldon Brookbank,0,3,1,D,2006
33146,8,27,Sheldon Brookbank,0,44,8,D,2007
33147,3,28,Sheldon Brookbank,1,44,4,D,2008
33148,9,29,Sheldon Brookbank,0,66,9,D,2009
33149,0,30,Sheldon Brookbank,0,40,0,D,2010
33150,11,31,Sheldon Brookbank,3,80,14,D,2011
33151,0,32,Sheldon Brookbank,1,26,1,D,2012
33152,5,33,Sheldon Brookbank,2,48,7,D,2013
33153,2,23,Sheldon Kannegiesser,0,18,2,D,1970
33154,4,24,Sheldon Kannegiesser,2,54,6,D,1971
33155,1,25,Sheldon Kannegiesser,0,6,1,D,1972
33156,20,26,Sheldon Kannegiesser,4,63,24,D,1973
33157,23,27,Sheldon Kannegiesser,2,74,25,D,1974
33158,9,28,Sheldon Kannegiesser,4,70,13,D,1975
33159,1,29,Sheldon Kannegiesser,1,39,2,D,1976
33160,7,30,Sheldon Kannegiesser,1,42,8,D,1977
33161,0,20,Sheldon Keefe,4,49,4,RW,2000
33162,7,21,Sheldon Keefe,6,39,13,RW,2001
33163,5,22,Sheldon Keefe,2,37,7,RW,2002
33164,7,20,Sheldon Kennedy,2,20,9,RW,1989
33165,0,21,Sheldon Kennedy,1,7,1,RW,1990
33166,8,22,Sheldon Kennedy,3,27,11,RW,1991
33167,11,23,Sheldon Kennedy,19,68,30,C,1992
33168,7,24,Sheldon Kennedy,6,61,13,RW,1993
33169,8,25,Sheldon Kennedy,7,30,15,RW,1994
33170,7,26,Sheldon Kennedy,3,41,10,RW,1995
33171,10,27,Sheldon Kennedy,8,56,18,RW,1996
33172,7,21,Sheldon Souray,3,60,10,D,1997
33173,7,22,Sheldon Souray,1,70,8,D,1998
33174,8,23,Sheldon Souray,3,71,11,D,1999
33175,8,24,Sheldon Souray,3,52,11,D,2000
33176,5,25,Sheldon Souray,3,34,8,D,2001
33177,20,27,Sheldon Souray,15,63,35,D,2003
33178,27,29,Sheldon Souray,12,75,39,D,2005
33179,38,30,Sheldon Souray,26,81,64,D,2006
33180,7,31,Sheldon Souray,3,26,10,D,2007
33181,30,32,Sheldon Souray,23,81,53,D,2008
33182,9,33,Sheldon Souray,4,37,13,D,2009
33183,15,35,Sheldon Souray,6,64,21,D,2011
33184,10,36,Sheldon Souray,7,44,17,D,2012
33185,6,24,Shjon Podein,13,40,19,C,1992
33186,5,25,Shjon Podein,3,28,8,RW,1993
33187,7,26,Shjon Podein,3,44,10,LW,1994
33188,10,27,Shjon Podein,15,79,25,LW,1995
33189,18,28,Shjon Podein,14,82,32,LW,1996
33190,13,29,Shjon Podein,11,82,24,RW,1997
33191,6,30,Shjon Podein,3,55,9,LW,1998
33192,8,31,Shjon Podein,11,75,19,LW,1999
33193,17,32,Shjon Podein,15,82,32,RW,2000
33194,10,33,Shjon Podein,8,64,18,RW,2001
33195,6,34,Shjon Podein,4,68,10,RW,2002
33196,0,22,Sid Veysey,0,1,0,C,1977
33197,63,18,Sidney Crosby,39,81,102,C,2005
33198,84,19,Sidney Crosby,36,79,120,C,2006
33199,48,20,Sidney Crosby,24,53,72,C,2007
33200,70,21,Sidney Crosby,33,77,103,C,2008
33201,58,22,Sidney Crosby,51,81,109,C,2009
33202,34,23,Sidney Crosby,32,41,66,C,2010
33203,29,24,Sidney Crosby,8,22,37,C,2011
33204,41,25,Sidney Crosby,15,36,56,C,2012
33205,68,26,Sidney Crosby,36,80,104,C,2013
33206,56,27,Sidney Crosby,28,77,84,C,2014
33207,49,28,Sidney Crosby,36,80,85,C,2015
33208,45,29,Sidney Crosby,44,75,89,C,2016
33209,60,30,Sidney Crosby,29,82,89,C,2017
33210,0,21,Simo Saarinen,0,8,0,D,1984
33211,3,20,Simon Despres,1,18,4,D,2011
33212,5,21,Simon Despres,2,33,7,D,2012
33213,5,22,Simon Despres,0,34,5,D,2013
33214,20,23,Simon Despres,3,75,23,D,2014
33215,4,24,Simon Despres,0,32,4,D,2015
33216,0,25,Simon Despres,0,1,0,D,2016
33217,28,19,Simon Gagne,20,80,48,C,1999
33218,32,20,Simon Gagne,27,69,59,LW,2000
33219,33,21,Simon Gagne,33,79,66,LW,2001
33220,18,22,Simon Gagne,9,46,27,LW,2002
33221,21,23,Simon Gagne,24,80,45,LW,2003
33222,32,25,Simon Gagne,47,72,79,LW,2005
33223,27,26,Simon Gagne,41,76,68,LW,2006
33224,11,27,Simon Gagne,7,25,18,LW,2007
33225,40,28,Simon Gagne,34,79,74,LW,2008
33226,23,29,Simon Gagne,17,58,40,LW,2009
33227,23,30,Simon Gagne,17,63,40,LW,2010
33228,10,31,Simon Gagne,7,34,17,LW,2011
33229,11,32,Simon Gagne,5,38,16,LW,2012
33230,1,34,Simon Gagne,3,23,4,LW,2014
33231,0,22,Simon Gamache,0,2,0,C,2002
33232,1,23,Simon Gamache,1,9,2,LW,2003
33233,4,25,Simon Gamache,3,26,7,RW,2005
33234,2,27,Simon Gamache,2,11,4,LW,2007
33235,1,24,Simon Moser,1,6,2,LW,2013
33236,0,26,Simon Nolet,0,4,0,RW,1967
33237,10,27,Simon Nolet,4,35,14,RW,1968
33238,22,28,Simon Nolet,22,56,44,RW,1969
33239,19,29,Simon Nolet,9,74,28,RW,1970
33240,20,30,Simon Nolet,23,67,43,RW,1971
33241,20,31,Simon Nolet,16,70,36,RW,1972
33242,17,32,Simon Nolet,19,52,36,RW,1973
33243,32,33,Simon Nolet,26,72,58,RW,1974
33244,23,34,Simon Nolet,19,80,42,RW,1975
33245,19,35,Simon Nolet,12,52,31,RW,1976
33246,1,21,Simon Wheeldon,0,5,1,C,1987
33247,1,22,Simon Wheeldon,0,6,1,C,1988
33248,0,24,Simon Wheeldon,0,4,0,C,1990
33249,7,24,Skip Krake,5,68,12,C,1967
33250,9,25,Skip Krake,3,30,12,C,1968
33251,17,26,Skip Krake,5,58,22,RW,1969
33252,5,27,Skip Krake,4,74,9,C,1970
33253,10,29,Skip Krake,9,26,19,C,1972
33254,10,29,Skip Krake,9,26,19,C,1972
33255,36,30,Skip Krake,20,69,56,RW,1973
33256,36,30,Skip Krake,20,69,56,RW,1973
33257,23,31,Skip Krake,15,71,38,RW,1974
33258,23,31,Skip Krake,15,71,38,RW,1974
33259,8,32,Skip Krake,8,41,16,RW,1975
33260,8,32,Skip Krake,8,41,16,RW,1975
33261,0,20,Slater Koekkoek,0,3,0,D,2014
33262,1,21,Slater Koekkoek,0,9,1,D,2015
33263,4,22,Slater Koekkoek,0,29,4,D,2016
33264,4,23,Slater Koekkoek,4,35,8,D,2017
33265,12,22,Slava Voynov,8,54,20,D,2011
33266,19,23,Slava Voynov,6,48,25,D,2012
33267,30,24,Slava Voynov,4,82,34,D,2013
33268,2,25,Slava Voynov,0,6,2,D,2014
33269,1,19,Sonny Milano,0,3,1,LW,2015
33270,0,20,Sonny Milano,0,4,0,LW,2016
33271,8,21,Sonny Milano,14,55,22,LW,2017
33272,0,25,Spencer Abbott,0,1,0,RW,2013
33273,0,28,Spencer Abbott,0,1,0,LW,2016
33274,0,23,Spencer Foo,2,4,2,RW,2017
33275,0,20,Spencer Machacek,0,2,0,RW,2008
33276,0,22,Spencer Machacek,0,10,0,RW,2010
33277,7,23,Spencer Machacek,2,13,9,RW,2011
33278,8,24,Stacy Roest,4,59,12,C,1998
33279,9,25,Stacy Roest,7,49,16,C,1999
33280,20,26,Stacy Roest,7,76,27,C,2000
33281,11,27,Stacy Roest,10,58,21,RW,2001
33282,0,28,Stacy Roest,0,2,0,RW,2002
33283,1,23,Staffan Kronwall,0,34,1,D,2005
33284,0,25,Staffan Kronwall,0,18,0,D,2007
33285,0,26,Staffan Kronwall,0,3,0,D,2008
33286,2,27,Staffan Kronwall,1,11,3,D,2009
33287,1,25,Stan Drulia,2,24,3,RW,1992
33288,22,32,Stan Drulia,11,68,33,RW,1999
33289,4,33,Stan Drulia,2,34,6,RW,2000
33290,16,27,Stan Gilbertson,16,78,32,LW,1971
33291,15,28,Stan Gilbertson,6,66,21,LW,1972
33292,12,29,Stan Gilbertson,18,76,30,LW,1973
33293,15,30,Stan Gilbertson,13,62,28,LW,1974
33294,22,31,Stan Gilbertson,26,79,48,LW,1975
33295,9,32,Stan Gilbertson,6,67,15,LW,1976
33296,0,20,Stan Jonathan,0,1,0,LW,1975
33297,13,21,Stan Jonathan,17,69,30,LW,1976
33298,25,22,Stan Jonathan,27,68,52,LW,1977
33299,9,23,Stan Jonathan,6,33,15,LW,1978
33300,19,24,Stan Jonathan,21,79,40,LW,1979
33301,24,25,Stan Jonathan,14,74,38,LW,1980
33302,17,26,Stan Jonathan,6,67,23,LW,1981
33303,3,27,Stan Jonathan,0,20,3,LW,1982
33304,47,27,Stan Mikita,40,72,87,C,1967
33305,67,28,Stan Mikita,30,74,97,C,1968
33306,47,29,Stan Mikita,39,76,86,C,1969
33307,48,30,Stan Mikita,24,74,72,C,1970
33308,39,31,Stan Mikita,26,74,65,C,1971
33309,56,32,Stan Mikita,27,57,83,C,1972
33310,50,33,Stan Mikita,30,76,80,C,1973
33311,50,34,Stan Mikita,36,79,86,C,1974
33312,41,35,Stan Mikita,16,48,57,C,1975
33313,30,36,Stan Mikita,19,57,49,C,1976
33314,41,37,Stan Mikita,18,76,59,C,1977
33315,36,38,Stan Mikita,19,65,55,C,1978
33316,5,39,Stan Mikita,2,17,7,C,1979
33317,3,19,Stan Neckar,1,48,4,D,1994
33318,9,20,Stan Neckar,3,82,12,D,1995
33319,0,21,Stan Neckar,0,5,0,D,1996
33320,2,22,Stan Neckar,2,60,4,D,1997
33321,3,23,Stan Neckar,0,32,3,D,1998
33322,8,24,Stan Neckar,2,66,10,D,1999
33323,4,25,Stan Neckar,2,69,6,D,2000
33324,7,26,Stan Neckar,1,77,8,D,2001
33325,4,27,Stan Neckar,1,70,5,D,2002
33326,1,28,Stan Neckar,0,1,1,D,2003
33327,24,21,Stan Smyl,14,62,38,RW,1978
33328,47,22,Stan Smyl,31,77,78,RW,1979
33329,38,23,Stan Smyl,25,80,63,RW,1980
33330,44,24,Stan Smyl,34,80,78,RW,1981
33331,50,25,Stan Smyl,38,74,88,RW,1982
33332,43,26,Stan Smyl,24,80,67,RW,1983
33333,37,27,Stan Smyl,27,80,64,RW,1984
33334,35,28,Stan Smyl,27,73,62,RW,1985
33335,23,29,Stan Smyl,20,66,43,RW,1986
33336,25,30,Stan Smyl,12,57,37,RW,1987
33337,18,31,Stan Smyl,7,75,25,RW,1988
33338,15,32,Stan Smyl,1,47,16,RW,1989
33339,12,33,Stan Smyl,2,45,14,RW,1990
33340,24,20,Stan Weir,15,78,39,C,1972
33341,7,21,Stan Weir,9,58,16,C,1973
33342,27,22,Stan Weir,18,80,45,C,1974
33343,32,23,Stan Weir,19,64,51,C,1975
33344,19,24,Stan Weir,11,65,30,C,1976
33345,5,25,Stan Weir,12,30,17,C,1977
33346,30,26,Stan Weir,31,68,61,C,1978
33347,33,27,Stan Weir,33,79,66,C,1979
33348,20,28,Stan Weir,12,70,32,C,1980
33349,16,29,Stan Weir,5,61,21,C,1981
33350,24,30,Stan Weir,5,57,29,C,1982
33351,18,19,Stanislav Chistov,12,79,30,LW,2002
33352,16,20,Stanislav Chistov,2,56,18,RW,2003
33353,8,23,Stanislav Chistov,5,61,13,RW,2006
33354,0,23,Stanislav Galiev,1,2,1,RW,2014
33355,3,24,Stanislav Galiev,0,24,3,RW,2015
33356,0,22,Stanislav Gron,0,1,0,RW,2000
33357,0,28,Stanislav Hajdusek,0,4,0,RW,1978
33358,0,20,Stefan Bergkvist,0,2,0,D,1995
33359,0,21,Stefan Bergkvist,0,5,0,D,1996
33360,0,20,Stefan Della Rovere,0,7,0,LW,2010
33361,9,21,Stefan Elliott,4,39,13,D,2011
33362,3,22,Stefan Elliott,1,18,4,D,2012
33363,0,23,Stefan Elliott,1,1,1,D,2013
33364,0,24,Stefan Elliott,0,5,0,D,2014
33365,4,25,Stefan Elliott,2,21,6,D,2015
33366,2,18,Stefan Matteau,1,17,3,C,2012
33367,0,20,Stefan Matteau,1,7,1,LW,2014
33368,1,21,Stefan Matteau,1,32,2,LW,2015
33369,1,23,Stefan Matteau,0,8,1,C,2017
33370,0,22,Stefan Meyer,0,4,0,LW,2007
33371,2,25,Stefan Meyer,0,16,2,LW,2010
33372,0,21,Stefan Noesen,0,1,0,RW,2014
33373,0,22,Stefan Noesen,0,1,0,RW,2015
33374,0,23,Stefan Noesen,2,12,2,RW,2016
33375,14,24,Stefan Noesen,13,72,27,RW,2017
33376,50,23,Stefan Persson,6,66,56,D,1977
33377,56,24,Stefan Persson,10,78,66,D,1978
33378,35,25,Stefan Persson,4,73,39,D,1979
33379,52,26,Stefan Persson,9,80,61,D,1980
33380,37,27,Stefan Persson,6,70,43,D,1981
33381,25,28,Stefan Persson,4,70,29,D,1982
33382,24,29,Stefan Persson,9,75,33,D,1983
33383,19,30,Stefan Persson,3,54,22,D,1984
33384,19,31,Stefan Persson,1,56,20,D,1985
33385,0,20,Stefan Ruzicka,0,1,0,RW,2005
33386,10,21,Stefan Ruzicka,3,40,13,RW,2006
33387,3,22,Stefan Ruzicka,1,14,4,RW,2007
33388,10,22,Stefan Ustorf,7,48,17,RW,1995
33389,0,23,Stefan Ustorf,0,6,0,LW,1996
33390,1,20,Stephan Lebeau,0,1,1,C,1988
33391,20,21,Stephan Lebeau,15,57,35,RW,1989
33392,31,22,Stephan Lebeau,22,73,53,C,1990
33393,31,23,Stephan Lebeau,27,77,58,RW,1991
33394,49,24,Stephan Lebeau,31,71,80,C,1992
33395,11,25,Stephan Lebeau,15,56,26,C,1993
33396,16,26,Stephan Lebeau,8,38,24,C,1994
33397,0,21,Stephane Brochu,0,1,0,D,1988
33398,0,21,Stephane Charbonneau,0,2,0,RW,1991
33399,0,21,Stephane Da Costa,0,4,0,RW,2010
33400,2,22,Stephane Da Costa,3,22,5,RW,2011
33401,1,23,Stephane Da Costa,1,9,2,RW,2012
33402,1,24,Stephane Da Costa,3,12,4,C,2013
33403,0,19,Stephane Guerard,0,30,0,D,1987
33404,0,21,Stephane Guerard,0,4,0,D,1989
33405,19,21,Stephane Matteau,15,78,34,RW,1990
33406,8,22,Stephane Matteau,6,24,14,LW,1991
33407,18,23,Stephane Matteau,15,79,33,LW,1992
33408,19,24,Stephane Matteau,19,77,38,LW,1993
33409,5,25,Stephane Matteau,3,41,8,LW,1994
33410,15,26,Stephane Matteau,11,78,26,LW,1995
33411,20,27,Stephane Matteau,16,74,36,LW,1996
33412,14,28,Stephane Matteau,15,73,29,LW,1997
33413,15,29,Stephane Matteau,8,68,23,LW,1998
33414,12,30,Stephane Matteau,12,69,24,RW,1999
33415,19,31,Stephane Matteau,13,80,32,LW,2000
33416,4,32,Stephane Matteau,7,55,11,LW,2001
33417,4,33,Stephane Matteau,4,52,8,LW,2002
33418,2,20,Stephane Morin,0,6,2,C,1989
33419,27,21,Stephane Morin,13,48,40,C,1990
33420,8,22,Stephane Morin,2,30,10,C,1991
33421,1,23,Stephane Morin,0,1,1,C,1992
33422,1,24,Stephane Morin,1,5,2,LW,1993
33423,1,20,Stephane Quintal,0,26,1,D,1988
33424,2,21,Stephane Quintal,2,38,4,D,1989
33425,6,22,Stephane Quintal,2,45,8,D,1990
33426,16,23,Stephane Quintal,4,75,20,D,1991
33427,10,24,Stephane Quintal,1,75,11,D,1992
33428,18,25,Stephane Quintal,8,81,26,D,1993
33429,17,26,Stephane Quintal,6,43,23,D,1994
33430,14,27,Stephane Quintal,2,68,16,D,1995
33431,15,28,Stephane Quintal,7,71,22,D,1996
33432,10,29,Stephane Quintal,6,71,16,D,1997
33433,19,30,Stephane Quintal,8,82,27,D,1998
33434,14,31,Stephane Quintal,2,75,16,D,1999
33435,18,32,Stephane Quintal,1,72,19,D,2000
33436,10,33,Stephane Quintal,6,75,16,D,2001
33437,5,34,Stephane Quintal,5,67,10,D,2002
33438,5,35,Stephane Quintal,3,73,8,D,2003
33439,0,18,Stephane Richer,0,1,0,RW,1984
33440,16,19,Stephane Richer,21,65,37,C,1985
33441,19,20,Stephane Richer,20,57,39,RW,1986
33442,28,21,Stephane Richer,50,72,78,RW,1987
33443,35,22,Stephane Richer,25,68,60,RW,1988
33444,40,23,Stephane Richer,51,75,91,RW,1989
33445,30,24,Stephane Richer,31,75,61,RW,1990
33446,35,25,Stephane Richer,29,74,64,RW,1991
33447,35,26,Stephane Richer,38,78,73,LW,1992
33448,4,26,Stephane Richer,1,24,5,D,1992
33449,36,27,Stephane Richer,36,80,72,RW,1993
33450,1,27,Stephane Richer,0,2,1,D,1993
33451,16,28,Stephane Richer,23,45,39,RW,1994
33452,0,28,Stephane Richer,0,1,0,D,1994
33453,12,29,Stephane Richer,20,73,32,RW,1995
33454,24,30,Stephane Richer,22,63,46,RW,1996
33455,15,31,Stephane Richer,14,40,29,LW,1997
33456,21,32,Stephane Richer,12,64,33,RW,1998
33457,22,33,Stephane Richer,15,56,37,RW,1999
33458,14,35,Stephane Richer,14,68,28,RW,2001
33459,0,22,Stephane Robidas,0,1,0,D,1999
33460,6,23,Stephane Robidas,6,65,12,D,2000
33461,10,24,Stephane Robidas,1,56,11,D,2001
33462,7,25,Stephane Robidas,3,76,10,D,2002
33463,10,26,Stephane Robidas,3,59,13,D,2003
33464,15,28,Stephane Robidas,5,75,20,D,2005
33465,17,29,Stephane Robidas,0,75,17,D,2006
33466,17,30,Stephane Robidas,9,82,26,D,2007
33467,23,31,Stephane Robidas,3,72,26,D,2008
33468,31,32,Stephane Robidas,10,82,41,D,2009
33469,25,33,Stephane Robidas,5,81,30,D,2010
33470,17,34,Stephane Robidas,5,75,22,D,2011
33471,12,35,Stephane Robidas,1,48,13,D,2012
33472,5,36,Stephane Robidas,5,38,10,D,2013
33473,6,37,Stephane Robidas,1,52,7,D,2014
33474,0,20,Stephane Roy,1,12,1,C,1987
33475,2,21,Stephane Veilleux,3,38,5,RW,2002
33476,8,22,Stephane Veilleux,2,19,10,LW,2003
33477,9,24,Stephane Veilleux,7,71,16,C,2005
33478,11,25,Stephane Veilleux,7,75,18,LW,2006
33479,7,26,Stephane Veilleux,11,77,18,LW,2007
33480,10,27,Stephane Veilleux,13,81,23,LW,2008
33481,6,28,Stephane Veilleux,3,77,9,LW,2009
33482,2,30,Stephane Veilleux,0,22,2,LW,2011
33483,0,32,Stephane Veilleux,3,34,3,LW,2013
33484,1,33,Stephane Veilleux,1,12,2,LW,2014
33485,14,21,Stephane Yelle,13,71,27,LW,1995
33486,17,22,Stephane Yelle,9,79,26,C,1996
33487,15,23,Stephane Yelle,7,81,22,C,1997
33488,7,24,Stephane Yelle,8,72,15,C,1998
33489,14,25,Stephane Yelle,8,79,22,C,1999
33490,10,26,Stephane Yelle,4,50,14,C,2000
33491,12,27,Stephane Yelle,5,73,17,C,2001
33492,15,28,Stephane Yelle,10,82,25,C,2002
33493,13,29,Stephane Yelle,4,53,17,C,2003
33494,14,31,Stephane Yelle,4,74,18,C,2005
33495,14,32,Stephane Yelle,10,56,24,C,2006
33496,9,33,Stephane Yelle,3,74,12,C,2007
33497,11,34,Stephane Yelle,7,77,18,C,2008
33498,4,35,Stephane Yelle,4,70,8,C,2009
33499,0,27,Stephen Gionta,0,12,0,RW,2010
33500,0,28,Stephen Gionta,1,1,1,RW,2011
33501,10,29,Stephen Gionta,4,48,14,RW,2012
33502,7,30,Stephen Gionta,4,66,11,RW,2013
33503,8,31,Stephen Gionta,5,61,13,C,2014
33504,10,32,Stephen Gionta,1,82,11,C,2015
33505,5,33,Stephen Gionta,1,26,6,RW,2016
33506,2,23,Stephen Johns,1,14,3,D,2015
33507,6,24,Stephen Johns,4,61,10,D,2016
33508,7,25,Stephen Johns,8,75,15,D,2017
33509,1,20,Stephen Leach,1,11,2,RW,1985
33510,0,21,Stephen Leach,1,15,1,RW,1986
33511,1,22,Stephen Leach,1,8,2,RW,1987
33512,19,23,Stephen Leach,11,74,30,RW,1988
33513,14,24,Stephen Leach,18,70,32,RW,1989
33514,19,25,Stephen Leach,11,68,30,RW,1990
33515,29,26,Stephen Leach,31,78,60,RW,1991
33516,25,27,Stephen Leach,26,79,51,RW,1992
33517,10,28,Stephen Leach,5,42,15,RW,1993
33518,6,29,Stephen Leach,5,35,11,RW,1994
33519,17,30,Stephen Leach,11,73,28,RW,1995
33520,1,31,Stephen Leach,2,17,3,RW,1996
33521,5,32,Stephen Leach,4,45,9,RW,1997
33522,3,33,Stephen Leach,1,31,4,RW,1998
33523,3,34,Stephen Leach,2,56,5,RW,1999
33524,2,21,Stephen Peat,2,38,4,RW,2001
33525,0,22,Stephen Peat,1,27,1,RW,2002
33526,0,23,Stephen Peat,5,64,5,RW,2003
33527,0,25,Stephen Peat,0,1,0,RW,2005
33528,0,23,Stephen Tepper,0,1,0,RW,1992
33529,1,18,Stephen Weiss,1,7,2,C,2001
33530,15,19,Stephen Weiss,6,77,21,C,2002
33531,17,20,Stephen Weiss,12,50,29,C,2003
33532,12,22,Stephen Weiss,9,41,21,C,2005
33533,28,23,Stephen Weiss,20,74,48,C,2006
33534,29,24,Stephen Weiss,13,74,42,C,2007
33535,47,25,Stephen Weiss,14,78,61,C,2008
33536,32,26,Stephen Weiss,28,80,60,C,2009
33537,28,27,Stephen Weiss,21,76,49,C,2010
33538,37,28,Stephen Weiss,20,80,57,C,2011
33539,3,29,Stephen Weiss,1,17,4,C,2012
33540,2,30,Stephen Weiss,2,26,4,C,2013
33541,16,31,Stephen Weiss,9,52,25,C,2014
33542,12,24,Steve Alley,8,27,20,LW,1977
33543,12,24,Steve Alley,8,27,20,LW,1977
33544,24,25,Steve Alley,17,78,41,LW,1978
33545,24,25,Steve Alley,17,78,41,LW,1978
33546,1,26,Steve Alley,1,7,2,LW,1979
33547,2,27,Steve Alley,2,8,4,LW,1980
33548,11,26,Steve Andrascik,6,77,17,RW,1974
33549,7,26,Steve Andrascik,4,57,11,RW,1974
33550,4,26,Steve Andrascik,2,20,6,RW,1974
33551,7,26,Steve Andrascik,4,57,11,RW,1974
33552,4,26,Steve Andrascik,2,20,6,RW,1974
33553,2,27,Steve Andrascik,3,20,5,RW,1975
33554,0,20,Steve Atkinson,0,1,0,RW,1968
33555,18,22,Steve Atkinson,20,57,38,RW,1970
33556,10,23,Steve Atkinson,14,67,24,RW,1971
33557,9,24,Steve Atkinson,9,61,18,RW,1972
33558,10,25,Steve Atkinson,6,70,16,RW,1973
33559,4,26,Steve Atkinson,11,46,15,RW,1974
33560,6,27,Steve Atkinson,2,52,8,RW,1975
33561,6,27,Steve Atkinson,2,52,8,RW,1975
33562,0,22,Steve Bancroft,0,1,0,D,1992
33563,1,31,Steve Bancroft,0,5,1,D,2001
33564,0,19,Steve Begin,0,5,0,C,1997
33565,1,21,Steve Begin,1,13,2,C,1999
33566,0,22,Steve Begin,0,4,0,C,2000
33567,5,23,Steve Begin,7,51,12,C,2001
33568,1,24,Steve Begin,3,50,4,C,2002
33569,5,25,Steve Begin,10,52,15,C,2003
33570,12,27,Steve Begin,11,76,23,C,2005
33571,5,28,Steve Begin,5,52,10,LW,2006
33572,5,29,Steve Begin,3,44,8,LW,2007
33573,5,30,Steve Begin,7,62,12,LW,2008
33574,9,31,Steve Begin,5,77,14,C,2009
33575,0,32,Steve Begin,0,2,0,C,2010
33576,4,34,Steve Begin,4,36,8,C,2012
33577,13,20,Steve Bernier,14,39,27,RW,2005
33578,16,21,Steve Bernier,15,62,31,RW,2006
33579,16,22,Steve Bernier,16,76,32,RW,2007
33580,17,23,Steve Bernier,15,81,32,RW,2008
33581,11,24,Steve Bernier,11,59,22,RW,2009
33582,10,25,Steve Bernier,5,68,15,RW,2010
33583,5,26,Steve Bernier,1,32,6,RW,2011
33584,7,27,Steve Bernier,8,47,15,RW,2012
33585,9,28,Steve Bernier,3,78,12,RW,2013
33586,16,29,Steve Bernier,16,67,32,RW,2014
33587,5,30,Steve Bernier,1,24,6,RW,2015
33588,0,32,Steve Bernier,0,4,0,RW,2017
33589,23,21,Steve Bozek,33,71,56,C,1981
33590,13,22,Steve Bozek,13,53,26,LW,1982
33591,10,23,Steve Bozek,10,46,20,LW,1983
33592,22,24,Steve Bozek,13,54,35,LW,1984
33593,22,25,Steve Bozek,21,64,43,LW,1985
33594,18,26,Steve Bozek,17,71,35,LW,1986
33595,7,27,Steve Bozek,3,33,10,LW,1987
33596,18,28,Steve Bozek,17,71,35,C,1988
33597,9,29,Steve Bozek,14,58,23,LW,1989
33598,17,30,Steve Bozek,15,62,32,LW,1990
33599,8,31,Steve Bozek,8,58,16,LW,1991
33600,0,28,Steve Brule,0,2,0,C,2002
33601,1,20,Steve Cardwell,0,5,1,LW,1970
33602,8,21,Steve Cardwell,7,28,15,LW,1971
33603,2,22,Steve Cardwell,2,20,4,LW,1972
33604,23,23,Steve Cardwell,23,77,46,LW,1973
33605,23,23,Steve Cardwell,23,77,46,LW,1973
33606,13,24,Steve Cardwell,9,75,22,LW,1974
33607,13,24,Steve Cardwell,9,75,22,LW,1974
33608,1,20,Steve Carlson,0,10,1,C,1975
33609,1,20,Steve Carlson,0,10,1,C,1975
33610,17,21,Steve Carlson,9,52,26,C,1976
33611,9,21,Steve Carlson,4,31,13,C,1976
33612,8,21,Steve Carlson,5,21,13,C,1976
33613,17,21,Steve Carlson,9,52,26,C,1976
33614,9,21,Steve Carlson,4,31,13,C,1976
33615,8,21,Steve Carlson,5,21,13,C,1976
33616,7,22,Steve Carlson,6,38,13,C,1977
33617,7,22,Steve Carlson,6,38,13,C,1977
33618,22,23,Steve Carlson,18,73,40,C,1978
33619,22,23,Steve Carlson,18,73,40,C,1978
33620,12,24,Steve Carlson,9,52,21,C,1979
33621,10,22,Steve Carlyle,7,67,17,D,1972
33622,10,22,Steve Carlyle,7,67,17,D,1972
33623,13,23,Steve Carlyle,2,50,15,D,1973
33624,13,23,Steve Carlyle,2,50,15,D,1973
33625,25,24,Steve Carlyle,2,73,27,D,1974
33626,11,25,Steve Carlyle,0,28,11,D,1975
33627,4,19,Steve Chiasson,1,45,5,D,1986
33628,9,20,Steve Chiasson,2,29,11,D,1987
33629,35,21,Steve Chiasson,12,65,47,D,1988
33630,28,22,Steve Chiasson,14,67,42,D,1989
33631,17,23,Steve Chiasson,3,42,20,D,1990
33632,24,24,Steve Chiasson,10,62,34,D,1991
33633,50,25,Steve Chiasson,12,79,62,D,1992
33634,33,26,Steve Chiasson,13,82,46,D,1993
33635,23,27,Steve Chiasson,2,45,25,D,1994
33636,25,28,Steve Chiasson,8,76,33,D,1995
33637,22,29,Steve Chiasson,8,65,30,D,1996
33638,27,30,Steve Chiasson,7,66,34,D,1997
33639,8,31,Steve Chiasson,1,28,9,D,1998
33640,7,22,Steve Christoff,8,20,15,C,1979
33641,13,23,Steve Christoff,26,56,39,C,1980
33642,29,24,Steve Christoff,26,69,55,C,1981
33643,8,25,Steve Christoff,9,45,17,C,1982
33644,7,26,Steve Christoff,8,58,15,RW,1983
33645,2,20,Steve Clippingdale,1,16,3,LW,1976
33646,0,23,Steve Clippingdale,0,3,0,LW,1979
33647,0,26,Steve Coates,1,5,1,RW,1976
33648,13,22,Steve Cuddie,7,77,20,D,1972
33649,13,22,Steve Cuddie,7,77,20,D,1972
33650,18,23,Steve Cuddie,5,74,23,D,1973
33651,18,23,Steve Cuddie,5,74,23,D,1973
33652,16,24,Steve Cuddie,5,70,21,D,1974
33653,16,24,Steve Cuddie,5,70,21,D,1974
33654,6,20,Steve Downie,6,32,12,RW,2007
33655,3,21,Steve Downie,3,29,6,RW,2008
33656,24,22,Steve Downie,22,79,46,RW,2009
33657,22,23,Steve Downie,10,57,32,RW,2010
33658,27,24,Steve Downie,14,75,41,RW,2011
33659,1,25,Steve Downie,0,2,1,RW,2012
33660,20,26,Steve Downie,4,62,24,RW,2013
33661,14,27,Steve Downie,14,72,28,RW,2014
33662,3,28,Steve Downie,3,26,6,RW,2015
33663,6,23,Steve Dubinsky,2,27,8,LW,1993
33664,0,24,Steve Dubinsky,0,16,0,C,1994
33665,3,25,Steve Dubinsky,2,43,5,C,1995
33666,0,26,Steve Dubinsky,0,5,0,C,1996
33667,13,27,Steve Dubinsky,5,82,18,C,1997
33668,10,28,Steve Dubinsky,4,62,14,C,1998
33669,1,29,Steve Dubinsky,0,23,1,C,1999
33670,4,30,Steve Dubinsky,6,60,10,C,2000
33671,2,31,Steve Dubinsky,6,29,8,LW,2001
33672,6,32,Steve Dubinsky,0,28,6,C,2002
33673,25,21,Steve Duchesne,13,75,38,D,1986
33674,39,22,Steve Duchesne,16,71,55,D,1987
33675,50,23,Steve Duchesne,25,79,75,D,1988
33676,42,24,Steve Duchesne,20,79,62,D,1989
33677,41,25,Steve Duchesne,21,78,62,D,1990
33678,38,26,Steve Duchesne,18,78,56,D,1991
33679,62,27,Steve Duchesne,20,82,82,D,1992
33680,19,28,Steve Duchesne,12,36,31,D,1993
33681,26,29,Steve Duchesne,12,47,38,D,1994
33682,24,30,Steve Duchesne,12,62,36,D,1995
33683,28,31,Steve Duchesne,19,78,47,D,1996
33684,42,32,Steve Duchesne,14,80,56,D,1997
33685,24,33,Steve Duchesne,6,71,30,D,1998
33686,31,34,Steve Duchesne,10,79,41,D,1999
33687,19,35,Steve Duchesne,6,54,25,D,2000
33688,15,36,Steve Duchesne,3,64,18,D,2001
33689,18,21,Steve Durbano,3,49,21,D,1972
33690,19,22,Steve Durbano,8,69,27,D,1973
33691,1,23,Steve Durbano,0,1,1,D,1974
33692,19,24,Steve Durbano,1,69,20,D,1975
33693,2,25,Steve Durbano,0,19,2,D,1976
33694,4,26,Steve Durbano,6,45,10,D,1977
33695,1,27,Steve Durbano,1,13,2,D,1978
33696,21,23,Steve Dykstra,4,64,25,D,1985
33697,1,24,Steve Dykstra,0,37,1,D,1986
33698,4,25,Steve Dykstra,3,42,7,D,1987
33699,6,26,Steve Dykstra,1,65,7,D,1988
33700,0,27,Steve Dykstra,0,9,0,D,1989
33701,2,19,Steve Eminger,0,17,2,D,2002
33702,4,20,Steve Eminger,0,41,4,D,2003
33703,13,22,Steve Eminger,5,66,18,D,2005
33704,16,23,Steve Eminger,1,68,17,D,2006
33705,2,24,Steve Eminger,0,20,2,D,2007
33706,21,25,Steve Eminger,5,71,26,D,2008
33707,12,26,Steve Eminger,4,63,16,D,2009
33708,4,27,Steve Eminger,2,65,6,D,2010
33709,3,28,Steve Eminger,2,42,5,D,2011
33710,3,29,Steve Eminger,0,35,3,D,2012
33711,0,22,Steve Gainey,0,1,0,LW,2000
33712,1,23,Steve Gainey,0,5,1,LW,2001
33713,0,25,Steve Gainey,0,7,0,LW,2003
33714,1,27,Steve Gainey,0,20,1,LW,2005
33715,8,20,Steve Gatzos,6,16,14,RW,1981
33716,7,21,Steve Gatzos,6,44,13,RW,1982
33717,3,22,Steve Gatzos,3,23,6,RW,1983
33718,2,23,Steve Gatzos,0,6,2,RW,1984
33719,6,20,Steve Gotaas,5,36,11,C,1987
33720,3,21,Steve Gotaas,1,12,4,C,1988
33721,0,23,Steve Gotaas,0,1,0,C,1990
33722,0,19,Steve Graves,0,2,0,C,1983
33723,0,22,Steve Graves,2,12,2,C,1986
33724,4,23,Steve Graves,3,21,7,LW,1987
33725,8,23,Steve Guolla,13,43,21,LW,1996
33726,1,24,Steve Guolla,1,7,2,LW,1997
33727,2,25,Steve Guolla,2,14,4,C,1998
33728,19,26,Steve Guolla,10,66,29,C,1999
33729,16,27,Steve Guolla,12,63,28,LW,2000
33730,0,29,Steve Guolla,2,12,2,LW,2002
33731,0,22,Steve Hazlett,0,1,0,LW,1979
33732,4,22,Steve Heinze,3,14,7,RW,1991
33733,13,23,Steve Heinze,18,73,31,RW,1992
33734,11,24,Steve Heinze,10,77,21,RW,1993
33735,9,25,Steve Heinze,7,36,16,RW,1994
33736,12,26,Steve Heinze,16,76,28,RW,1995
33737,8,27,Steve Heinze,17,30,25,RW,1996
33738,20,28,Steve Heinze,26,61,46,RW,1997
33739,18,29,Steve Heinze,22,73,40,RW,1998
33740,13,30,Steve Heinze,12,75,25,RW,1999
33741,27,31,Steve Heinze,27,79,54,RW,2000
33742,16,32,Steve Heinze,15,73,31,LW,2001
33743,7,33,Steve Heinze,5,27,12,RW,2002
33744,15,23,Steve Hull,11,58,26,RW,1975
33745,15,23,Steve Hull,11,58,26,RW,1975
33746,2,24,Steve Hull,0,2,2,RW,1976
33747,6,20,Steve Jensen,7,19,13,LW,1975
33748,23,21,Steve Jensen,22,78,45,LW,1976
33749,17,22,Steve Jensen,13,74,30,LW,1977
33750,8,23,Steve Jensen,23,72,31,LW,1978
33751,15,24,Steve Jensen,21,76,36,LW,1979
33752,19,25,Steve Jensen,19,74,38,LW,1980
33753,19,26,Steve Jensen,8,45,27,LW,1981
33754,0,21,Steve Junker,0,5,0,RW,1993
33755,11,22,Steve Kariya,8,45,19,LW,1999
33756,6,23,Steve Kariya,1,17,7,LW,2000
33757,1,24,Steve Kariya,0,3,1,LW,2001
33758,35,19,Steve Kasper,21,76,56,C,1980
33759,31,20,Steve Kasper,20,73,51,C,1981
33760,6,21,Steve Kasper,2,24,8,C,1982
33761,11,22,Steve Kasper,3,27,14,C,1983
33762,24,23,Steve Kasper,16,77,40,C,1984
33763,23,24,Steve Kasper,17,80,40,C,1985
33764,30,25,Steve Kasper,20,79,50,C,1986
33765,44,26,Steve Kasper,26,79,70,C,1987
33766,31,27,Steve Kasper,19,78,50,C,1988
33767,28,28,Steve Kasper,17,77,45,C,1989
33768,19,29,Steve Kasper,9,67,28,C,1990
33769,2,30,Steve Kasper,3,16,5,C,1991
33770,7,31,Steve Kasper,4,68,11,C,1992
33771,0,20,Steve Kelly,1,8,1,C,1996
33772,3,21,Steve Kelly,2,43,5,C,1997
33773,3,22,Steve Kelly,1,34,4,C,1998
33774,0,23,Steve Kelly,0,1,0,C,1999
33775,2,24,Steve Kelly,3,35,5,C,2000
33776,1,25,Steve Kelly,0,8,1,C,2001
33777,3,26,Steve Kelly,2,15,5,C,2002
33778,0,27,Steve Kelly,0,3,0,C,2003
33779,0,31,Steve Kelly,0,2,0,C,2007
33780,34,24,Steve King,18,69,52,C,1972
33781,34,24,Steve King,18,69,52,C,1972
33782,22,25,Steve King,14,67,36,RW,1973
33783,22,25,Steve King,14,67,36,RW,1973
33784,0,19,Steve Konowalchuk,0,1,0,C,1991
33785,7,20,Steve Konowalchuk,4,36,11,C,1992
33786,14,21,Steve Konowalchuk,12,62,26,C,1993
33787,14,22,Steve Konowalchuk,11,46,25,LW,1994
33788,22,23,Steve Konowalchuk,23,70,45,LW,1995
33789,25,24,Steve Konowalchuk,17,78,42,LW,1996
33790,24,25,Steve Konowalchuk,10,80,34,LW,1997
33791,12,26,Steve Konowalchuk,12,45,24,C,1998
33792,27,27,Steve Konowalchuk,16,82,43,LW,1999
33793,23,28,Steve Konowalchuk,24,82,47,LW,2000
33794,12,29,Steve Konowalchuk,2,28,14,LW,2001
33795,15,30,Steve Konowalchuk,15,77,30,LW,2002
33796,21,31,Steve Konowalchuk,19,82,40,LW,2003
33797,9,33,Steve Konowalchuk,6,21,15,LW,2005
33798,0,19,Steve Konroyd,0,4,0,D,1980
33799,14,20,Steve Konroyd,3,63,17,D,1981
33800,13,21,Steve Konroyd,4,79,17,D,1982
33801,13,22,Steve Konroyd,1,80,14,D,1983
33802,23,23,Steve Konroyd,3,64,26,D,1984
33803,25,24,Steve Konroyd,7,73,32,D,1985
33804,16,25,Steve Konroyd,5,72,21,D,1986
33805,15,26,Steve Konroyd,2,62,17,D,1987
33806,12,27,Steve Konroyd,6,78,18,D,1988
33807,14,28,Steve Konroyd,3,75,17,D,1989
33808,12,29,Steve Konroyd,0,70,12,D,1990
33809,24,30,Steve Konroyd,4,82,28,D,1991
33810,12,31,Steve Konroyd,3,65,15,D,1992
33811,2,32,Steve Konroyd,0,27,2,D,1993
33812,0,33,Steve Konroyd,0,1,0,D,1994
33813,1,21,Steve Langdon,0,1,1,LW,1974
33814,0,22,Steve Langdon,0,4,0,LW,1975
33815,0,24,Steve Langdon,0,2,0,LW,1977
33816,1,19,Steve Larmer,0,4,1,RW,1980
33817,0,20,Steve Larmer,0,3,0,RW,1981
33818,47,21,Steve Larmer,43,80,90,RW,1982
33819,40,22,Steve Larmer,35,80,75,RW,1983
33820,40,23,Steve Larmer,46,80,86,RW,1984
33821,45,24,Steve Larmer,31,80,76,RW,1985
33822,56,25,Steve Larmer,28,80,84,RW,1986
33823,48,26,Steve Larmer,41,80,89,LW,1987
33824,44,27,Steve Larmer,43,80,87,RW,1988
33825,59,28,Steve Larmer,31,80,90,RW,1989
33826,57,29,Steve Larmer,44,80,101,RW,1990
33827,45,30,Steve Larmer,29,80,74,RW,1991
33828,35,31,Steve Larmer,35,84,70,RW,1992
33829,39,32,Steve Larmer,21,68,60,RW,1993
33830,15,33,Steve Larmer,14,47,29,RW,1994
33831,7,23,Steve Larouche,8,18,15,RW,1994
33832,2,24,Steve Larouche,1,8,3,C,1995
33833,1,20,Steve Ludzik,2,8,3,C,1981
33834,19,21,Steve Ludzik,6,66,25,C,1982
33835,20,22,Steve Ludzik,9,80,29,LW,1983
33836,20,23,Steve Ludzik,11,79,31,LW,1984
33837,5,24,Steve Ludzik,6,49,11,LW,1985
33838,12,25,Steve Ludzik,5,52,17,LW,1986
33839,15,26,Steve Ludzik,6,73,21,C,1987
33840,0,27,Steve Ludzik,1,6,1,C,1988
33841,1,28,Steve Ludzik,0,11,1,C,1989
33842,0,24,Steve Lyon,0,3,0,D,1976
33843,0,28,Steve MacIntyre,2,22,2,LW,2008
33844,1,29,Steve MacIntyre,0,22,1,LW,2009
33845,1,30,Steve MacIntyre,0,34,1,LW,2010
33846,0,31,Steve MacIntyre,0,12,0,LW,2011
33847,0,32,Steve MacIntyre,0,1,0,LW,2012
33848,0,21,Steve Maltais,0,8,0,LW,1989
33849,0,22,Steve Maltais,0,7,0,LW,1990
33850,1,23,Steve Maltais,2,12,3,LW,1991
33851,13,24,Steve Maltais,7,63,20,LW,1992
33852,1,25,Steve Maltais,0,4,1,LW,1993
33853,3,32,Steve Maltais,0,26,3,RW,2000
33854,3,23,Steve Martins,1,23,4,C,1995
33855,1,24,Steve Martins,0,2,1,C,1996
33856,0,25,Steve Martins,0,3,0,C,1997
33857,3,26,Steve Martins,4,36,7,C,1998
33858,7,27,Steve Martins,6,59,13,C,1999
33859,4,28,Steve Martins,2,59,6,C,2000
33860,0,29,Steve Martins,1,14,1,C,2001
33861,6,30,Steve Martins,5,42,11,C,2002
33862,0,31,Steve Martins,1,25,1,C,2003
33863,1,33,Steve Martins,1,4,2,C,2005
33864,1,28,Steve Martinson,1,10,2,LW,1987
33865,0,29,Steve Martinson,1,25,1,LW,1988
33866,0,30,Steve Martinson,0,13,0,LW,1989
33867,0,32,Steve Martinson,0,1,0,LW,1991
33868,1,18,Steve McCarthy,1,5,2,D,1999
33869,5,19,Steve McCarthy,0,44,5,D,2000
33870,0,20,Steve McCarthy,0,3,0,D,2001
33871,4,21,Steve McCarthy,1,57,5,D,2002
33872,3,22,Steve McCarthy,1,25,4,D,2003
33873,7,24,Steve McCarthy,9,67,16,D,2005
33874,12,25,Steve McCarthy,4,46,16,D,2006
33875,6,26,Steve McCarthy,1,55,7,D,2007
33876,0,23,Steve McKenna,0,9,0,LW,1996
33877,4,24,Steve McKenna,4,62,8,LW,1997
33878,0,25,Steve McKenna,1,20,1,LW,1998
33879,5,26,Steve McKenna,0,46,5,LW,1999
33880,1,27,Steve McKenna,1,54,2,LW,2000
33881,1,28,Steve McKenna,2,54,3,LW,2001
33882,1,29,Steve McKenna,9,79,10,LW,2002
33883,2,30,Steve McKenna,1,49,3,LW,2003
33884,0,28,Steve McLaren,0,6,0,LW,2003
33885,2,22,Steve Montador,1,11,3,D,2001
33886,1,23,Steve Montador,1,50,2,D,2002
33887,2,24,Steve Montador,1,26,3,D,2003
33888,5,26,Steve Montador,2,58,7,D,2005
33889,8,27,Steve Montador,1,72,9,D,2006
33890,15,28,Steve Montador,8,73,23,D,2007
33891,17,29,Steve Montador,4,78,21,D,2008
33892,18,30,Steve Montador,5,78,23,D,2009
33893,21,31,Steve Montador,5,73,26,D,2010
33894,9,32,Steve Montador,5,52,14,D,2011
33895,0,23,Steve Moore,0,8,0,C,2001
33896,0,24,Steve Moore,0,4,0,C,2002
33897,7,25,Steve Moore,5,57,12,C,2003
33898,0,20,Steve Nemeth,2,12,2,C,1987
33899,0,28,Steve Oleksy,0,1,0,D,2014
33900,4,20,Steve Ott,3,26,7,C,2002
33901,10,21,Steve Ott,2,73,12,LW,2003
33902,17,23,Steve Ott,5,82,22,LW,2005
33903,4,24,Steve Ott,0,19,4,C,2006
33904,11,25,Steve Ott,11,73,22,C,2007
33905,27,26,Steve Ott,19,64,46,C,2008
33906,14,27,Steve Ott,22,73,36,C,2009
33907,20,28,Steve Ott,12,82,32,C,2010
33908,28,29,Steve Ott,11,74,39,C,2011
33909,15,30,Steve Ott,9,48,24,C,2012
33910,14,31,Steve Ott,9,82,23,C,2013
33911,9,32,Steve Ott,3,78,12,C,2014
33912,2,33,Steve Ott,0,21,2,C,2015
33913,1,34,Steve Ott,0,11,1,C,2016
33914,7,19,Steve Patrick,1,30,8,RW,1980
33915,8,20,Steve Patrick,8,41,16,RW,1981
33916,13,21,Steve Patrick,9,56,22,RW,1982
33917,4,22,Steve Patrick,1,11,5,RW,1983
33918,20,23,Steve Patrick,13,57,33,RW,1984
33919,16,24,Steve Patrick,8,55,24,RW,1985
33920,17,20,Steve Payne,23,70,40,LW,1978
33921,43,21,Steve Payne,42,80,85,LW,1979
33922,28,22,Steve Payne,30,76,58,LW,1980
33923,45,23,Steve Payne,33,74,78,LW,1981
33924,39,24,Steve Payne,30,80,69,LW,1982
33925,31,25,Steve Payne,28,78,59,LW,1983
33926,22,26,Steve Payne,29,76,51,LW,1984
33927,4,27,Steve Payne,8,22,12,LW,1985
33928,6,28,Steve Payne,4,48,10,LW,1986
33929,3,29,Steve Payne,1,9,4,LW,1987
33930,1,20,Steve Peters,0,2,1,C,1979
33931,0,28,Steve Pinizzotto,0,12,0,C,2012
33932,2,29,Steve Pinizzotto,0,6,2,RW,2013
33933,0,27,Steve Poapst,1,3,1,D,1995
33934,0,30,Steve Poapst,0,22,0,D,1998
33935,3,32,Steve Poapst,2,36,5,D,2000
33936,7,33,Steve Poapst,1,56,8,D,2001
33937,11,34,Steve Poapst,2,75,13,D,2002
33938,2,35,Steve Poapst,2,53,4,D,2003
33939,5,37,Steve Poapst,0,62,5,D,2005
33940,0,21,Steve Regier,0,9,0,LW,2005
33941,0,22,Steve Regier,0,1,0,LW,2006
33942,0,23,Steve Regier,0,8,0,LW,2007
33943,1,24,Steve Regier,3,8,4,LW,2008
33944,0,23,Steve Reinprecht,0,1,0,C,1999
33945,21,24,Steve Reinprecht,15,80,36,C,2000
33946,27,25,Steve Reinprecht,19,67,46,C,2001
33947,33,26,Steve Reinprecht,18,77,51,C,2002
33948,22,27,Steve Reinprecht,7,44,29,C,2003
33949,30,29,Steve Reinprecht,22,80,52,C,2005
33950,24,30,Steve Reinprecht,9,49,33,C,2006
33951,30,31,Steve Reinprecht,16,81,46,C,2007
33952,27,32,Steve Reinprecht,14,73,41,C,2008
33953,22,33,Steve Reinprecht,16,82,38,C,2009
33954,6,34,Steve Reinprecht,4,29,10,C,2010
33955,22,25,Steve Richardson,9,66,31,LW,1974
33956,18,25,Steve Richardson,8,47,26,LW,1974
33957,4,25,Steve Richardson,1,19,5,LW,1974
33958,22,25,Steve Richardson,9,66,31,LW,1974
33959,18,25,Steve Richardson,8,47,26,LW,1974
33960,4,25,Steve Richardson,1,19,5,LW,1974
33961,0,26,Steve Richardson,0,6,0,LW,1975
33962,0,26,Steve Richardson,0,6,0,LW,1975
33963,5,24,Steve Richmond,2,26,7,D,1983
33964,5,25,Steve Richmond,0,34,5,D,1984
33965,4,26,Steve Richmond,1,46,5,D,1985
33966,7,27,Steve Richmond,1,44,8,D,1986
33967,2,29,Steve Richmond,0,9,2,D,1988
33968,0,22,Steve Rooney,1,3,1,LW,1984
33969,3,23,Steve Rooney,2,38,5,LW,1985
33970,3,24,Steve Rooney,2,32,5,LW,1986
33971,6,25,Steve Rooney,7,56,13,LW,1987
33972,1,26,Steve Rooney,3,25,4,LW,1988
33973,11,23,Steve Rucchin,6,43,17,C,1994
33974,25,24,Steve Rucchin,19,64,44,C,1995
33975,48,25,Steve Rucchin,19,79,67,C,1996
33976,36,26,Steve Rucchin,17,72,53,C,1997
33977,39,27,Steve Rucchin,23,69,62,C,1998
33978,38,28,Steve Rucchin,19,71,57,C,1999
33979,5,29,Steve Rucchin,3,16,8,C,2000
33980,16,30,Steve Rucchin,7,38,23,C,2001
33981,38,31,Steve Rucchin,20,82,58,C,2002
33982,23,32,Steve Rucchin,20,82,43,C,2003
33983,23,34,Steve Rucchin,13,72,36,C,2005
33984,16,35,Steve Rucchin,5,47,21,C,2006
33985,0,22,Steve Seftel,0,4,0,LW,1990
33986,0,20,Steve Seguin,0,5,0,RW,1984
33987,0,26,Steve Self,0,3,0,C,1976
33988,0,23,Steve Short,0,5,0,D,1977
33989,0,24,Steve Short,0,1,0,D,1978
33990,8,20,Steve Shutt,8,50,16,LW,1972
33991,20,21,Steve Shutt,15,70,35,LW,1973
33992,35,22,Steve Shutt,30,77,65,LW,1974
33993,34,23,Steve Shutt,45,80,79,LW,1975
33994,45,24,Steve Shutt,60,80,105,LW,1976
33995,37,25,Steve Shutt,49,80,86,LW,1977
33996,40,26,Steve Shutt,37,72,77,LW,1978
33997,42,27,Steve Shutt,47,77,89,LW,1979
33998,38,28,Steve Shutt,35,77,73,LW,1980
33999,24,29,Steve Shutt,31,57,55,LW,1981
34000,22,30,Steve Shutt,35,78,57,LW,1982
34001,23,31,Steve Shutt,14,63,37,LW,1983
34002,25,32,Steve Shutt,18,69,43,LW,1984
34003,1,18,Steve Smith,0,8,1,D,1981
34004,0,21,Steve Smith,0,2,0,D,1984
34005,0,21,Steve Smith,0,2,0,D,1984
34006,20,22,Steve Smith,4,55,24,D,1985
34007,0,22,Steve Smith,0,2,0,D,1985
34008,15,23,Steve Smith,7,62,22,D,1986
34009,0,23,Steve Smith,0,2,0,D,1986
34010,43,24,Steve Smith,12,79,55,D,1987
34011,0,24,Steve Smith,0,1,0,D,1987
34012,19,25,Steve Smith,3,35,22,D,1988
34013,0,25,Steve Smith,0,3,0,D,1988
34014,34,26,Steve Smith,7,75,41,D,1989
34015,41,27,Steve Smith,13,77,54,D,1990
34016,21,28,Steve Smith,9,76,30,D,1991
34017,47,29,Steve Smith,10,78,57,D,1992
34018,22,30,Steve Smith,5,57,27,D,1993
34019,12,31,Steve Smith,1,48,13,D,1994
34020,9,32,Steve Smith,0,37,9,D,1995
34021,0,33,Steve Smith,0,21,0,D,1996
34022,14,35,Steve Smith,1,69,15,D,1998
34023,4,36,Steve Smith,0,20,4,D,1999
34024,2,37,Steve Smith,0,13,2,D,2000
34025,0,22,Steve Staios,0,12,0,D,1995
34026,14,23,Steve Staios,3,63,17,D,1996
34027,4,24,Steve Staios,3,77,7,RW,1997
34028,2,25,Steve Staios,0,57,2,RW,1998
34029,3,26,Steve Staios,2,27,5,RW,1999
34030,13,27,Steve Staios,9,70,22,D,2000
34031,5,28,Steve Staios,5,73,10,D,2001
34032,21,29,Steve Staios,5,76,26,D,2002
34033,22,30,Steve Staios,6,82,28,D,2003
34034,20,32,Steve Staios,8,82,28,D,2005
34035,15,33,Steve Staios,2,58,17,D,2006
34036,9,34,Steve Staios,7,82,16,D,2007
34037,12,35,Steve Staios,2,80,14,D,2008
34038,9,36,Steve Staios,1,58,10,D,2009
34039,7,37,Steve Staios,3,39,10,D,2010
34040,8,38,Steve Staios,0,65,8,D,2011
34041,0,21,Steve Stone,0,2,0,RW,1973
34042,5,26,Steve Stoyanovich,3,23,8,C,1983
34043,4,21,Steve Sullivan,5,16,9,C,1995
34044,25,22,Steve Sullivan,13,54,38,C,1996
34045,18,23,Steve Sullivan,10,63,28,C,1997
34046,20,24,Steve Sullivan,20,63,40,C,1998
34047,43,25,Steve Sullivan,22,80,65,C,1999
34048,41,26,Steve Sullivan,34,81,75,RW,2000
34049,39,27,Steve Sullivan,21,78,60,RW,2001
34050,35,28,Steve Sullivan,26,82,61,RW,2002
34051,49,29,Steve Sullivan,24,80,73,RW,2003
34052,37,31,Steve Sullivan,31,69,68,RW,2005
34053,38,32,Steve Sullivan,22,57,60,RW,2006
34054,21,34,Steve Sullivan,11,41,32,LW,2008
34055,34,35,Steve Sullivan,17,82,51,C,2009
34056,12,36,Steve Sullivan,10,44,22,C,2010
34057,31,37,Steve Sullivan,17,79,48,C,2011
34058,10,38,Steve Sullivan,7,42,17,C,2012
34059,6,26,Steve Sutherland,11,44,17,LW,1972
34060,6,26,Steve Sutherland,11,44,17,LW,1972
34061,12,27,Steve Sutherland,20,72,32,LW,1973
34062,12,27,Steve Sutherland,20,72,32,LW,1973
34063,20,28,Steve Sutherland,15,78,35,LW,1974
34064,15,28,Steve Sutherland,14,56,29,LW,1974
34065,5,28,Steve Sutherland,1,22,6,LW,1974
34066,20,28,Steve Sutherland,15,78,35,LW,1974
34067,15,28,Steve Sutherland,14,56,29,LW,1974
34068,5,28,Steve Sutherland,1,22,6,LW,1974
34069,19,29,Steve Sutherland,22,74,41,LW,1975
34070,19,29,Steve Sutherland,22,74,41,LW,1975
34071,9,30,Steve Sutherland,6,36,15,LW,1976
34072,9,30,Steve Sutherland,6,36,15,LW,1976
34073,10,31,Steve Sutherland,23,75,33,LW,1977
34074,10,31,Steve Sutherland,23,75,33,LW,1977
34075,0,20,Steve Tambellini,0,1,0,C,1978
34076,8,21,Steve Tambellini,5,45,13,C,1979
34077,29,22,Steve Tambellini,25,74,54,C,1980
34078,30,23,Steve Tambellini,29,79,59,C,1981
34079,18,24,Steve Tambellini,25,73,43,C,1982
34080,10,25,Steve Tambellini,15,73,25,LW,1983
34081,10,26,Steve Tambellini,19,47,29,C,1984
34082,15,27,Steve Tambellini,15,48,30,C,1985
34083,20,28,Steve Tambellini,16,72,36,C,1986
34084,10,29,Steve Tambellini,11,41,21,LW,1987
34085,1,21,Steve Thomas,1,18,2,LW,1984
34086,37,22,Steve Thomas,20,65,57,LW,1985
34087,27,23,Steve Thomas,35,78,62,LW,1986
34088,13,24,Steve Thomas,13,30,26,LW,1987
34089,19,25,Steve Thomas,21,45,40,LW,1988
34090,30,26,Steve Thomas,40,76,70,RW,1989
34091,35,27,Steve Thomas,19,69,54,LW,1990
34092,48,28,Steve Thomas,30,82,78,RW,1991
34093,50,29,Steve Thomas,37,79,87,RW,1992
34094,33,30,Steve Thomas,42,78,75,RW,1993
34095,15,31,Steve Thomas,11,47,26,RW,1994
34096,35,32,Steve Thomas,26,81,61,LW,1995
34097,19,33,Steve Thomas,15,57,34,RW,1996
34098,10,34,Steve Thomas,14,55,24,RW,1997
34099,45,35,Steve Thomas,28,78,73,LW,1998
34100,37,36,Steve Thomas,26,81,63,RW,1999
34101,26,37,Steve Thomas,8,57,34,RW,2000
34102,4,38,Steve Thomas,11,34,15,RW,2001
34103,16,39,Steve Thomas,14,81,30,RW,2002
34104,12,40,Steve Thomas,10,44,22,LW,2003
34105,12,23,Steve Tuttle,13,53,25,RW,1988
34106,10,24,Steve Tuttle,12,71,22,C,1989
34107,6,25,Steve Tuttle,3,20,9,RW,1990
34108,23,21,Steve Vickers,30,61,53,LW,1972
34109,24,22,Steve Vickers,34,75,58,LW,1973
34110,48,23,Steve Vickers,41,80,89,LW,1974
34111,53,24,Steve Vickers,30,80,83,LW,1975
34112,31,25,Steve Vickers,22,75,53,LW,1976
34113,44,26,Steve Vickers,19,79,63,LW,1977
34114,34,27,Steve Vickers,13,66,47,LW,1978
34115,33,28,Steve Vickers,29,75,62,LW,1979
34116,39,29,Steve Vickers,19,73,58,LW,1980
34117,11,30,Steve Vickers,9,34,20,LW,1981
34118,6,23,Steve Wagner,2,24,8,D,2007
34119,2,24,Steve Wagner,2,22,4,D,2008
34120,8,22,Steve Warr,3,72,11,D,1972
34121,8,22,Steve Warr,3,72,11,D,1972
34122,1,20,Steve Washburn,0,1,1,C,1995
34123,6,21,Steve Washburn,3,18,9,C,1996
34124,8,22,Steve Washburn,11,58,19,C,1997
34125,0,23,Steve Washburn,0,12,0,C,1998
34126,0,24,Steve Washburn,0,1,0,C,1999
34127,0,25,Steve Washburn,0,3,0,C,2000
34128,4,21,Steve Webb,1,41,5,RW,1996
34129,0,22,Steve Webb,0,20,0,RW,1997
34130,0,23,Steve Webb,0,45,0,RW,1998
34131,3,24,Steve Webb,1,65,4,RW,1999
34132,2,25,Steve Webb,0,31,2,C,2000
34133,4,26,Steve Webb,2,60,6,RW,2001
34134,0,27,Steve Webb,1,49,1,RW,2002
34135,0,28,Steve Webb,0,10,0,RW,2003
34136,18,22,Steve West,15,50,33,C,1974
34137,18,22,Steve West,15,50,33,C,1974
34138,0,24,Steve West,0,3,0,C,1976
34139,0,24,Steve West,0,3,0,C,1976
34140,21,25,Steve West,11,71,32,C,1977
34141,21,25,Steve West,11,71,32,C,1977
34142,11,26,Steve West,3,18,14,C,1978
34143,11,26,Steve West,3,18,14,C,1978
34144,48,18,Steve Yzerman,39,80,87,C,1983
34145,59,19,Steve Yzerman,30,80,89,C,1984
34146,28,20,Steve Yzerman,14,51,42,C,1985
34147,59,21,Steve Yzerman,31,80,90,C,1986
34148,52,22,Steve Yzerman,50,64,102,C,1987
34149,90,23,Steve Yzerman,65,80,155,C,1988
34150,65,24,Steve Yzerman,62,79,127,C,1989
34151,57,25,Steve Yzerman,51,80,108,C,1990
34152,58,26,Steve Yzerman,45,79,103,C,1991
34153,79,27,Steve Yzerman,58,84,137,C,1992
34154,58,28,Steve Yzerman,24,58,82,LW,1993
34155,26,29,Steve Yzerman,12,47,38,C,1994
34156,59,30,Steve Yzerman,36,80,95,C,1995
34157,63,31,Steve Yzerman,22,81,85,LW,1996
34158,45,32,Steve Yzerman,24,75,69,C,1997
34159,45,33,Steve Yzerman,29,80,74,C,1998
34160,44,34,Steve Yzerman,35,78,79,C,1999
34161,34,35,Steve Yzerman,18,54,52,C,2000
34162,35,36,Steve Yzerman,13,52,48,C,2001
34163,6,37,Steve Yzerman,2,16,8,C,2002
34164,33,38,Steve Yzerman,18,75,51,C,2003
34165,20,40,Steve Yzerman,14,61,34,C,2005
34166,1,19,Steven Finn,0,17,1,D,1985
34167,5,20,Steven Finn,2,36,7,D,1986
34168,7,21,Steven Finn,3,75,10,D,1987
34169,6,22,Steven Finn,2,77,8,D,1988
34170,9,23,Steven Finn,3,64,12,D,1989
34171,13,24,Steven Finn,6,71,19,D,1990
34172,7,25,Steven Finn,4,65,11,D,1991
34173,9,26,Steven Finn,5,80,14,D,1992
34174,13,27,Steven Finn,4,80,17,D,1993
34175,3,28,Steven Finn,0,40,3,D,1994
34176,2,29,Steven Finn,3,66,5,D,1995
34177,3,30,Steven Finn,2,54,5,D,1996
34178,0,26,Steven Fletcher,0,3,0,LW,1988
34179,0,24,Steven Fogarty,0,1,0,C,2017
34180,0,21,Steven Goertzen,0,39,0,RW,2005
34181,0,22,Steven Goertzen,0,7,0,RW,2006
34182,2,24,Steven Goertzen,2,16,4,RW,2008
34183,0,25,Steven Goertzen,0,6,0,RW,2009
34184,2,23,Steven Halko,0,18,2,D,1997
34185,3,24,Steven Halko,0,20,3,D,1998
34186,8,25,Steven Halko,0,58,8,D,1999
34187,1,26,Steven Halko,0,48,1,D,2000
34188,1,27,Steven Halko,0,5,1,D,2001
34189,0,28,Steven Halko,0,6,0,D,2002
34190,5,22,Steven Kampfer,5,38,10,D,2010
34191,3,23,Steven Kampfer,2,23,5,D,2011
34192,2,26,Steven Kampfer,2,25,4,D,2014
34193,4,27,Steven Kampfer,0,47,4,D,2015
34194,0,28,Steven Kampfer,0,1,0,D,2016
34195,1,29,Steven Kampfer,0,22,1,D,2017
34196,5,23,Steven King,7,24,12,RW,1992
34197,3,24,Steven King,8,36,11,RW,1993
34198,0,26,Steven King,2,7,2,RW,1995
34199,8,26,Steven Oleksy,1,28,9,D,2012
34200,8,27,Steven Oleksy,2,33,10,D,2013
34201,1,30,Steven Oleksy,0,11,1,D,2016
34202,2,30,Steven Pinizzotto,2,18,4,RW,2014
34203,1,19,Steven Rice,1,11,2,RW,1990
34204,0,20,Steven Rice,0,3,0,RW,1991
34205,5,21,Steven Rice,2,28,7,RW,1992
34206,15,22,Steven Rice,17,63,32,RW,1993
34207,10,23,Steven Rice,11,40,21,RW,1994
34208,12,24,Steven Rice,10,59,22,RW,1995
34209,14,25,Steven Rice,21,78,35,RW,1996
34210,4,26,Steven Rice,2,47,6,RW,1997
34211,0,20,Steven Santini,0,1,0,D,2015
34212,5,21,Steven Santini,2,38,7,D,2016
34213,8,22,Steven Santini,2,36,10,D,2017
34214,23,18,Steven Stamkos,23,79,46,C,2008
34215,44,19,Steven Stamkos,51,82,95,C,2009
34216,46,20,Steven Stamkos,45,82,91,C,2010
34217,37,21,Steven Stamkos,60,82,97,C,2011
34218,28,22,Steven Stamkos,29,48,57,C,2012
34219,15,23,Steven Stamkos,25,37,40,C,2013
34220,29,24,Steven Stamkos,43,82,72,C,2014
34221,28,25,Steven Stamkos,36,77,64,C,2015
34222,11,26,Steven Stamkos,9,17,20,C,2016
34223,59,27,Steven Stamkos,27,78,86,C,2017
34224,0,23,Steven Zalewski,0,3,0,C,2009
34225,0,25,Steven Zalewski,0,7,0,C,2011
34226,2,20,Stew Gavin,1,14,3,LW,1980
34227,6,21,Stew Gavin,5,38,11,LW,1981
34228,5,22,Stew Gavin,6,63,11,LW,1982
34229,22,23,Stew Gavin,10,80,32,RW,1983
34230,13,24,Stew Gavin,12,73,25,RW,1984
34231,29,25,Stew Gavin,26,76,55,RW,1985
34232,21,26,Stew Gavin,20,79,41,RW,1986
34233,10,27,Stew Gavin,11,56,21,RW,1987
34234,18,28,Stew Gavin,8,73,26,LW,1988
34235,13,29,Stew Gavin,12,80,25,LW,1989
34236,4,30,Stew Gavin,4,38,8,LW,1990
34237,4,31,Stew Gavin,5,35,9,LW,1991
34238,8,32,Stew Gavin,10,63,18,LW,1992
34239,3,23,Stewart Malgunas,1,67,4,D,1993
34240,0,24,Stewart Malgunas,0,4,0,D,1994
34241,1,25,Stewart Malgunas,0,30,1,D,1995
34242,0,26,Stewart Malgunas,0,6,0,D,1996
34243,0,27,Stewart Malgunas,0,8,0,D,1997
34244,0,28,Stewart Malgunas,0,10,0,D,1998
34245,1,29,Stewart Malgunas,0,4,1,D,1999
34246,9,21,Stu Barnes,8,46,17,C,1991
34247,10,22,Stu Barnes,12,38,22,C,1992
34248,24,23,Stu Barnes,23,77,47,C,1993
34249,19,24,Stu Barnes,10,41,29,C,1994
34250,25,25,Stu Barnes,19,72,44,C,1995
34251,30,26,Stu Barnes,19,81,49,C,1996
34252,35,27,Stu Barnes,30,78,65,LW,1997
34253,16,28,Stu Barnes,20,81,36,C,1998
34254,25,29,Stu Barnes,20,82,45,C,1999
34255,24,30,Stu Barnes,19,75,43,C,2000
34256,31,31,Stu Barnes,17,68,48,C,2001
34257,26,32,Stu Barnes,13,81,39,LW,2002
34258,18,33,Stu Barnes,11,77,29,C,2003
34259,21,35,Stu Barnes,15,78,36,C,2005
34260,12,36,Stu Barnes,13,82,25,C,2006
34261,11,37,Stu Barnes,12,79,23,C,2007
34262,9,25,Stu Bickel,0,51,9,D,2011
34263,0,26,Stu Bickel,0,16,0,D,2012
34264,1,28,Stu Bickel,0,9,1,D,2014
34265,0,23,Stu Grimson,0,1,0,LW,1988
34266,0,24,Stu Grimson,0,3,0,LW,1989
34267,1,25,Stu Grimson,0,35,1,LW,1990
34268,2,26,Stu Grimson,2,54,4,LW,1991
34269,1,27,Stu Grimson,1,78,2,LW,1992
34270,5,28,Stu Grimson,1,77,6,LW,1993
34271,1,29,Stu Grimson,0,42,1,LW,1994
34272,1,30,Stu Grimson,0,56,1,LW,1995
34273,2,31,Stu Grimson,2,76,4,LW,1996
34274,4,32,Stu Grimson,3,82,7,LW,1997
34275,0,33,Stu Grimson,3,73,3,LW,1998
34276,2,34,Stu Grimson,1,50,3,LW,1999
34277,2,35,Stu Grimson,3,72,5,LW,2000
34278,1,36,Stu Grimson,1,30,2,LW,2001
34279,1,19,Stu Kulak,1,4,2,RW,1982
34280,2,23,Stu Kulak,4,54,6,RW,1986
34281,1,24,Stu Kulak,1,14,2,RW,1987
34282,0,25,Stu Kulak,2,18,2,RW,1988
34283,0,19,Stu Smith,0,4,0,D,1979
34284,7,20,Stu Smith,1,38,8,D,1980
34285,3,21,Stu Smith,0,17,3,D,1981
34286,0,22,Stu Smith,1,18,1,D,1982
34287,3,21,Stuart Percy,0,9,3,D,2014
34288,0,22,Stuart Percy,0,3,0,D,2015
34289,1,21,Sven Andrighetto,2,12,3,RW,2014
34290,10,22,Sven Andrighetto,7,44,17,RW,2015
34291,11,23,Sven Andrighetto,5,19,16,RW,2016
34292,14,24,Sven Andrighetto,8,50,22,RW,2017
34293,0,19,Sven Baertschi,3,5,3,LW,2011
34294,7,20,Sven Baertschi,3,20,10,LW,2012
34295,9,21,Sven Baertschi,2,26,11,LW,2013
34296,4,22,Sven Baertschi,2,18,6,LW,2014
34297,13,23,Sven Baertschi,15,69,28,LW,2015
34298,17,24,Sven Baertschi,18,68,35,LW,2016
34299,15,25,Sven Baertschi,14,53,29,LW,2017
34300,0,21,Sven Butenschon,0,8,0,D,1997
34301,0,22,Sven Butenschon,0,17,0,D,1998
34302,0,23,Sven Butenschon,0,3,0,D,1999
34303,2,24,Sven Butenschon,1,12,3,D,2000
34304,0,25,Sven Butenschon,0,14,0,D,2001
34305,4,26,Sven Butenschon,0,37,4,D,2002
34306,6,27,Sven Butenschon,1,41,7,D,2003
34307,0,29,Sven Butenschon,0,8,0,D,2005
34308,18,23,Syl Apps,10,62,28,C,1970
34309,44,24,Syl Apps,15,72,59,C,1971
34310,56,25,Syl Apps,29,77,85,C,1972
34311,61,26,Syl Apps,24,75,85,C,1973
34312,55,27,Syl Apps,24,79,79,C,1974
34313,67,28,Syl Apps,32,80,99,C,1975
34314,43,29,Syl Apps,18,72,61,C,1976
34315,33,30,Syl Apps,19,79,52,C,1977
34316,30,31,Syl Apps,7,80,37,C,1978
34317,16,32,Syl Apps,5,51,21,C,1979
34318,0,22,Sylvain Blouin,0,6,0,D,1996
34319,0,23,Sylvain Blouin,0,1,0,D,1997
34320,0,24,Sylvain Blouin,0,5,0,LW,1998
34321,2,26,Sylvain Blouin,3,41,5,LW,2000
34322,2,27,Sylvain Blouin,0,43,2,LW,2001
34323,0,28,Sylvain Blouin,0,19,0,LW,2002
34324,0,24,Sylvain Cloutier,0,7,0,C,1998
34325,9,19,Sylvain Cote,3,67,12,D,1984
34326,0,20,Sylvain Cote,0,2,0,D,1985
34327,8,21,Sylvain Cote,2,67,10,D,1986
34328,21,22,Sylvain Cote,7,67,28,D,1987
34329,9,23,Sylvain Cote,8,78,17,D,1988
34330,2,24,Sylvain Cote,4,28,6,D,1989
34331,12,25,Sylvain Cote,7,73,19,D,1990
34332,29,26,Sylvain Cote,11,78,40,D,1991
34333,29,27,Sylvain Cote,21,77,50,D,1992
34334,35,28,Sylvain Cote,16,84,51,D,1993
34335,14,29,Sylvain Cote,5,47,19,D,1994
34336,33,30,Sylvain Cote,5,81,38,D,1995
34337,18,31,Sylvain Cote,6,57,24,D,1996
34338,21,32,Sylvain Cote,4,71,25,D,1997
34339,24,33,Sylvain Cote,5,79,29,D,1998
34340,27,34,Sylvain Cote,8,76,35,D,1999
34341,11,35,Sylvain Cote,7,68,18,D,2000
34342,11,36,Sylvain Cote,3,70,14,D,2001
34343,0,37,Sylvain Cote,0,1,0,D,2002
34344,3,20,Sylvain Couturier,1,16,4,C,1988
34345,1,22,Sylvain Couturier,0,3,1,C,1990
34346,1,23,Sylvain Couturier,3,14,4,C,1991
34347,10,22,Sylvain Lefebvre,3,68,13,D,1989
34348,18,23,Sylvain Lefebvre,5,63,23,D,1990
34349,14,24,Sylvain Lefebvre,3,69,17,D,1991
34350,12,25,Sylvain Lefebvre,2,81,14,D,1992
34351,9,26,Sylvain Lefebvre,2,84,11,D,1993
34352,11,27,Sylvain Lefebvre,2,48,13,D,1994
34353,11,28,Sylvain Lefebvre,5,75,16,D,1995
34354,11,29,Sylvain Lefebvre,2,71,13,D,1996
34355,10,30,Sylvain Lefebvre,0,81,10,D,1997
34356,18,31,Sylvain Lefebvre,2,76,20,D,1998
34357,10,32,Sylvain Lefebvre,2,82,12,D,1999
34358,13,33,Sylvain Lefebvre,2,71,15,D,2000
34359,5,34,Sylvain Lefebvre,0,41,5,D,2001
34360,2,35,Sylvain Lefebvre,0,35,2,D,2002
34361,32,19,Sylvain Turgeon,40,76,72,LW,1983
34362,31,20,Sylvain Turgeon,31,64,62,LW,1984
34363,34,21,Sylvain Turgeon,45,76,79,LW,1985
34364,13,22,Sylvain Turgeon,23,41,36,LW,1986
34365,26,23,Sylvain Turgeon,23,71,49,LW,1987
34366,14,24,Sylvain Turgeon,16,42,30,LW,1988
34367,17,25,Sylvain Turgeon,30,72,47,RW,1989
34368,7,26,Sylvain Turgeon,5,19,12,LW,1990
34369,11,27,Sylvain Turgeon,9,56,20,LW,1991
34370,18,28,Sylvain Turgeon,25,72,43,LW,1992
34371,15,29,Sylvain Turgeon,11,47,26,RW,1993
34372,8,30,Sylvain Turgeon,11,33,19,LW,1994
34373,0,22,T.J. Brennan,1,11,1,D,2011
34374,7,23,T.J. Brennan,3,29,10,D,2012
34375,0,26,T.J. Brennan,1,7,1,D,2015
34376,0,20,T.J. Brodie,0,3,0,D,2010
34377,12,21,T.J. Brodie,2,54,14,D,2011
34378,12,22,T.J. Brodie,2,47,14,D,2012
34379,27,23,T.J. Brodie,4,81,31,D,2013
34380,39,25,T.J. Brodie,6,70,45,D,2015
34381,30,26,T.J. Brodie,6,82,36,D,2016
34382,28,27,T.J. Brodie,4,73,32,D,2017
34383,1,20,T.J. Galiardi,3,11,4,LW,2008
34384,24,21,T.J. Galiardi,15,70,39,LW,2009
34385,8,22,T.J. Galiardi,7,35,15,LW,2010
34386,6,23,T.J. Galiardi,9,69,15,LW,2011
34387,9,24,T.J. Galiardi,5,36,14,LW,2012
34388,13,25,T.J. Galiardi,4,62,17,LW,2013
34389,5,22,T.J. Hensick,6,31,11,C,2007
34390,17,23,T.J. Hensick,4,61,21,C,2008
34391,2,24,T.J. Hensick,1,7,3,C,2009
34392,2,25,T.J. Hensick,1,13,3,C,2010
34393,25,22,T.J. Oshie,14,57,39,C,2008
34394,30,23,T.J. Oshie,18,76,48,C,2009
34395,22,24,T.J. Oshie,12,49,34,C,2010
34396,35,25,T.J. Oshie,19,80,54,C,2011
34397,13,26,T.J. Oshie,7,30,20,C,2012
34398,39,27,T.J. Oshie,21,79,60,RW,2013
34399,36,28,T.J. Oshie,19,72,55,RW,2014
34400,25,29,T.J. Oshie,26,80,51,RW,2015
34401,23,30,T.J. Oshie,33,68,56,RW,2016
34402,29,31,T.J. Oshie,18,74,47,RW,2017
34403,0,24,T.J. Tynan,0,3,0,RW,2016
34407,6,20,Tage Thompson,3,41,9,C,2017
34408,4,26,Tanner Fritz,3,34,7,C,2017
34409,1,24,Tanner Glass,1,41,2,LW,2007
34410,0,25,Tanner Glass,0,3,0,LW,2008
34411,7,26,Tanner Glass,4,67,11,LW,2009
34412,7,27,Tanner Glass,3,73,10,LW,2010
34413,11,28,Tanner Glass,5,78,16,LW,2011
34414,1,29,Tanner Glass,1,48,2,LW,2012
34415,9,30,Tanner Glass,4,67,13,LW,2013
34416,5,31,Tanner Glass,1,66,6,LW,2014
34417,3,32,Tanner Glass,4,57,7,LW,2015
34418,1,33,Tanner Glass,1,11,2,LW,2016
34419,0,34,Tanner Glass,0,16,0,LW,2017
34420,2,23,Tanner Kero,1,17,3,RW,2015
34421,10,24,Tanner Kero,6,47,16,RW,2016
34422,2,25,Tanner Kero,1,8,3,RW,2017
34423,4,21,Tanner Pearson,3,25,7,LW,2013
34424,4,22,Tanner Pearson,12,42,16,LW,2014
34425,21,23,Tanner Pearson,15,79,36,LW,2015
34426,20,24,Tanner Pearson,24,80,44,LW,2016
34427,25,25,Tanner Pearson,15,82,40,LW,2017
34428,0,23,Tanner Richard,0,3,0,C,2016
34429,13,26,Tapio Levo,9,34,22,D,1981
34430,40,27,Tapio Levo,7,73,47,D,1982
34431,0,19,Tavis Hansen,0,1,0,C,1994
34432,0,21,Tavis Hansen,0,1,0,C,1996
34433,1,23,Tavis Hansen,2,20,3,C,1998
34434,0,24,Tavis Hansen,0,5,0,C,1999
34435,0,25,Tavis Hansen,0,7,0,RW,2000
34436,0,19,Taylor  Hall,1,4,1,LW,1983
34437,4,20,Taylor  Hall,1,7,5,LW,1984
34438,5,21,Taylor  Hall,5,19,10,LW,1985
34439,0,22,Taylor  Hall,0,4,0,LW,1986
34440,0,23,Taylor  Hall,0,7,0,LW,1987
34441,4,21,Taylor Beck,3,16,7,LW,2012
34442,0,22,Taylor Beck,0,7,0,RW,2013
34443,8,23,Taylor Beck,8,62,16,LW,2014
34444,0,24,Taylor Beck,0,2,0,LW,2015
34445,0,25,Taylor Beck,0,2,0,LW,2016
34446,0,21,Taylor Chorney,0,2,0,D,2008
34447,3,22,Taylor Chorney,0,42,3,D,2009
34448,3,23,Taylor Chorney,1,12,4,D,2010
34449,0,24,Taylor Chorney,0,5,0,D,2011
34450,0,27,Taylor Chorney,0,7,0,D,2014
34451,5,28,Taylor Chorney,1,55,6,D,2015
34452,4,29,Taylor Chorney,1,18,5,D,2016
34453,0,30,Taylor Chorney,0,1,0,D,2017
34454,0,25,Taylor Fedun,2,4,2,D,2013
34455,4,26,Taylor Fedun,0,7,4,D,2014
34456,1,27,Taylor Fedun,0,1,1,D,2015
34457,7,28,Taylor Fedun,0,27,7,D,2016
34458,1,29,Taylor Fedun,0,7,1,D,2017
34459,33,25,Taylor Hall,20,72,53,LW,2016
34460,54,26,Taylor Hall,39,76,93,LW,2017
34461,0,21,Taylor Leier,0,6,0,LW,2015
34462,1,22,Taylor Leier,1,10,2,LW,2016
34463,4,23,Taylor Leier,1,39,5,LW,2017
34464,14,19,Taylor Pyatt,4,78,18,LW,2000
34465,10,20,Taylor Pyatt,10,48,20,LW,2001
34466,14,21,Taylor Pyatt,14,78,28,LW,2002
34467,12,22,Taylor Pyatt,8,63,20,LW,2003
34468,6,24,Taylor Pyatt,6,41,12,LW,2005
34469,14,25,Taylor Pyatt,23,76,37,LW,2006
34470,21,26,Taylor Pyatt,16,79,37,LW,2007
34471,9,27,Taylor Pyatt,10,69,19,LW,2008
34472,11,28,Taylor Pyatt,12,74,23,LW,2009
34473,13,29,Taylor Pyatt,18,76,31,LW,2010
34474,10,30,Taylor Pyatt,9,73,19,LW,2011
34475,5,31,Taylor Pyatt,6,48,11,LW,2012
34476,1,32,Taylor Pyatt,4,56,5,LW,2013
34477,20,19,Taylor S Hall,22,65,42,LW,2010
34478,26,20,Taylor S Hall,27,61,53,LW,2011
34479,34,21,Taylor S Hall,16,45,50,LW,2012
34480,53,22,Taylor S Hall,27,75,80,LW,2013
34481,24,23,Taylor S Hall,14,53,38,LW,2014
34482,39,24,Taylor S Hall,26,82,65,LW,2015
34483,0,21,Ted Bulley,0,2,0,LW,1976
34484,28,22,Ted Bulley,23,79,51,LW,1977
34485,23,23,Ted Bulley,27,75,50,LW,1978
34486,17,24,Ted Bulley,14,66,31,LW,1979
34487,16,25,Ted Bulley,18,68,34,LW,1980
34488,18,26,Ted Bulley,12,59,30,LW,1981
34489,9,27,Ted Bulley,4,39,13,LW,1982
34490,2,28,Ted Bulley,3,26,5,LW,1983
34491,2,23,Ted Crowley,1,21,3,D,1993
34492,2,28,Ted Crowley,1,13,3,D,1998
34493,2,22,Ted Donato,1,10,3,C,1991
34494,20,23,Ted Donato,15,82,35,LW,1992
34495,32,24,Ted Donato,22,84,54,LW,1993
34496,10,25,Ted Donato,10,47,20,C,1994
34497,26,26,Ted Donato,23,82,49,LW,1995
34498,26,27,Ted Donato,25,67,51,LW,1996
34499,23,28,Ted Donato,16,79,39,LW,1997
34500,16,29,Ted Donato,11,82,27,LW,1998
34501,19,30,Ted Donato,11,81,30,LW,1999
34502,17,31,Ted Donato,8,65,25,LW,2000
34503,0,32,Ted Donato,0,5,0,LW,2001
34504,1,33,Ted Donato,2,49,3,C,2002
34505,5,34,Ted Donato,6,63,11,C,2003
34506,12,22,Ted Drury,6,50,18,C,1993
34507,6,23,Ted Drury,3,34,9,LW,1994
34508,7,24,Ted Drury,9,42,16,C,1995
34509,9,25,Ted Drury,9,73,18,LW,1996
34510,10,26,Ted Drury,6,73,16,LW,1997
34511,6,27,Ted Drury,5,75,11,C,1998
34512,2,28,Ted Drury,3,66,5,C,1999
34513,0,29,Ted Drury,0,1,0,C,2000
34514,1,25,Ted Fauss,0,15,1,D,1986
34515,1,26,Ted Fauss,0,13,1,D,1987
34516,36,27,Ted Green,7,72,43,D,1967
34517,38,28,Ted Green,8,65,46,D,1968
34518,37,30,Ted Green,5,78,42,D,1970
34519,16,31,Ted Green,1,54,17,D,1971
34520,30,32,Ted Green,16,78,46,D,1972
34521,26,33,Ted Green,7,75,33,D,1973
34522,14,34,Ted Green,6,57,20,D,1974
34523,23,35,Ted Green,5,79,28,D,1975
34524,21,36,Ted Green,4,70,25,D,1976
34525,22,37,Ted Green,4,73,26,D,1977
34526,2,38,Ted Green,0,20,2,D,1978
34527,37,31,Ted Hampson,17,71,54,C,1967
34528,49,32,Ted Hampson,26,76,75,C,1968
34529,35,33,Ted Hampson,17,76,52,C,1969
34530,26,34,Ted Hampson,14,78,40,C,1970
34531,14,35,Ted Hampson,5,78,19,C,1971
34532,45,36,Ted Hampson,17,77,62,C,1972
34533,38,37,Ted Hampson,17,77,55,C,1973
34534,36,38,Ted Hampson,17,78,53,C,1974
34535,24,39,Ted Hampson,9,73,33,C,1975
34536,12,30,Ted Hargreaves,7,74,19,LW,1973
34537,16,31,Ted Harris,5,67,21,D,1967
34538,18,32,Ted Harris,7,76,25,D,1968
34539,17,33,Ted Harris,3,74,20,D,1969
34540,13,34,Ted Harris,2,78,15,D,1970
34541,15,35,Ted Harris,2,78,17,D,1971
34542,23,36,Ted Harris,7,78,30,D,1972
34543,16,37,Ted Harris,0,77,16,D,1973
34544,6,38,Ted Harris,1,70,7,D,1974
34545,23,27,Ted Hodgson,15,74,38,RW,1972
34546,11,28,Ted Hodgson,3,33,14,RW,1973
34547,9,28,Ted Hodgson,3,23,12,RW,1973
34548,2,28,Ted Hodgson,0,10,2,RW,1973
34549,22,23,Ted Irvine,18,73,40,LW,1967
34550,24,24,Ted Irvine,15,76,39,LW,1968
34551,16,25,Ted Irvine,11,75,27,LW,1969
34552,18,26,Ted Irvine,20,76,38,LW,1970
34553,21,27,Ted Irvine,15,78,36,LW,1971
34554,12,28,Ted Irvine,8,53,20,LW,1972
34555,20,29,Ted Irvine,26,75,46,LW,1973
34556,17,30,Ted Irvine,17,79,34,LW,1974
34557,13,31,Ted Irvine,10,69,23,LW,1975
34558,14,32,Ted Irvine,14,69,28,LW,1976
34559,0,28,Ted Lanyon,0,5,0,D,1967
34560,0,22,Ted Long,0,1,0,D,1976
34561,13,22,Ted McAneeley,4,77,17,D,1972
34562,20,23,Ted McAneeley,4,72,24,D,1973
34563,2,24,Ted McAneeley,0,9,2,D,1974
34564,17,25,Ted McAneeley,2,79,19,D,1975
34565,2,31,Ted McCaskill,0,4,2,C,1967
34566,11,36,Ted McCaskill,11,73,22,C,1972
34567,2,37,Ted McCaskill,2,18,4,C,1973
34568,13,23,Ted Nolan,4,41,17,C,1981
34569,2,25,Ted Nolan,1,19,3,C,1983
34570,1,27,Ted Nolan,1,18,2,C,1985
34571,1,23,Ted Scharf,3,67,4,RW,1974
34572,14,24,Ted Scharf,7,74,21,RW,1975
34573,2,25,Ted Scharf,0,5,2,RW,1976
34574,12,27,Ted Snell,4,55,16,RW,1973
34575,6,28,Ted Snell,3,49,9,RW,1974
34576,1,25,Ted Speers,1,4,2,C,1985
34577,5,25,Ted Taylor,3,31,8,LW,1967
34578,16,28,Ted Taylor,11,56,27,LW,1970
34579,13,29,Ted Taylor,9,69,22,LW,1971
34580,42,30,Ted Taylor,34,73,76,RW,1972
34581,23,31,Ted Taylor,21,75,44,RW,1973
34582,27,32,Ted Taylor,26,73,53,LW,1974
34583,26,33,Ted Taylor,15,68,41,LW,1975
34584,35,34,Ted Taylor,16,78,51,LW,1976
34585,11,35,Ted Taylor,11,54,22,LW,1977
34586,2,22,Teddy Purcell,1,10,3,RW,2007
34587,12,23,Teddy Purcell,4,40,16,RW,2008
34588,9,24,Teddy Purcell,6,60,15,RW,2009
34589,34,25,Teddy Purcell,17,81,51,RW,2010
34590,41,26,Teddy Purcell,24,81,65,RW,2011
34591,25,27,Teddy Purcell,11,48,36,RW,2012
34592,30,28,Teddy Purcell,12,81,42,RW,2013
34593,22,29,Teddy Purcell,12,82,34,RW,2014
34594,29,30,Teddy Purcell,14,76,43,RW,2015
34595,2,31,Teddy Purcell,0,12,2,LW,2016
34596,2,20,Teemu Hartikainen,3,12,5,LW,2010
34597,3,21,Teemu Hartikainen,2,17,5,LW,2011
34598,2,22,Teemu Hartikainen,1,23,3,LW,2012
34599,0,22,Teemu Laakso,0,7,0,D,2009
34600,0,23,Teemu Laakso,0,1,0,D,2010
34601,0,24,Teemu Laakso,0,9,0,D,2011
34602,0,22,Teemu Pulkkinen,0,3,0,RW,2013
34603,3,23,Teemu Pulkkinen,5,31,8,LW,2014
34604,6,24,Teemu Pulkkinen,6,36,12,LW,2015
34605,0,25,Teemu Pulkkinen,1,4,1,LW,2016
34606,56,22,Teemu Selanne,76,84,132,RW,1992
34607,29,23,Teemu Selanne,25,51,54,RW,1993
34608,26,24,Teemu Selanne,22,45,48,RW,1994
34609,68,25,Teemu Selanne,40,79,108,RW,1995
34610,58,26,Teemu Selanne,51,78,109,RW,1996
34611,34,27,Teemu Selanne,52,73,86,RW,1997
34612,60,28,Teemu Selanne,47,75,107,RW,1998
34613,52,29,Teemu Selanne,33,79,85,RW,1999
34614,39,30,Teemu Selanne,33,73,72,RW,2000
34615,25,31,Teemu Selanne,29,82,54,RW,2001
34616,36,32,Teemu Selanne,28,82,64,RW,2002
34617,16,33,Teemu Selanne,16,78,32,RW,2003
34618,50,35,Teemu Selanne,40,80,90,RW,2005
34619,46,36,Teemu Selanne,48,82,94,RW,2006
34620,11,37,Teemu Selanne,12,26,23,RW,2007
34621,27,38,Teemu Selanne,27,65,54,RW,2008
34622,21,39,Teemu Selanne,27,54,48,RW,2009
34623,49,40,Teemu Selanne,31,73,80,RW,2010
34624,40,41,Teemu Selanne,26,82,66,RW,2011
34625,12,42,Teemu Selanne,12,46,24,RW,2012
34626,18,43,Teemu Selanne,9,64,27,RW,2013
34627,14,20,Teppo Numminen,1,69,15,D,1988
34628,32,21,Teppo Numminen,11,79,43,D,1989
34629,25,22,Teppo Numminen,8,80,33,D,1990
34630,34,23,Teppo Numminen,5,80,39,D,1991
34631,30,24,Teppo Numminen,7,66,37,D,1992
34632,18,25,Teppo Numminen,5,57,23,D,1993
34633,16,26,Teppo Numminen,5,42,21,D,1994
34634,43,27,Teppo Numminen,11,74,54,D,1995
34635,25,28,Teppo Numminen,2,82,27,D,1996
34636,40,29,Teppo Numminen,11,82,51,D,1997
34637,30,30,Teppo Numminen,10,82,40,D,1998
34638,34,31,Teppo Numminen,8,79,42,D,1999
34639,26,32,Teppo Numminen,5,72,31,D,2000
34640,35,33,Teppo Numminen,13,76,48,D,2001
34641,24,34,Teppo Numminen,6,78,30,D,2002
34642,14,35,Teppo Numminen,3,62,17,D,2003
34643,38,37,Teppo Numminen,2,75,40,D,2005
34644,27,38,Teppo Numminen,2,79,29,D,2006
34645,0,39,Teppo Numminen,0,1,0,D,2007
34646,15,40,Teppo Numminen,2,57,17,D,2008
34647,0,25,Terran Sandwith,0,8,0,D,1997
34648,0,23,Terry Ball,0,1,0,D,1967
34649,18,25,Terry Ball,7,61,25,D,1969
34650,0,26,Terry Ball,0,2,0,D,1970
34651,1,27,Terry Ball,0,10,1,D,1971
34652,34,28,Terry Ball,6,78,40,D,1972
34653,28,29,Terry Ball,8,71,36,D,1973
34654,37,30,Terry Ball,8,76,45,D,1974
34655,29,31,Terry Ball,5,59,34,D,1975
34656,6,32,Terry Ball,1,23,7,D,1976
34657,0,20,Terry Caffery,0,6,0,C,1969
34658,0,21,Terry Caffery,0,8,0,C,1970
34659,61,23,Terry Caffery,39,74,100,C,1972
34660,37,25,Terry Caffery,15,67,52,C,1974
34661,13,26,Terry Caffery,5,23,18,C,1975
34662,13,20,Terry Carkner,2,52,15,D,1986
34663,24,21,Terry Carkner,3,63,27,D,1987
34664,32,22,Terry Carkner,11,78,43,D,1988
34665,18,23,Terry Carkner,4,63,22,D,1989
34666,25,24,Terry Carkner,7,79,32,D,1990
34667,12,25,Terry Carkner,4,73,16,D,1991
34668,16,26,Terry Carkner,3,83,19,D,1992
34669,6,27,Terry Carkner,1,68,7,D,1993
34670,2,28,Terry Carkner,1,20,3,D,1994
34671,10,29,Terry Carkner,3,73,13,D,1995
34672,14,30,Terry Carkner,0,70,14,D,1996
34673,7,31,Terry Carkner,1,74,8,D,1997
34674,9,32,Terry Carkner,2,62,11,D,1998
34675,0,24,Terry Clancy,0,7,0,RW,1967
34676,0,25,Terry Clancy,0,2,0,RW,1968
34677,5,26,Terry Clancy,6,52,11,RW,1969
34678,1,29,Terry Clancy,0,32,1,RW,1972
34679,20,24,Terry Crisp,9,73,29,C,1967
34680,9,25,Terry Crisp,6,57,15,C,1968
34681,6,26,Terry Crisp,5,26,11,C,1969
34682,11,27,Terry Crisp,5,54,16,C,1970
34683,18,28,Terry Crisp,13,75,31,C,1971
34684,21,29,Terry Crisp,5,66,26,C,1972
34685,21,30,Terry Crisp,10,71,31,C,1973
34686,19,31,Terry Crisp,8,71,27,C,1974
34687,9,32,Terry Crisp,6,38,15,C,1975
34688,0,33,Terry Crisp,0,2,0,C,1976
34689,16,29,Terry Gray,12,65,28,RW,1967
34690,0,30,Terry Gray,4,8,4,RW,1968
34691,5,31,Terry Gray,2,28,7,RW,1969
34692,8,28,Terry Harper,3,57,11,D,1967
34693,3,29,Terry Harper,0,21,3,D,1968
34694,18,30,Terry Harper,4,75,22,D,1969
34695,21,31,Terry Harper,1,78,22,D,1970
34696,12,32,Terry Harper,2,52,14,D,1971
34697,8,33,Terry Harper,1,77,9,D,1972
34698,17,34,Terry Harper,0,77,17,D,1973
34699,21,35,Terry Harper,5,80,26,D,1974
34700,25,36,Terry Harper,8,69,33,D,1975
34701,8,37,Terry Harper,4,52,12,D,1976
34702,17,38,Terry Harper,2,80,19,D,1977
34703,6,39,Terry Harper,0,51,6,D,1978
34704,5,40,Terry Harper,1,11,6,D,1979
34705,2,41,Terry Harper,0,15,2,D,1980
34706,3,22,Terry Holbrook,2,21,5,RW,1972
34707,3,23,Terry Holbrook,1,22,4,RW,1973
34708,13,24,Terry Holbrook,10,78,23,RW,1974
34709,2,25,Terry Holbrook,1,15,3,RW,1975
34710,0,22,Terry Hollinger,0,2,0,D,1993
34711,0,23,Terry Hollinger,0,5,0,D,1994
34712,0,21,Terry Johnson,0,3,0,D,1979
34713,1,22,Terry Johnson,0,13,1,D,1980
34714,1,23,Terry Johnson,0,6,1,D,1981
34715,0,24,Terry Johnson,0,3,0,D,1982
34716,6,25,Terry Johnson,2,65,8,D,1983
34717,7,26,Terry Johnson,0,74,7,D,1984
34718,8,27,Terry Johnson,1,73,9,D,1985
34719,1,28,Terry Johnson,0,48,1,D,1986
34720,0,20,Terry Martin,0,1,0,LW,1975
34721,12,21,Terry Martin,11,62,23,LW,1976
34722,2,22,Terry Martin,3,21,5,LW,1977
34723,8,23,Terry Martin,6,64,14,LW,1978
34724,15,24,Terry Martin,6,40,21,LW,1979
34725,14,25,Terry Martin,23,69,37,LW,1980
34726,24,26,Terry Martin,25,72,49,LW,1981
34727,13,27,Terry Martin,14,76,27,LW,1982
34728,10,28,Terry Martin,15,63,25,LW,1983
34729,3,29,Terry Martin,1,11,4,LW,1984
34730,1,20,Terry McDonald,0,8,1,D,1975
34731,3,22,Terry Murray,0,23,3,D,1972
34732,12,23,Terry Murray,0,58,12,D,1973
34733,2,24,Terry Murray,0,9,2,D,1974
34734,0,25,Terry Murray,0,3,0,D,1975
34735,20,26,Terry Murray,0,59,20,D,1976
34736,0,28,Terry Murray,0,5,0,D,1978
34737,17,30,Terry Murray,1,71,18,D,1980
34738,22,31,Terry Murray,3,74,25,D,1981
34739,0,20,Terry O'Reilly,1,1,1,RW,1971
34740,22,21,Terry O'Reilly,5,72,27,RW,1972
34741,24,22,Terry O'Reilly,11,76,35,RW,1973
34742,20,23,Terry O'Reilly,15,68,35,RW,1974
34743,27,24,Terry O'Reilly,23,80,50,RW,1975
34744,41,25,Terry O'Reilly,14,79,55,RW,1976
34745,61,26,Terry O'Reilly,29,77,90,RW,1977
34746,51,27,Terry O'Reilly,26,80,77,RW,1978
34747,42,28,Terry O'Reilly,19,71,61,RW,1979
34748,35,29,Terry O'Reilly,8,77,43,RW,1980
34749,30,30,Terry O'Reilly,22,70,52,RW,1981
34750,14,31,Terry O'Reilly,6,19,20,RW,1982
34751,18,32,Terry O'Reilly,12,58,30,RW,1983
34752,17,33,Terry O'Reilly,13,63,30,RW,1984
34753,36,20,Terry Ruskowski,10,71,46,C,1974
34754,35,21,Terry Ruskowski,14,65,49,C,1975
34755,60,22,Terry Ruskowski,24,80,84,C,1976
34756,57,23,Terry Ruskowski,15,78,72,C,1977
34757,66,24,Terry Ruskowski,20,75,86,C,1978
34758,55,25,Terry Ruskowski,15,74,70,C,1979
34759,51,26,Terry Ruskowski,8,72,59,C,1980
34760,30,27,Terry Ruskowski,7,60,37,C,1981
34761,32,28,Terry Ruskowski,14,76,46,C,1982
34762,25,29,Terry Ruskowski,7,77,32,C,1983
34763,33,30,Terry Ruskowski,16,78,49,LW,1984
34764,37,31,Terry Ruskowski,26,73,63,LW,1985
34765,37,32,Terry Ruskowski,14,70,51,LW,1986
34766,12,33,Terry Ruskowski,5,47,17,LW,1987
34767,1,34,Terry Ruskowski,1,3,2,C,1988
34768,6,20,Terry Ryan,13,76,19,C,1972
34769,0,20,Terry Ryan,0,3,0,LW,1996
34770,0,21,Terry Ryan,0,4,0,LW,1997
34771,0,22,Terry Ryan,0,1,0,LW,1998
34772,0,28,Terry Virtue,0,4,0,D,1998
34773,0,29,Terry Virtue,0,1,0,D,1999
34774,0,20,Terry Yake,0,2,0,C,1988
34775,1,21,Terry Yake,0,2,1,C,1989
34776,4,22,Terry Yake,1,19,5,C,1990
34777,1,23,Terry Yake,1,15,2,C,1991
34778,31,24,Terry Yake,22,66,53,RW,1992
34779,31,25,Terry Yake,21,82,52,RW,1993
34780,2,26,Terry Yake,3,19,5,RW,1994
34781,15,29,Terry Yake,10,65,25,C,1997
34782,18,30,Terry Yake,9,60,27,RW,1998
34783,14,31,Terry Yake,10,61,24,RW,1999
34784,3,32,Terry Yake,0,12,3,RW,2000
34785,0,19,Teuvo Teravainen,0,3,0,C,2013
34786,5,20,Teuvo Teravainen,4,34,9,C,2014
34787,22,21,Teuvo Teravainen,13,78,35,C,2015
34788,27,22,Teuvo Teravainen,15,81,42,LW,2016
34789,41,23,Teuvo Teravainen,23,82,64,LW,2017
34790,0,20,Theo Peckham,0,1,0,D,2007
34791,0,21,Theo Peckham,0,15,0,D,2008
34792,1,22,Theo Peckham,0,15,1,D,2009
34793,10,23,Theo Peckham,3,71,13,D,2010
34794,2,24,Theo Peckham,1,54,3,D,2011
34795,0,25,Theo Peckham,0,4,0,D,2012
34796,20,20,Theoren Fleury,14,36,34,C,1988
34797,35,21,Theoren Fleury,31,80,66,RW,1989
34798,53,22,Theoren Fleury,51,79,104,RW,1990
34799,40,23,Theoren Fleury,33,80,73,RW,1991
34800,66,24,Theoren Fleury,34,83,100,RW,1992
34801,45,25,Theoren Fleury,40,83,85,RW,1993
34802,29,26,Theoren Fleury,29,47,58,RW,1994
34803,50,27,Theoren Fleury,46,80,96,RW,1995
34804,38,28,Theoren Fleury,29,81,67,RW,1996
34805,51,29,Theoren Fleury,27,82,78,RW,1997
34806,53,30,Theoren Fleury,40,75,93,RW,1998
34807,49,31,Theoren Fleury,15,80,64,RW,1999
34808,44,32,Theoren Fleury,30,62,74,RW,2000
34809,39,33,Theoren Fleury,24,82,63,LW,2001
34810,21,34,Theoren Fleury,12,54,33,LW,2002
34811,0,20,Thomas Chabot,0,1,0,D,2016
34812,16,21,Thomas Chabot,9,63,25,D,2017
34813,10,21,Thomas Eriksson,1,24,11,D,1980
34814,0,22,Thomas Eriksson,0,1,0,D,1981
34815,33,24,Thomas Eriksson,11,68,44,D,1983
34816,29,25,Thomas Eriksson,10,72,39,D,1984
34817,4,26,Thomas Eriksson,0,43,4,D,1985
34818,31,22,Thomas Gradin,20,76,51,C,1978
34819,45,23,Thomas Gradin,30,80,75,C,1979
34820,48,24,Thomas Gradin,21,79,69,C,1980
34821,49,25,Thomas Gradin,37,76,86,C,1981
34822,54,26,Thomas Gradin,32,80,86,C,1982
34823,57,27,Thomas Gradin,21,75,78,C,1983
34824,42,28,Thomas Gradin,22,76,64,C,1984
34825,27,29,Thomas Gradin,14,71,41,C,1985
34826,31,30,Thomas Gradin,12,64,43,C,1986
34827,3,23,Thomas Hickey,1,39,4,D,2012
34828,18,24,Thomas Hickey,4,82,22,D,2013
34829,20,25,Thomas Hickey,2,81,22,D,2014
34830,11,26,Thomas Hickey,6,62,17,D,2015
34831,16,27,Thomas Hickey,4,76,20,D,2016
34832,20,28,Thomas Hickey,5,69,25,D,2017
34833,2,22,Thomas Pock,2,6,4,D,2003
34834,1,24,Thomas Pock,1,8,2,D,2005
34835,4,25,Thomas Pock,4,44,8,D,2006
34836,0,26,Thomas Pock,0,1,0,D,2007
34837,2,27,Thomas Pock,1,59,3,D,2008
34838,1,24,Thomas Rundqvist,0,2,1,C,1984
34839,29,21,Thomas Steen,15,73,44,C,1981
34840,33,22,Thomas Steen,26,75,59,C,1982
34841,45,23,Thomas Steen,20,78,65,C,1983
34842,54,24,Thomas Steen,30,79,84,C,1984
34843,47,25,Thomas Steen,17,78,64,C,1985
34844,33,26,Thomas Steen,17,75,50,C,1986
34845,38,27,Thomas Steen,16,76,54,C,1987
34846,61,28,Thomas Steen,27,80,88,C,1988
34847,48,29,Thomas Steen,18,53,66,C,1989
34848,48,30,Thomas Steen,19,58,67,C,1990
34849,25,31,Thomas Steen,13,38,38,C,1991
34850,50,32,Thomas Steen,22,80,72,C,1992
34851,32,33,Thomas Steen,19,76,51,C,1993
34852,10,34,Thomas Steen,5,31,15,C,1994
34853,23,22,Thomas Vanek,25,81,48,LW,2005
34854,41,23,Thomas Vanek,43,82,84,LW,2006
34855,28,24,Thomas Vanek,36,82,64,LW,2007
34856,24,25,Thomas Vanek,40,73,64,LW,2008
34857,25,26,Thomas Vanek,28,71,53,LW,2009
34858,41,27,Thomas Vanek,32,80,73,LW,2010
34859,35,28,Thomas Vanek,26,78,61,LW,2011
34860,21,29,Thomas Vanek,20,38,41,LW,2012
34861,41,30,Thomas Vanek,27,78,68,LW,2013
34862,31,31,Thomas Vanek,21,80,52,LW,2014
34863,23,32,Thomas Vanek,18,74,41,LW,2015
34864,8,33,Thomas Vanek,2,20,10,LW,2016
34865,8,34,Thomas Vanek,7,19,15,LW,2017
34866,0,22,Thomas Ziegler,0,5,0,C,2000
34867,12,25,Thommie Bergman,9,75,21,D,1972
34868,3,26,Thommie Bergman,0,43,3,D,1973
34869,1,27,Thommie Bergman,0,18,1,D,1974
34870,15,27,Thommie Bergman,4,49,19,D,1974
34871,30,28,Thommie Bergman,11,81,41,D,1975
34872,24,29,Thommie Bergman,2,42,26,D,1976
34873,6,30,Thommie Bergman,1,14,7,D,1977
34874,28,30,Thommie Bergman,5,62,33,D,1977
34875,17,31,Thommie Bergman,10,68,27,D,1978
34876,5,32,Thommie Bergman,1,28,6,D,1979
34877,22,27,Thommy Abrahamsson,8,76,30,D,1974
34878,21,28,Thommy Abrahamsson,14,63,35,D,1975
34879,24,29,Thommy Abrahamsson,6,64,30,D,1976
34880,11,33,Thommy Abrahamsson,6,32,17,D,1980
34881,0,20,Tie Domi,0,2,0,RW,1989
34882,0,21,Tie Domi,1,28,1,RW,1990
34883,4,22,Tie Domi,2,42,6,RW,1991
34884,10,23,Tie Domi,5,61,15,RW,1992
34885,11,24,Tie Domi,8,81,19,RW,1993
34886,5,25,Tie Domi,4,40,9,RW,1994
34887,6,26,Tie Domi,7,72,13,RW,1995
34888,17,27,Tie Domi,11,80,28,RW,1996
34889,10,28,Tie Domi,4,80,14,RW,1997
34890,14,29,Tie Domi,8,72,22,RW,1998
34891,9,30,Tie Domi,5,70,14,RW,1999
34892,7,31,Tie Domi,13,82,20,RW,2000
34893,10,32,Tie Domi,9,74,19,RW,2001
34894,14,33,Tie Domi,15,79,29,RW,2002
34895,13,34,Tie Domi,7,80,20,RW,2003
34896,11,36,Tie Domi,5,77,16,RW,2005
34897,19,20,Tiger Williams,10,42,29,LW,1974
34898,19,21,Tiger Williams,21,78,40,LW,1975
34899,25,22,Tiger Williams,18,77,43,LW,1976
34900,31,23,Tiger Williams,19,78,50,LW,1977
34901,20,24,Tiger Williams,19,77,39,LW,1978
34902,23,25,Tiger Williams,30,78,53,LW,1979
34903,27,26,Tiger Williams,35,77,62,LW,1980
34904,21,27,Tiger Williams,17,77,38,LW,1981
34905,13,28,Tiger Williams,8,68,21,LW,1982
34906,16,29,Tiger Williams,15,67,31,LW,1983
34907,11,30,Tiger Williams,7,67,18,LW,1984
34908,29,31,Tiger Williams,20,72,49,LW,1985
34909,18,32,Tiger Williams,16,76,34,LW,1986
34910,0,33,Tiger Williams,6,28,6,LW,1987
34911,0,21,Tim Armstrong,1,11,1,C,1988
34912,5,25,Tim Bergland,2,32,7,C,1989
34913,9,26,Tim Bergland,5,47,14,C,1990
34914,4,27,Tim Bergland,1,22,5,C,1991
34915,3,28,Tim Bergland,3,27,6,RW,1992
34916,5,29,Tim Bergland,6,54,11,RW,1993
34917,0,23,Tim Bothwell,0,1,0,D,1978
34918,6,24,Tim Bothwell,4,45,10,D,1979
34919,1,25,Tim Bothwell,0,3,1,D,1980
34920,3,26,Tim Bothwell,0,13,3,D,1981
34921,11,27,Tim Bothwell,4,61,15,D,1982
34922,13,28,Tim Bothwell,2,62,15,D,1983
34923,22,29,Tim Bothwell,4,79,26,D,1984
34924,8,30,Tim Bothwell,2,62,10,D,1985
34925,16,31,Tim Bothwell,6,76,22,D,1986
34926,13,32,Tim Bothwell,6,78,19,D,1987
34927,0,33,Tim Bothwell,0,22,0,D,1988
34928,0,22,Tim Brent,1,15,1,C,2006
34929,0,23,Tim Brent,0,1,0,C,2007
34930,0,24,Tim Brent,0,2,0,C,2008
34931,0,25,Tim Brent,0,1,0,C,2009
34932,12,26,Tim Brent,8,79,20,C,2010
34933,12,27,Tim Brent,12,79,24,C,2011
34934,3,28,Tim Brent,0,30,3,C,2012
34935,5,25,Tim Conboy,0,19,5,D,2007
34936,1,26,Tim Conboy,0,28,1,RW,2008
34937,0,27,Tim Conboy,0,12,0,D,2009
34938,20,18,Tim Connolly,14,81,34,C,1999
34939,31,19,Tim Connolly,10,82,41,C,2000
34940,35,20,Tim Connolly,10,82,45,C,2001
34941,13,21,Tim Connolly,12,80,25,C,2002
34942,39,24,Tim Connolly,16,63,55,C,2005
34943,0,25,Tim Connolly,1,2,1,C,2006
34944,33,26,Tim Connolly,7,48,40,C,2007
34945,29,27,Tim Connolly,18,48,47,C,2008
34946,48,28,Tim Connolly,17,73,65,C,2009
34947,29,29,Tim Connolly,13,68,42,C,2010
34948,23,30,Tim Connolly,13,70,36,C,2011
34949,2,21,Tim Coulis,1,19,3,LW,1979
34950,0,25,Tim Coulis,0,2,0,LW,1983
34951,1,26,Tim Coulis,1,7,2,LW,1984
34952,2,27,Tim Coulis,2,19,4,LW,1985
34953,8,20,Tim Ecclestone,6,50,14,RW,1967
34954,23,21,Tim Ecclestone,11,68,34,LW,1968
34955,21,22,Tim Ecclestone,16,65,37,RW,1969
34956,34,23,Tim Ecclestone,19,74,53,LW,1970
34957,35,24,Tim Ecclestone,18,72,53,RW,1971
34958,30,25,Tim Ecclestone,18,78,48,RW,1972
34959,19,26,Tim Ecclestone,9,60,28,RW,1973
34960,22,27,Tim Ecclestone,14,67,36,RW,1974
34961,21,28,Tim Ecclestone,6,69,27,RW,1975
34962,18,29,Tim Ecclestone,9,78,27,LW,1976
34963,2,30,Tim Ecclestone,0,11,2,RW,1977
34964,2,20,Tim Erixon,0,18,2,D,2011
34965,5,21,Tim Erixon,0,31,5,D,2012
34966,0,22,Tim Erixon,0,2,0,D,2013
34967,5,23,Tim Erixon,2,42,7,D,2014
34968,3,24,Tim Friday,0,23,3,D,1985
34969,7,21,Tim Gleason,0,47,7,D,2003
34970,19,23,Tim Gleason,2,78,21,D,2005
34971,4,24,Tim Gleason,2,57,6,D,2006
34972,16,25,Tim Gleason,3,80,19,D,2007
34973,12,26,Tim Gleason,0,70,12,D,2008
34974,14,27,Tim Gleason,5,61,19,D,2009
34975,14,28,Tim Gleason,2,82,16,D,2010
34976,17,29,Tim Gleason,1,82,18,D,2011
34977,9,30,Tim Gleason,0,42,9,D,2012
34978,5,31,Tim Gleason,1,56,6,D,2013
34979,8,32,Tim Gleason,1,72,9,D,2014
34980,0,25,Tim Harrer,0,3,0,RW,1982
34981,0,26,Tim Heed,0,1,0,D,2016
34982,8,27,Tim Heed,3,29,11,D,2017
34983,16,20,Tim Higgins,7,36,23,RW,1978
34984,12,21,Tim Higgins,13,74,25,RW,1979
34985,35,22,Tim Higgins,24,78,59,RW,1980
34986,30,23,Tim Higgins,20,74,50,RW,1981
34987,9,24,Tim Higgins,14,64,23,RW,1982
34988,14,25,Tim Higgins,19,69,33,RW,1983
34989,29,26,Tim Higgins,19,71,48,RW,1984
34990,17,27,Tim Higgins,9,59,26,RW,1985
34991,14,28,Tim Higgins,12,77,26,RW,1986
34992,13,29,Tim Higgins,12,62,25,RW,1987
34993,9,30,Tim Higgins,5,42,14,RW,1988
34994,23,38,Tim Horton,4,69,27,D,1967
34995,29,39,Tim Horton,11,74,40,D,1968
34996,24,40,Tim Horton,4,74,28,D,1969
34997,18,41,Tim Horton,2,78,20,D,1970
34998,9,42,Tim Horton,2,44,11,D,1971
34999,16,43,Tim Horton,1,69,17,D,1972
35000,6,44,Tim Horton,0,55,6,D,1973
35001,3,19,Tim Hrynewich,2,30,5,LW,1982
35002,5,20,Tim Hrynewich,4,25,9,LW,1983
35003,0,21,Tim Hunter,0,2,0,D,1981
35004,0,22,Tim Hunter,1,16,1,D,1982
35005,4,23,Tim Hunter,4,43,8,D,1983
35006,11,24,Tim Hunter,11,71,22,RW,1984
35007,7,25,Tim Hunter,8,66,15,RW,1985
35008,15,26,Tim Hunter,6,73,21,RW,1986
35009,5,27,Tim Hunter,8,68,13,RW,1987
35010,9,28,Tim Hunter,3,75,12,RW,1988
35011,3,29,Tim Hunter,2,67,5,RW,1989
35012,2,30,Tim Hunter,5,34,7,RW,1990
35013,3,31,Tim Hunter,1,30,4,RW,1991
35014,7,32,Tim Hunter,5,74,12,RW,1992
35015,4,33,Tim Hunter,3,56,7,RW,1993
35016,2,34,Tim Hunter,3,34,5,RW,1994
35017,0,35,Tim Hunter,2,60,2,RW,1995
35018,4,36,Tim Hunter,0,46,4,LW,1996
35019,2,22,Tim Jackman,1,19,3,RW,2003
35020,0,24,Tim Jackman,0,8,0,RW,2005
35021,0,25,Tim Jackman,0,5,0,RW,2006
35022,3,26,Tim Jackman,1,36,4,RW,2007
35023,7,27,Tim Jackman,5,69,12,RW,2008
35024,5,28,Tim Jackman,4,54,9,RW,2009
35025,13,29,Tim Jackman,10,82,23,RW,2010
35026,6,30,Tim Jackman,1,75,7,RW,2011
35027,4,31,Tim Jackman,1,42,5,RW,2012
35028,1,32,Tim Jackman,4,36,5,RW,2013
35029,2,33,Tim Jackman,5,55,7,RW,2014
35030,0,34,Tim Jackman,0,2,0,RW,2015
35031,10,23,Tim Jacobs,0,46,10,D,1975
35032,0,22,Tim Kennedy,0,1,0,LW,2008
35033,16,23,Tim Kennedy,10,78,26,LW,2009
35034,1,24,Tim Kennedy,0,6,1,LW,2010
35035,1,25,Tim Kennedy,1,27,2,LW,2011
35036,0,26,Tim Kennedy,2,13,2,LW,2012
35037,6,27,Tim Kennedy,2,37,8,LW,2013
35038,23,21,Tim Kerr,22,68,45,C,1980
35039,30,22,Tim Kerr,21,61,51,RW,1981
35040,8,23,Tim Kerr,11,24,19,RW,1982
35041,39,24,Tim Kerr,54,79,93,RW,1983
35042,44,25,Tim Kerr,54,74,98,RW,1984
35043,26,26,Tim Kerr,58,76,84,RW,1985
35044,37,27,Tim Kerr,58,75,95,RW,1986
35045,2,28,Tim Kerr,3,8,5,RW,1987
35046,40,29,Tim Kerr,48,69,88,RW,1988
35047,24,30,Tim Kerr,24,40,48,RW,1989
35048,14,31,Tim Kerr,10,27,24,RW,1990
35049,11,32,Tim Kerr,7,32,18,RW,1991
35050,6,33,Tim Kerr,0,22,6,RW,1992
35051,1,24,Tim Lenardon,1,7,2,C,1986
35052,0,27,Tim Lenardon,1,8,1,C,1989
35053,0,23,Tim Ramholt,0,1,0,D,2007
35054,1,24,Tim Schaller,1,18,2,C,2014
35055,2,25,Tim Schaller,1,17,3,C,2015
35056,7,26,Tim Schaller,7,59,14,C,2016
35057,10,27,Tim Schaller,12,82,22,C,2017
35058,0,24,Tim Sestito,0,1,0,LW,2008
35059,1,25,Tim Sestito,0,9,1,LW,2009
35060,2,26,Tim Sestito,0,36,2,LW,2010
35061,0,27,Tim Sestito,0,18,0,LW,2011
35062,0,28,Tim Sestito,0,6,0,LW,2012
35063,3,29,Tim Sestito,0,16,3,LW,2013
35064,2,30,Tim Sestito,0,15,2,LW,2014
35065,38,24,Tim Sheehy,33,78,71,C,1972
35066,33,26,Tim Sheehy,29,81,62,RW,1974
35067,13,26,Tim Sheehy,21,52,34,RW,1974
35068,31,27,Tim Sheehy,34,81,65,RW,1975
35069,29,28,Tim Sheehy,41,78,70,RW,1976
35070,21,28,Tim Sheehy,26,50,47,RW,1976
35071,8,28,Tim Sheehy,15,28,23,RW,1976
35072,0,29,Tim Sheehy,0,15,0,RW,1977
35073,11,29,Tim Sheehy,8,25,19,RW,1977
35074,2,29,Tim Sheehy,4,13,6,RW,1977
35075,1,31,Tim Sheehy,2,12,3,RW,1979
35076,0,26,Tim Stapleton,1,4,1,RW,2008
35077,0,27,Tim Stapleton,2,6,2,C,2009
35078,2,28,Tim Stapleton,5,45,7,C,2010
35079,16,29,Tim Stapleton,11,63,27,C,2011
35080,9,23,Tim Sweeney,7,42,16,LW,1990
35081,2,24,Tim Sweeney,1,11,3,LW,1991
35082,7,25,Tim Sweeney,1,14,8,LW,1992
35083,27,26,Tim Sweeney,16,78,43,LW,1993
35084,1,27,Tim Sweeney,1,13,2,LW,1994
35085,8,28,Tim Sweeney,8,41,16,LW,1995
35086,11,29,Tim Sweeney,10,36,21,LW,1996
35087,18,30,Tim Sweeney,11,56,29,RW,1997
35088,0,24,Tim Taylor,1,1,1,C,1993
35089,4,25,Tim Taylor,0,22,4,C,1994
35090,14,26,Tim Taylor,11,72,25,C,1995
35091,4,27,Tim Taylor,3,44,7,C,1996
35092,11,28,Tim Taylor,20,79,31,C,1997
35093,7,29,Tim Taylor,4,49,11,C,1998
35094,11,30,Tim Taylor,9,76,20,C,1999
35095,5,31,Tim Taylor,2,38,7,C,2000
35096,4,32,Tim Taylor,4,48,8,C,2001
35097,8,33,Tim Taylor,4,82,12,C,2002
35098,15,34,Tim Taylor,7,82,22,C,2003
35099,6,36,Tim Taylor,7,82,13,C,2005
35100,5,37,Tim Taylor,1,71,6,C,2006
35101,13,20,Tim Tookey,10,29,23,C,1980
35102,8,21,Tim Tookey,8,28,16,C,1981
35103,6,22,Tim Tookey,1,12,7,C,1982
35104,2,23,Tim Tookey,0,8,2,C,1983
35105,0,26,Tim Tookey,0,2,0,C,1986
35106,6,27,Tim Tookey,1,20,7,C,1987
35107,1,28,Tim Tookey,2,7,3,C,1988
35108,10,20,Tim Trimper,6,30,16,LW,1979
35109,14,21,Tim Trimper,15,56,29,LW,1980
35110,8,22,Tim Trimper,8,74,16,LW,1981
35111,0,23,Tim Trimper,0,5,0,LW,1982
35112,0,24,Tim Trimper,0,5,0,LW,1983
35113,4,25,Tim Trimper,1,20,5,LW,1984
35114,2,24,Tim Wallace,0,16,2,RW,2008
35115,0,25,Tim Wallace,0,1,0,RW,2009
35116,0,26,Tim Wallace,0,7,0,RW,2010
35117,6,27,Tim Wallace,3,49,9,RW,2011
35118,1,28,Tim Wallace,1,28,2,RW,2012
35119,22,22,Tim Watters,2,69,24,D,1981
35120,18,23,Tim Watters,5,77,23,D,1982
35121,20,24,Tim Watters,3,74,23,D,1983
35122,20,25,Tim Watters,2,63,22,D,1984
35123,8,26,Tim Watters,6,56,14,D,1985
35124,13,27,Tim Watters,3,63,16,D,1986
35125,0,28,Tim Watters,0,36,0,D,1987
35126,18,29,Tim Watters,3,76,21,D,1988
35127,10,30,Tim Watters,1,62,11,D,1989
35128,4,31,Tim Watters,0,45,4,D,1990
35129,7,32,Tim Watters,0,37,7,D,1991
35130,2,33,Tim Watters,0,22,2,D,1992
35131,9,34,Tim Watters,1,60,10,D,1993
35132,0,35,Tim Watters,0,1,0,D,1994
35133,33,20,Tim Young,18,63,51,C,1975
35134,66,21,Tim Young,29,80,95,C,1976
35135,35,22,Tim Young,23,78,58,C,1977
35136,32,23,Tim Young,24,73,56,C,1978
35137,43,24,Tim Young,31,77,74,C,1979
35138,41,25,Tim Young,25,74,66,C,1980
35139,31,26,Tim Young,10,49,41,C,1981
35140,35,27,Tim Young,18,70,53,C,1982
35141,19,28,Tim Young,15,44,34,C,1983
35142,6,29,Tim Young,2,20,8,C,1984
35143,11,21,Timo Blomqvist,1,44,12,D,1981
35144,17,22,Timo Blomqvist,1,61,18,D,1982
35145,19,23,Timo Blomqvist,1,65,20,D,1983
35146,4,24,Timo Blomqvist,1,53,5,D,1984
35147,2,26,Timo Blomqvist,0,20,2,D,1986
35148,1,24,Timo Helbling,0,9,1,D,2005
35149,0,25,Timo Helbling,0,2,0,D,2006
35150,5,21,Timo Jutila,1,10,6,D,1984
35151,3,20,Timo Meier,3,34,6,RW,2016
35152,15,21,Timo Meier,21,81,36,RW,2017
35153,3,25,Timo Parssinen,0,17,3,LW,2001
35154,0,20,Timofei Shishkanov,0,2,0,LW,2003
35155,2,22,Timofei Shishkanov,3,22,5,RW,2005
34404,1,25,TJ Brennan,0,6,1,D,2014
34405,30,24,TJ Brodie,11,81,41,D,2014
34406,0,26,TJ Galiardi,1,38,1,LW,2014
35156,2,20,Tobias Lindberg,0,6,2,RW,2015
35157,8,22,Tobias Rieder,13,72,21,RW,2014
35158,23,23,Tobias Rieder,14,82,37,RW,2015
35159,18,24,Tobias Rieder,16,80,34,RW,2016
35160,2,25,Tobias Rieder,4,20,6,RW,2017
35161,33,23,Toby Enstrom,5,82,38,D,2007
35162,27,24,Toby Enstrom,5,82,32,D,2008
35163,44,25,Toby Enstrom,6,82,50,D,2009
35164,41,26,Toby Enstrom,10,72,51,D,2010
35165,27,27,Toby Enstrom,6,62,33,D,2011
35166,11,28,Toby Enstrom,4,22,15,D,2012
35167,20,29,Toby Enstrom,10,82,30,D,2013
35168,19,30,Toby Enstrom,4,60,23,D,2014
35169,14,31,Toby Enstrom,2,72,16,D,2015
35170,13,32,Toby Enstrom,1,60,14,D,2016
35171,5,33,Toby Enstrom,1,43,6,D,2017
35172,6,22,Toby Petersen,2,12,8,C,2000
35173,10,23,Toby Petersen,8,79,18,RW,2001
35174,9,28,Toby Petersen,6,64,15,C,2006
35175,3,29,Toby Petersen,0,8,3,C,2007
35176,7,30,Toby Petersen,4,57,11,C,2008
35177,6,31,Toby Petersen,9,78,15,C,2009
35178,4,32,Toby Petersen,2,60,6,C,2010
35179,3,33,Toby Petersen,2,39,5,C,2011
35180,0,34,Toby Petersen,0,1,0,C,2012
35181,5,21,Todd Bergen,11,14,16,C,1984
35182,21,20,Todd Bertuzzi,18,76,39,RW,1995
35183,13,21,Todd Bertuzzi,10,64,23,RW,1996
35184,20,22,Todd Bertuzzi,13,74,33,LW,1997
35185,8,23,Todd Bertuzzi,8,32,16,C,1998
35186,25,24,Todd Bertuzzi,25,80,50,RW,1999
35187,30,25,Todd Bertuzzi,25,79,55,LW,2000
35188,49,26,Todd Bertuzzi,36,72,85,RW,2001
35189,51,27,Todd Bertuzzi,46,82,97,RW,2002
35190,43,28,Todd Bertuzzi,17,69,60,RW,2003
35191,46,30,Todd Bertuzzi,25,82,71,RW,2005
35192,8,31,Todd Bertuzzi,3,15,11,RW,2006
35193,26,32,Todd Bertuzzi,14,68,40,LW,2007
35194,29,33,Todd Bertuzzi,15,66,44,LW,2008
35195,26,34,Todd Bertuzzi,18,82,44,RW,2009
35196,29,35,Todd Bertuzzi,16,81,45,RW,2010
35197,24,36,Todd Bertuzzi,14,71,38,RW,2011
35198,1,37,Todd Bertuzzi,2,7,3,RW,2012
35199,7,38,Todd Bertuzzi,9,59,16,RW,2013
35200,1,20,Todd Bidner,2,12,3,LW,1981
35201,0,18,Todd Charlesworth,0,10,0,D,1983
35202,8,19,Todd Charlesworth,1,67,9,D,1984
35203,1,20,Todd Charlesworth,0,2,1,D,1985
35204,0,21,Todd Charlesworth,0,1,0,D,1986
35205,0,22,Todd Charlesworth,2,6,2,D,1987
35206,0,24,Todd Charlesworth,0,7,0,D,1989
35207,23,23,Todd Elik,10,48,33,C,1989
35208,37,24,Todd Elik,21,74,58,C,1990
35209,32,25,Todd Elik,14,62,46,C,1991
35210,27,26,Todd Elik,14,60,41,C,1992
35211,41,27,Todd Elik,25,79,66,C,1993
35212,14,28,Todd Elik,9,35,23,C,1994
35213,33,29,Todd Elik,13,59,46,LW,1995
35214,12,30,Todd Elik,4,31,16,LW,1996
35215,0,20,Todd Ewen,2,23,2,RW,1986
35216,2,21,Todd Ewen,4,64,6,RW,1987
35217,5,22,Todd Ewen,4,34,9,RW,1988
35218,6,23,Todd Ewen,4,44,10,RW,1989
35219,2,24,Todd Ewen,3,28,5,RW,1990
35220,2,25,Todd Ewen,1,46,3,RW,1991
35221,9,26,Todd Ewen,5,75,14,RW,1992
35222,9,27,Todd Ewen,9,76,18,RW,1993
35223,0,28,Todd Ewen,0,24,0,RW,1994
35224,3,29,Todd Ewen,4,53,7,RW,1995
35225,2,30,Todd Ewen,0,51,2,RW,1996
35226,5,21,Todd Fedoruk,5,53,10,RW,2000
35227,4,22,Todd Fedoruk,3,55,7,LW,2001
35228,5,23,Todd Fedoruk,1,63,6,LW,2002
35229,4,24,Todd Fedoruk,1,49,5,LW,2003
35230,19,26,Todd Fedoruk,4,76,23,LW,2005
35231,11,27,Todd Fedoruk,3,58,14,LW,2006
35232,7,28,Todd Fedoruk,6,69,13,LW,2007
35233,7,29,Todd Fedoruk,6,72,13,LW,2008
35234,3,30,Todd Fedoruk,3,50,6,LW,2009
35235,0,23,Todd Flichel,0,2,0,D,1987
35236,0,24,Todd Flichel,0,1,0,D,1988
35237,1,25,Todd Flichel,0,3,1,D,1989
35238,0,19,Todd Gill,1,10,1,D,1984
35239,2,20,Todd Gill,1,15,3,D,1985
35240,27,21,Todd Gill,4,61,31,D,1986
35241,17,22,Todd Gill,8,65,25,D,1987
35242,14,23,Todd Gill,11,59,25,D,1988
35243,14,24,Todd Gill,1,48,15,D,1989
35244,22,25,Todd Gill,2,72,24,D,1990
35245,15,26,Todd Gill,2,74,17,D,1991
35246,32,27,Todd Gill,11,69,43,D,1992
35247,24,28,Todd Gill,4,45,28,D,1993
35248,25,29,Todd Gill,7,47,32,D,1994
35249,18,30,Todd Gill,7,74,25,D,1995
35250,21,31,Todd Gill,0,79,21,D,1996
35251,17,32,Todd Gill,13,75,30,D,1997
35252,5,33,Todd Gill,4,51,9,D,1998
35253,6,34,Todd Gill,3,54,9,D,1999
35254,8,35,Todd Gill,3,68,11,D,2000
35255,4,36,Todd Gill,0,36,4,D,2001
35256,1,37,Todd Gill,0,5,1,D,2002
35257,0,23,Todd Harkins,0,5,0,C,1991
35258,3,24,Todd Harkins,2,15,5,C,1992
35259,0,25,Todd Harkins,1,28,1,C,1993
35260,9,19,Todd Harvey,11,40,20,RW,1994
35261,20,20,Todd Harvey,9,69,29,RW,1995
35262,22,21,Todd Harvey,9,71,31,RW,1996
35263,10,22,Todd Harvey,9,59,19,C,1997
35264,17,23,Todd Harvey,11,37,28,RW,1998
35265,7,24,Todd Harvey,11,71,18,RW,1999
35266,11,25,Todd Harvey,10,69,21,RW,2000
35267,13,26,Todd Harvey,9,69,22,RW,2001
35268,16,27,Todd Harvey,3,76,19,RW,2002
35269,5,28,Todd Harvey,4,47,9,C,2003
35270,2,30,Todd Harvey,5,63,7,RW,2005
35271,0,22,Todd Hawkins,0,4,0,LW,1988
35272,0,23,Todd Hawkins,0,4,0,LW,1989
35273,0,25,Todd Hawkins,0,2,0,LW,1991
35274,0,23,Todd Hlushko,1,2,1,LW,1993
35275,1,24,Todd Hlushko,0,2,1,C,1994
35276,0,25,Todd Hlushko,0,4,0,C,1995
35277,11,26,Todd Hlushko,7,58,18,LW,1996
35278,1,27,Todd Hlushko,0,13,1,LW,1997
35279,12,24,Todd Krygier,18,58,30,LW,1989
35280,17,25,Todd Krygier,13,72,30,LW,1990
35281,17,26,Todd Krygier,13,67,30,LW,1991
35282,12,27,Todd Krygier,11,77,23,LW,1992
35283,18,28,Todd Krygier,12,66,30,RW,1993
35284,11,29,Todd Krygier,11,35,22,LW,1994
35285,33,30,Todd Krygier,15,76,48,LW,1995
35286,11,31,Todd Krygier,5,47,16,LW,1996
35287,12,32,Todd Krygier,2,45,14,RW,1997
35288,1,20,Todd Marchant,0,4,1,C,1993
35289,14,21,Todd Marchant,13,45,27,C,1994
35290,19,22,Todd Marchant,19,81,38,C,1995
35291,19,23,Todd Marchant,14,79,33,LW,1996
35292,21,24,Todd Marchant,14,76,35,LW,1997
35293,22,25,Todd Marchant,14,82,36,C,1998
35294,23,26,Todd Marchant,17,82,40,C,1999
35295,26,27,Todd Marchant,13,71,39,C,2000
35296,22,28,Todd Marchant,12,82,34,C,2001
35297,40,29,Todd Marchant,20,77,60,C,2002
35298,25,30,Todd Marchant,9,77,34,C,2003
35299,25,32,Todd Marchant,9,79,34,C,2005
35300,15,33,Todd Marchant,8,56,23,C,2006
35301,7,34,Todd Marchant,9,75,16,C,2007
35302,13,35,Todd Marchant,5,72,18,C,2008
35303,13,36,Todd Marchant,9,78,22,C,2009
35304,7,37,Todd Marchant,1,79,8,C,2010
35305,1,20,Todd McLellan,1,5,2,C,1987
35306,0,22,Todd Nelson,0,1,0,D,1991
35307,0,24,Todd Nelson,1,2,1,D,1993
35308,0,23,Todd Okerlund,0,4,0,RW,1987
35309,3,27,Todd Reirden,2,17,5,D,1998
35310,21,28,Todd Reirden,4,56,25,D,1999
35311,4,29,Todd Reirden,2,38,6,D,2000
35312,5,30,Todd Reirden,3,65,8,D,2001
35313,2,32,Todd Reirden,0,7,2,D,2003
35314,4,24,Todd Richards,0,2,4,D,1990
35315,0,25,Todd Richards,0,6,0,D,1991
35316,1,28,Todd Rohloff,0,16,1,D,2001
35317,5,30,Todd Rohloff,0,59,5,D,2003
35318,1,21,Todd Simon,0,15,1,C,1993
35319,0,22,Todd Simpson,0,6,0,D,1995
35320,13,23,Todd Simpson,1,82,14,D,1996
35321,5,24,Todd Simpson,1,53,6,D,1997
35322,8,25,Todd Simpson,2,73,10,D,1998
35323,6,26,Todd Simpson,1,82,7,D,1999
35324,4,27,Todd Simpson,1,38,5,D,2000
35325,13,28,Todd Simpson,2,67,15,D,2001
35326,7,29,Todd Simpson,2,66,9,D,2002
35327,4,30,Todd Simpson,4,62,8,D,2003
35328,3,32,Todd Simpson,0,51,3,D,2005
35329,0,18,Todd Strueby,0,3,0,LW,1981
35330,0,19,Todd Strueby,0,1,0,LW,1982
35331,1,20,Todd Strueby,0,1,1,LW,1983
35332,0,21,Todd Warriner,0,5,0,LW,1994
35333,8,22,Todd Warriner,7,57,15,C,1995
35334,21,23,Todd Warriner,12,75,33,LW,1996
35335,8,24,Todd Warriner,5,45,13,LW,1997
35336,10,25,Todd Warriner,9,53,19,LW,1998
35337,14,26,Todd Warriner,14,73,28,C,1999
35338,11,27,Todd Warriner,10,64,21,LW,2000
35339,7,28,Todd Warriner,2,32,9,LW,2001
35340,10,29,Todd Warriner,6,49,16,LW,2002
35341,0,22,Todd White,1,7,1,C,1997
35342,8,23,Todd White,5,35,13,C,1998
35343,0,24,Todd White,1,4,1,C,1999
35344,1,25,Todd White,4,16,5,C,2000
35345,30,26,Todd White,20,81,50,C,2001
35346,35,27,Todd White,25,80,60,C,2002
35347,20,28,Todd White,9,53,29,C,2003
35348,21,30,Todd White,19,61,40,C,2005
35349,31,31,Todd White,13,77,44,C,2006
35350,23,32,Todd White,14,74,37,C,2007
35351,51,33,Todd White,22,82,73,C,2008
35352,19,34,Todd White,7,65,26,C,2009
35353,1,35,Todd White,1,18,2,C,2010
35354,0,24,Tom Bissett,0,5,0,C,1990
35355,31,20,Tom Bladon,11,78,42,D,1972
35356,22,21,Tom Bladon,12,70,34,D,1973
35357,20,22,Tom Bladon,9,76,29,D,1974
35358,23,23,Tom Bladon,14,80,37,D,1975
35359,43,24,Tom Bladon,10,80,53,D,1976
35360,24,25,Tom Bladon,11,79,35,D,1977
35361,23,26,Tom Bladon,4,78,27,D,1978
35362,6,27,Tom Bladon,2,57,8,D,1979
35363,5,28,Tom Bladon,0,12,5,D,1980
35364,4,25,Tom Cassidy,3,26,7,C,1977
35365,1,25,Tom Cavanagh,0,1,1,C,2007
35366,1,26,Tom Cavanagh,1,17,2,C,2008
35367,1,23,Tom Chorske,3,14,4,RW,1989
35368,11,24,Tom Chorske,9,57,20,RW,1990
35369,17,25,Tom Chorske,19,76,36,LW,1991
35370,12,26,Tom Chorske,7,50,19,LW,1992
35371,20,27,Tom Chorske,21,76,41,LW,1993
35372,8,28,Tom Chorske,10,42,18,LW,1994
35373,14,29,Tom Chorske,15,72,29,LW,1995
35374,8,30,Tom Chorske,18,68,26,LW,1996
35375,23,31,Tom Chorske,12,82,35,LW,1997
35376,3,32,Tom Chorske,0,26,3,LW,1998
35377,5,33,Tom Chorske,1,33,6,LW,1999
35378,0,21,Tom Colley,0,1,0,C,1974
35379,13,25,Tom Earl,10,77,23,RW,1972
35380,10,26,Tom Earl,10,78,20,RW,1973
35381,8,27,Tom Earl,3,72,11,RW,1974
35382,11,28,Tom Earl,8,66,19,RW,1975
35383,14,29,Tom Earl,9,54,23,RW,1976
35384,31,19,Tom Edur,7,76,38,D,1973
35385,20,20,Tom Edur,3,61,23,D,1974
35386,28,21,Tom Edur,7,80,35,D,1975
35387,25,22,Tom Edur,7,80,32,D,1976
35388,45,23,Tom Edur,10,78,55,D,1977
35389,24,19,Tom Fergus,15,61,39,C,1981
35390,35,20,Tom Fergus,28,80,63,C,1982
35391,36,21,Tom Fergus,25,69,61,C,1983
35392,43,22,Tom Fergus,30,79,73,LW,1984
35393,42,23,Tom Fergus,31,78,73,C,1985
35394,28,24,Tom Fergus,21,57,49,C,1986
35395,31,25,Tom Fergus,19,63,50,C,1987
35396,45,26,Tom Fergus,22,80,67,C,1988
35397,26,27,Tom Fergus,19,54,45,C,1989
35398,4,28,Tom Fergus,5,14,9,C,1990
35399,23,29,Tom Fergus,15,55,38,C,1991
35400,9,30,Tom Fergus,5,36,14,C,1992
35401,5,20,Tom Fitzgerald,3,23,8,C,1988
35402,5,21,Tom Fitzgerald,2,19,7,C,1989
35403,5,22,Tom Fitzgerald,5,41,10,C,1990
35404,11,23,Tom Fitzgerald,6,45,17,C,1991
35405,18,24,Tom Fitzgerald,9,77,27,C,1992
35406,14,25,Tom Fitzgerald,18,83,32,C,1993
35407,13,26,Tom Fitzgerald,3,48,16,RW,1994
35408,21,27,Tom Fitzgerald,13,82,34,C,1995
35409,14,28,Tom Fitzgerald,10,71,24,C,1996
35410,6,29,Tom Fitzgerald,12,80,18,C,1997
35411,19,30,Tom Fitzgerald,13,80,32,RW,1998
35412,9,31,Tom Fitzgerald,13,82,22,RW,1999
35413,9,32,Tom Fitzgerald,9,82,18,LW,2000
35414,12,33,Tom Fitzgerald,8,78,20,RW,2001
35415,13,34,Tom Fitzgerald,4,66,17,LW,2002
35416,10,35,Tom Fitzgerald,7,69,17,C,2003
35417,6,37,Tom Fitzgerald,4,71,10,RW,2005
35418,5,24,Tom Gilbert,1,12,6,D,2006
35419,20,25,Tom Gilbert,13,82,33,D,2007
35420,40,26,Tom Gilbert,5,82,45,D,2008
35421,26,27,Tom Gilbert,5,82,31,D,2009
35422,20,28,Tom Gilbert,6,79,26,D,2010
35423,19,29,Tom Gilbert,3,67,22,D,2011
35424,10,30,Tom Gilbert,3,43,13,D,2012
35425,25,31,Tom Gilbert,3,73,28,D,2013
35426,8,32,Tom Gilbert,4,72,12,D,2014
35427,1,33,Tom Gilbert,1,45,2,D,2015
35428,4,34,Tom Gilbert,1,18,5,D,2016
35429,18,24,Tom Gilmore,17,71,35,LW,1972
35430,23,25,Tom Gilmore,19,57,42,RW,1973
35431,19,26,Tom Gilmore,12,74,31,RW,1974
35432,6,21,Tom Gorence,13,42,19,RW,1978
35433,13,22,Tom Gorence,8,51,21,RW,1979
35434,18,23,Tom Gorence,24,79,42,RW,1980
35435,8,24,Tom Gorence,5,66,13,RW,1981
35436,7,25,Tom Gorence,7,53,14,RW,1982
35437,1,26,Tom Gorence,1,12,2,RW,1983
35438,3,21,Tom Hirsch,1,15,4,D,1983
35439,4,22,Tom Hirsch,0,15,4,D,1984
35440,0,25,Tom Hirsch,0,1,0,D,1987
35441,20,19,Tom J McCarthy,16,68,36,LW,1979
35442,25,20,Tom J McCarthy,23,62,48,LW,1980
35443,30,21,Tom J McCarthy,12,40,42,LW,1981
35444,48,22,Tom J McCarthy,28,80,76,LW,1982
35445,31,23,Tom J McCarthy,39,66,70,LW,1983
35446,21,24,Tom J McCarthy,16,44,37,LW,1984
35447,12,25,Tom J McCarthy,12,25,24,LW,1985
35448,29,26,Tom J McCarthy,30,68,59,LW,1986
35449,5,27,Tom J McCarthy,2,7,7,LW,1987
35450,4,28,Tom Koivisto,2,22,6,D,2002
35451,2,23,Tom Kostopoulos,1,11,3,RW,2001
35452,1,24,Tom Kostopoulos,0,8,1,RW,2002
35453,13,25,Tom Kostopoulos,9,60,22,RW,2003
35454,14,27,Tom Kostopoulos,8,76,22,RW,2005
35455,15,28,Tom Kostopoulos,7,76,22,RW,2006
35456,6,29,Tom Kostopoulos,7,67,13,RW,2007
35457,14,30,Tom Kostopoulos,8,78,22,RW,2008
35458,13,31,Tom Kostopoulos,8,82,21,RW,2009
35459,10,32,Tom Kostopoulos,8,76,18,RW,2010
35460,8,33,Tom Kostopoulos,4,81,12,RW,2011
35461,0,34,Tom Kostopoulos,1,15,1,RW,2012
35462,10,24,Tom Kuhnhackl,5,42,15,RW,2015
35463,12,25,Tom Kuhnhackl,4,57,16,RW,2016
35464,6,26,Tom Kuhnhackl,2,69,8,RW,2017
35465,35,22,Tom Kurvers,10,75,45,D,1984
35466,23,23,Tom Kurvers,7,62,30,D,1985
35467,17,24,Tom Kurvers,6,56,23,D,1986
35468,29,25,Tom Kurvers,5,56,34,D,1987
35469,50,26,Tom Kurvers,16,74,66,D,1988
35470,37,27,Tom Kurvers,15,71,52,D,1989
35471,26,28,Tom Kurvers,4,51,30,D,1990
35472,47,29,Tom Kurvers,9,74,56,D,1991
35473,30,30,Tom Kurvers,8,52,38,D,1992
35474,31,31,Tom Kurvers,9,66,40,D,1993
35475,3,32,Tom Kurvers,4,22,7,D,1994
35476,23,22,Tom Laidlaw,6,80,29,D,1980
35477,18,23,Tom Laidlaw,3,79,21,D,1981
35478,10,24,Tom Laidlaw,0,80,10,D,1982
35479,15,25,Tom Laidlaw,3,79,18,D,1983
35480,11,26,Tom Laidlaw,1,61,12,D,1984
35481,12,27,Tom Laidlaw,6,68,18,D,1985
35482,13,28,Tom Laidlaw,1,74,14,D,1986
35483,12,29,Tom Laidlaw,1,57,13,D,1987
35484,17,30,Tom Laidlaw,3,70,20,D,1988
35485,8,31,Tom Laidlaw,1,57,9,D,1989
35486,45,20,Tom Lysiak,19,77,64,C,1973
35487,52,21,Tom Lysiak,25,77,77,C,1974
35488,51,22,Tom Lysiak,31,80,82,C,1975
35489,51,23,Tom Lysiak,30,79,81,C,1976
35490,42,24,Tom Lysiak,27,80,69,C,1977
35491,45,25,Tom Lysiak,23,66,68,C,1978
35492,43,26,Tom Lysiak,26,77,69,C,1979
35493,55,27,Tom Lysiak,21,72,76,C,1980
35494,50,28,Tom Lysiak,32,71,82,C,1981
35495,38,29,Tom Lysiak,23,61,61,C,1982
35496,30,30,Tom Lysiak,17,54,47,LW,1983
35497,30,31,Tom Lysiak,16,74,46,C,1984
35498,19,32,Tom Lysiak,2,51,21,C,1985
35499,0,20,Tom Martin,1,3,1,RW,1967
35500,27,25,Tom Martin,19,74,46,RW,1972
35501,32,26,Tom Martin,25,74,57,RW,1973
35502,17,27,Tom Martin,15,64,32,RW,1974
35503,0,20,Tom Martin,1,8,1,LW,1984
35504,0,21,Tom Martin,0,5,0,LW,1985
35505,0,22,Tom Martin,1,11,1,LW,1986
35506,2,23,Tom Martin,1,5,3,LW,1987
35507,7,24,Tom Martin,8,42,15,LW,1988
35508,2,25,Tom Martin,1,21,3,LW,1989
35509,1,20,Tom McMurchy,3,27,4,RW,1983
35510,2,21,Tom McMurchy,1,15,3,RW,1984
35511,0,22,Tom McMurchy,0,4,0,RW,1985
35512,1,24,Tom McMurchy,4,9,5,RW,1987
35513,4,24,Tom Mellor,2,25,6,D,1973
35514,0,25,Tom Mellor,0,1,0,D,1974
35515,0,24,Tom Milani,0,2,0,RW,1976
35516,7,23,Tom Miller,1,29,8,C,1970
35517,17,25,Tom Miller,13,69,30,C,1972
35518,1,26,Tom Miller,2,19,3,C,1973
35519,0,27,Tom Miller,0,1,0,C,1974
35520,10,22,Tom O'Regan,4,51,14,C,1983
35521,0,23,Tom O'Regan,0,1,0,C,1984
35522,2,24,Tom O'Regan,1,9,3,C,1985
35523,13,23,Tom Pederson,7,44,20,D,1992
35524,19,24,Tom Pederson,6,74,25,D,1993
35525,11,25,Tom Pederson,5,47,16,D,1994
35526,4,26,Tom Pederson,1,60,5,D,1995
35527,2,27,Tom Pederson,1,15,3,D,1996
35528,2,26,Tom Polanic,0,16,2,D,1969
35529,0,27,Tom Polanic,0,3,0,D,1970
35530,16,21,Tom Poti,5,73,21,D,1998
35531,26,22,Tom Poti,9,76,35,D,1999
35532,20,23,Tom Poti,12,81,32,D,2000
35533,23,24,Tom Poti,2,66,25,D,2001
35534,37,25,Tom Poti,11,80,48,D,2002
35535,14,26,Tom Poti,10,67,24,D,2003
35536,20,28,Tom Poti,3,73,23,D,2005
35537,38,29,Tom Poti,6,78,44,D,2006
35538,27,30,Tom Poti,2,71,29,D,2007
35539,10,31,Tom Poti,3,52,13,D,2008
35540,20,32,Tom Poti,4,70,24,D,2009
35541,5,33,Tom Poti,2,21,7,D,2010
35542,2,35,Tom Poti,0,16,2,D,2012
35543,17,25,Tom Preissing,2,69,19,D,2003
35544,32,27,Tom Preissing,11,74,43,D,2005
35545,31,28,Tom Preissing,7,80,38,D,2006
35546,16,29,Tom Preissing,8,77,24,D,2007
35547,4,30,Tom Preissing,3,22,7,D,2008
35548,1,31,Tom Preissing,0,4,1,D,2009
35549,0,20,Tom Price,0,3,0,D,1974
35550,0,21,Tom Price,0,5,0,D,1975
35551,2,22,Tom Price,0,9,2,D,1976
35552,0,23,Tom Price,0,10,0,D,1977
35553,0,24,Tom Price,0,2,0,D,1978
35554,3,22,Tom Pyatt,2,40,5,C,2009
35555,5,23,Tom Pyatt,2,61,7,C,2010
35556,7,24,Tom Pyatt,12,74,19,C,2011
35557,8,25,Tom Pyatt,8,43,16,C,2012
35558,4,26,Tom Pyatt,3,27,7,C,2013
35559,14,29,Tom Pyatt,9,82,23,LW,2016
35560,15,30,Tom Pyatt,7,81,22,LW,2017
35561,4,21,Tom Reid,0,56,4,D,1967
35562,7,22,Tom Reid,0,48,7,D,1968
35563,7,23,Tom Reid,1,66,8,D,1969
35564,14,24,Tom Reid,3,73,17,D,1970
35565,15,25,Tom Reid,6,78,21,D,1971
35566,13,26,Tom Reid,1,60,14,D,1972
35567,19,27,Tom Reid,4,76,23,D,1973
35568,5,28,Tom Reid,1,74,6,D,1974
35569,15,29,Tom Reid,0,69,15,D,1975
35570,8,30,Tom Reid,0,65,8,D,1976
35571,6,31,Tom Reid,1,36,7,D,1977
35572,1,23,Tom Roulston,1,11,2,C,1980
35573,3,24,Tom Roulston,11,35,14,RW,1981
35574,21,25,Tom Roulston,19,67,40,C,1982
35575,24,26,Tom Roulston,16,77,40,RW,1983
35576,0,28,Tom Roulston,0,5,0,RW,1985
35577,2,20,Tom Rowe,1,12,3,RW,1976
35578,8,21,Tom Rowe,13,63,21,RW,1977
35579,30,22,Tom Rowe,31,69,61,RW,1978
35580,21,23,Tom Rowe,16,61,37,RW,1979
35581,28,24,Tom Rowe,13,74,41,RW,1980
35582,1,25,Tom Rowe,5,27,6,RW,1981
35583,10,26,Tom Rowe,6,51,16,RW,1982
35584,1,28,Tom Serviss,2,8,3,C,1976
35585,0,20,Tom Sestito,0,1,0,LW,2007
35586,0,22,Tom Sestito,0,3,0,LW,2009
35587,2,23,Tom Sestito,2,9,4,LW,2010
35588,1,24,Tom Sestito,0,14,1,LW,2011
35589,0,25,Tom Sestito,3,30,3,LW,2012
35590,4,26,Tom Sestito,5,77,9,LW,2013
35591,1,27,Tom Sestito,0,3,1,LW,2014
35592,1,28,Tom Sestito,0,4,1,LW,2015
35593,2,29,Tom Sestito,0,13,2,LW,2016
35594,1,25,Tom Songin,3,17,4,RW,1978
35595,3,26,Tom Songin,1,17,4,RW,1979
35596,1,27,Tom Songin,1,9,2,RW,1980
35597,8,20,Tom Thornbury,1,14,9,D,1983
35598,1,29,Tom Thurlby,1,20,2,D,1967
35599,22,23,Tom Tilley,1,70,23,D,1988
35600,5,24,Tom Tilley,0,34,5,D,1989
35601,4,25,Tom Tilley,2,22,6,D,1990
35602,7,28,Tom Tilley,1,48,8,D,1993
35603,2,22,Tom Wandell,1,14,3,C,2008
35604,10,23,Tom Wandell,5,50,15,C,2009
35605,2,24,Tom Wandell,7,75,9,C,2010
35606,9,25,Tom Wandell,6,72,15,C,2011
35607,0,26,Tom Wandell,1,18,1,C,2012
35608,2,20,Tom Webster,0,9,2,RW,1968
35609,1,21,Tom Webster,0,2,1,RW,1969
35610,37,22,Tom Webster,30,78,67,RW,1970
35611,2,23,Tom Webster,3,12,5,RW,1971
35612,0,31,Tom Webster,0,1,0,RW,1979
35613,0,20,Tom Williams,0,3,0,LW,1971
35614,1,21,Tom Williams,0,8,1,LW,1972
35615,19,22,Tom Williams,12,60,31,LW,1973
35616,22,23,Tom Williams,24,74,46,LW,1974
35617,20,24,Tom Williams,19,70,39,LW,1975
35618,39,25,Tom Williams,35,80,74,LW,1976
35619,22,26,Tom Williams,15,58,37,LW,1977
35620,15,27,Tom Williams,10,44,25,LW,1978
35621,7,19,Tom Wilson,3,82,10,RW,2013
35622,13,20,Tom Wilson,4,67,17,RW,2014
35623,16,21,Tom Wilson,7,82,23,RW,2015
35624,12,22,Tom Wilson,7,82,19,RW,2016
35625,21,23,Tom Wilson,14,78,35,RW,2017
35626,6,24,Tom Younghans,8,78,14,RW,1976
35627,8,25,Tom Younghans,10,72,18,RW,1977
35628,10,26,Tom Younghans,8,76,18,RW,1978
35629,6,27,Tom Younghans,10,79,16,RW,1979
35630,6,28,Tom Younghans,4,74,10,RW,1980
35631,5,29,Tom Younghans,4,50,9,RW,1981
35632,0,21,Tomas Divisek,0,2,0,LW,2000
35633,0,22,Tomas Divisek,1,3,1,C,2001
35634,2,21,Tomas Fleischmann,0,14,2,C,2005
35635,4,22,Tomas Fleischmann,4,29,8,C,2006
35636,20,23,Tomas Fleischmann,10,75,30,RW,2007
35637,18,24,Tomas Fleischmann,19,73,37,RW,2008
35638,28,25,Tomas Fleischmann,23,69,51,LW,2009
35639,19,26,Tomas Fleischmann,12,45,31,LW,2010
35640,34,27,Tomas Fleischmann,27,82,61,LW,2011
35641,23,28,Tomas Fleischmann,12,48,35,LW,2012
35642,20,29,Tomas Fleischmann,8,80,28,LW,2013
35643,19,30,Tomas Fleischmann,8,66,27,LW,2014
35644,11,31,Tomas Fleischmann,14,76,25,LW,2015
35645,9,23,Tomas Forslund,5,38,14,RW,1991
35646,2,24,Tomas Forslund,0,6,2,RW,1992
35647,10,20,Tomas Hertl,15,37,25,C,2013
35648,18,21,Tomas Hertl,13,82,31,C,2014
35649,25,22,Tomas Hertl,21,81,46,C,2015
35650,12,23,Tomas Hertl,10,49,22,C,2016
35651,24,24,Tomas Hertl,22,79,46,C,2017
35652,3,24,Tomas Holmstrom,6,47,9,LW,1996
35653,17,25,Tomas Holmstrom,5,57,22,LW,1997
35654,21,26,Tomas Holmstrom,13,82,34,LW,1998
35655,22,27,Tomas Holmstrom,13,72,35,LW,1999
35656,24,28,Tomas Holmstrom,16,73,40,LW,2000
35657,18,29,Tomas Holmstrom,8,69,26,RW,2001
35658,20,30,Tomas Holmstrom,20,74,40,RW,2002
35659,15,31,Tomas Holmstrom,15,67,30,RW,2003
35660,30,33,Tomas Holmstrom,29,81,59,RW,2005
35661,22,34,Tomas Holmstrom,30,77,52,LW,2006
35662,20,35,Tomas Holmstrom,20,59,40,RW,2007
35663,23,36,Tomas Holmstrom,14,53,37,RW,2008
35664,20,37,Tomas Holmstrom,25,68,45,LW,2009
35665,19,38,Tomas Holmstrom,18,73,37,LW,2010
35666,13,39,Tomas Holmstrom,11,74,24,LW,2011
35667,2,24,Tomas Hyka,1,10,3,RW,2017
35668,6,30,Tomas Jelinek,7,49,13,RW,1992
35669,25,21,Tomas Jonsson,9,70,34,D,1981
35670,35,22,Tomas Jonsson,13,72,48,D,1982
35671,36,23,Tomas Jonsson,11,72,47,D,1983
35672,34,24,Tomas Jonsson,16,69,50,D,1984
35673,30,25,Tomas Jonsson,14,77,44,D,1985
35674,25,26,Tomas Jonsson,6,47,31,D,1986
35675,41,27,Tomas Jonsson,6,72,47,D,1987
35676,33,28,Tomas Jonsson,10,73,43,D,1988
35677,7,21,Tomas Jurco,8,36,15,RW,2013
35678,15,22,Tomas Jurco,3,63,18,RW,2014
35679,2,23,Tomas Jurco,4,44,6,RW,2015
35680,0,24,Tomas Jurco,1,13,1,LW,2016
35681,4,25,Tomas Jurco,6,29,10,LW,2017
35682,18,20,Tomas Kaberle,4,57,22,D,1998
35683,33,21,Tomas Kaberle,7,82,40,D,1999
35684,39,22,Tomas Kaberle,6,82,45,D,2000
35685,29,23,Tomas Kaberle,10,69,39,D,2001
35686,36,24,Tomas Kaberle,11,82,47,D,2002
35687,28,25,Tomas Kaberle,3,71,31,D,2003
35688,58,27,Tomas Kaberle,9,82,67,D,2005
35689,47,28,Tomas Kaberle,11,74,58,D,2006
35690,45,29,Tomas Kaberle,8,82,53,D,2007
35691,27,30,Tomas Kaberle,4,57,31,D,2008
35692,42,31,Tomas Kaberle,7,82,49,D,2009
35693,43,32,Tomas Kaberle,4,82,47,D,2010
35694,28,33,Tomas Kaberle,3,72,31,D,2011
35695,3,34,Tomas Kaberle,0,10,3,D,2012
35696,2,22,Tomas Kana,0,6,2,C,2009
35697,4,20,Tomas Kloucek,1,43,5,D,2000
35698,3,21,Tomas Kloucek,1,52,4,D,2001
35699,0,22,Tomas Kloucek,0,3,0,D,2002
35700,1,23,Tomas Kloucek,0,42,1,D,2003
35701,0,25,Tomas Kloucek,0,1,0,D,2005
35702,0,23,Tomas Kopecky,0,1,0,C,2005
35703,0,24,Tomas Kopecky,1,26,1,RW,2006
35704,7,25,Tomas Kopecky,5,77,12,RW,2007
35705,13,26,Tomas Kopecky,6,79,19,RW,2008
35706,11,27,Tomas Kopecky,10,74,21,RW,2009
35707,27,28,Tomas Kopecky,15,81,42,RW,2010
35708,22,29,Tomas Kopecky,10,80,32,RW,2011
35709,12,30,Tomas Kopecky,15,47,27,RW,2012
35710,8,31,Tomas Kopecky,4,49,12,RW,2013
35711,6,32,Tomas Kopecky,2,64,8,RW,2014
35712,2,20,Tomas Kubalik,0,4,2,RW,2010
35713,1,21,Tomas Kubalik,1,8,2,RW,2011
35714,0,22,Tomas Kundratek,0,5,0,D,2011
35715,6,23,Tomas Kundratek,1,25,7,D,2012
35716,2,21,Tomas Kurka,3,14,5,LW,2002
35717,0,22,Tomas Kurka,0,3,0,LW,2003
35718,2,20,Tomas Malec,0,41,2,D,2002
35719,0,21,Tomas Malec,0,2,0,D,2003
35720,0,23,Tomas Malec,0,2,0,D,2005
35721,0,24,Tomas Malec,0,1,0,D,2006
35722,1,23,Tomas Mojzis,0,7,1,D,2005
35723,0,24,Tomas Mojzis,1,6,1,D,2006
35724,1,26,Tomas Mojzis,0,4,1,D,2008
35725,0,23,Tomas Nosek,0,6,0,C,2015
35726,0,24,Tomas Nosek,1,11,1,LW,2016
35727,8,25,Tomas Nosek,7,67,15,LW,2017
35728,0,21,Tomas Plekanec,0,2,0,LW,2003
35729,20,23,Tomas Plekanec,9,67,29,LW,2005
35730,27,24,Tomas Plekanec,20,81,47,C,2006
35731,40,25,Tomas Plekanec,29,81,69,C,2007
35732,19,26,Tomas Plekanec,20,80,39,C,2008
35733,45,27,Tomas Plekanec,25,82,70,C,2009
35734,35,28,Tomas Plekanec,22,77,57,C,2010
35735,35,29,Tomas Plekanec,17,81,52,C,2011
35736,19,30,Tomas Plekanec,14,47,33,C,2012
35737,23,31,Tomas Plekanec,20,81,43,C,2013
35738,34,32,Tomas Plekanec,26,82,60,C,2014
35739,40,33,Tomas Plekanec,14,82,54,C,2015
35740,18,34,Tomas Plekanec,10,78,28,C,2016
35741,2,35,Tomas Plekanec,0,17,2,C,2017
35742,0,23,Tomas Plihal,0,3,0,C,2006
35743,1,24,Tomas Plihal,2,22,3,C,2007
35744,8,25,Tomas Plihal,5,64,13,LW,2008
35745,29,20,Tomas Sandstrom,29,74,58,LW,1984
35746,29,21,Tomas Sandstrom,25,73,54,RW,1985
35747,34,22,Tomas Sandstrom,40,64,74,RW,1986
35748,40,23,Tomas Sandstrom,28,69,68,RW,1987
35749,56,24,Tomas Sandstrom,32,79,88,RW,1988
35750,39,25,Tomas Sandstrom,32,76,71,RW,1989
35751,44,26,Tomas Sandstrom,45,68,89,RW,1990
35752,22,27,Tomas Sandstrom,17,49,39,RW,1991
35753,27,28,Tomas Sandstrom,25,39,52,RW,1992
35754,35,29,Tomas Sandstrom,23,78,58,LW,1993
35755,23,30,Tomas Sandstrom,21,47,44,LW,1994
35756,35,31,Tomas Sandstrom,35,58,70,RW,1995
35757,24,32,Tomas Sandstrom,18,74,42,RW,1996
35758,8,33,Tomas Sandstrom,9,77,17,LW,1997
35759,17,34,Tomas Sandstrom,15,58,32,RW,1998
35760,0,24,Tomas Srsen,0,2,0,LW,1990
35761,7,21,Tomas Surovy,4,26,11,C,2002
35762,12,22,Tomas Surovy,11,47,23,RW,2003
35763,13,24,Tomas Surovy,12,53,25,LW,2005
35764,0,20,Tomas Tatar,1,9,1,LW,2010
35765,3,22,Tomas Tatar,4,18,7,LW,2012
35766,20,23,Tomas Tatar,19,73,39,LW,2013
35767,27,24,Tomas Tatar,29,82,56,LW,2014
35768,24,25,Tomas Tatar,21,81,45,LW,2015
35769,21,26,Tomas Tatar,25,82,46,LW,2016
35770,2,27,Tomas Tatar,4,20,6,LW,2017
35771,1,20,Tomas Vincour,1,24,2,C,2010
35772,6,21,Tomas Vincour,4,47,10,C,2011
35773,2,22,Tomas Vincour,2,17,4,C,2012
35774,1,24,Tomas Vincour,0,7,1,C,2014
35775,3,25,Tomas Vlasak,1,10,4,LW,2000
35776,3,23,Tomas Zizka,0,10,3,D,2002
35777,3,24,Tomas Zizka,2,15,5,D,2003
35778,13,24,Tomi Kallio,14,56,27,LW,2000
35779,14,25,Tomi Kallio,8,60,22,RW,2001
35780,4,26,Tomi Kallio,2,24,6,RW,2002
35781,0,23,Tomi Maki,0,1,0,RW,2006
35782,0,25,Tomi Pettinen,0,2,0,D,2002
35783,0,26,Tomi Pettinen,0,4,0,D,2003
35784,0,28,Tomi Pettinen,0,18,0,D,2005
35785,2,24,Tommi Santala,1,33,3,C,2003
35786,5,27,Tommi Santala,1,30,6,C,2006
35787,23,23,Tommy Albelin,3,60,26,D,1987
35788,28,24,Tommy Albelin,9,60,37,D,1988
35789,23,25,Tommy Albelin,6,68,29,D,1989
35790,12,26,Tommy Albelin,2,47,14,D,1990
35791,4,27,Tommy Albelin,0,19,4,D,1991
35792,5,28,Tommy Albelin,1,36,6,D,1992
35793,17,29,Tommy Albelin,2,62,19,D,1993
35794,10,30,Tommy Albelin,5,48,15,D,1994
35795,13,31,Tommy Albelin,1,73,14,D,1995
35796,11,32,Tommy Albelin,4,72,15,D,1996
35797,17,33,Tommy Albelin,2,69,19,D,1997
35798,5,34,Tommy Albelin,1,60,6,D,1998
35799,6,35,Tommy Albelin,4,41,10,D,1999
35800,19,36,Tommy Albelin,1,77,20,D,2000
35801,3,37,Tommy Albelin,1,42,4,D,2001
35802,6,38,Tommy Albelin,1,37,7,D,2002
35803,3,39,Tommy Albelin,1,45,4,D,2003
35804,6,41,Tommy Albelin,0,36,6,D,2005
35805,1,26,Tommy Cross,0,3,1,D,2015
35806,3,23,Tommy Lehman,1,9,4,C,1987
35807,2,24,Tommy Lehman,4,26,6,C,1988
35808,0,25,Tommy Lehman,0,1,0,C,1989
35809,29,27,Tommy Sjodin,7,77,36,D,1992
35810,11,28,Tommy Sjodin,1,29,12,D,1993
35811,8,25,Tommy Westlund,4,81,12,RW,1999
35812,3,26,Tommy Westlund,5,79,8,C,2000
35813,2,27,Tommy Westlund,0,40,2,RW,2001
35814,0,28,Tommy Westlund,0,3,0,RW,2002
35815,32,27,Tommy Williams,18,68,50,RW,1967
35816,7,28,Tommy Williams,4,26,11,RW,1968
35817,52,29,Tommy Williams,15,75,67,C,1969
35818,23,30,Tommy Williams,17,59,40,C,1970
35819,9,31,Tommy Williams,3,32,12,C,1971
35820,36,34,Tommy Williams,22,73,58,C,1974
35821,13,35,Tommy Williams,8,34,21,RW,1975
35822,0,22,Tommy Wingels,0,5,0,C,2010
35823,6,23,Tommy Wingels,3,33,9,C,2011
35824,8,24,Tommy Wingels,5,42,13,C,2012
35825,22,25,Tommy Wingels,16,77,38,C,2013
35826,21,26,Tommy Wingels,15,75,36,C,2014
35827,11,27,Tommy Wingels,7,68,18,C,2015
35828,2,28,Tommy Wingels,2,36,4,C,2016
35829,3,29,Tommy Wingels,2,18,5,RW,2017
35830,1,22,Toni Dahlman,0,10,1,RW,2001
35831,0,23,Toni Dahlman,1,12,1,RW,2002
35832,16,23,Toni Lydman,3,62,19,D,2000
35833,22,24,Toni Lydman,6,79,28,D,2001
35834,20,25,Toni Lydman,6,81,26,D,2002
35835,16,26,Toni Lydman,4,67,20,D,2003
35836,16,28,Toni Lydman,1,75,17,D,2005
35837,17,29,Toni Lydman,2,67,19,D,2006
35838,22,30,Toni Lydman,4,82,26,D,2007
35839,20,31,Toni Lydman,3,80,23,D,2008
35840,16,32,Toni Lydman,4,67,20,D,2009
35841,22,33,Toni Lydman,3,78,25,D,2010
35842,13,34,Toni Lydman,0,74,13,D,2011
35843,6,35,Toni Lydman,0,35,6,D,2012
35844,34,21,Tony Amonte,35,79,69,RW,1991
35845,43,22,Tony Amonte,33,83,76,RW,1992
35846,25,23,Tony Amonte,17,79,42,RW,1993
35847,20,24,Tony Amonte,15,48,35,RW,1994
35848,32,25,Tony Amonte,31,81,63,RW,1995
35849,36,26,Tony Amonte,41,81,77,RW,1996
35850,42,27,Tony Amonte,31,82,73,RW,1997
35851,31,28,Tony Amonte,44,82,75,RW,1998
35852,41,29,Tony Amonte,43,82,84,RW,1999
35853,29,30,Tony Amonte,35,82,64,RW,2000
35854,39,31,Tony Amonte,27,82,66,RW,2001
35855,31,32,Tony Amonte,20,72,51,RW,2002
35856,33,33,Tony Amonte,20,80,53,RW,2003
35857,28,35,Tony Amonte,14,80,42,RW,2005
35858,20,36,Tony Amonte,10,81,30,RW,2006
35859,0,19,Tony Camazzola,0,3,0,D,1981
35860,2,23,Tony Cassolato,0,9,2,RW,1979
35861,0,24,Tony Cassolato,0,2,0,RW,1980
35862,4,25,Tony Cassolato,1,12,5,RW,1981
35863,0,21,Tony Cimellaro,0,2,0,C,1992
35864,5,20,Tony Currie,4,22,9,RW,1977
35865,15,21,Tony Currie,4,36,19,RW,1978
35866,14,22,Tony Currie,19,40,33,RW,1979
35867,32,23,Tony Currie,23,61,55,RW,1980
35868,25,24,Tony Currie,23,60,48,RW,1981
35869,1,25,Tony Currie,1,8,2,RW,1982
35870,19,26,Tony Currie,15,50,34,RW,1983
35871,8,27,Tony Currie,3,13,11,RW,1984
35872,0,19,Tony Curtale,0,2,0,D,1980
35873,1,20,Tony Featherstone,0,9,1,RW,1969
35874,8,21,Tony Featherstone,8,67,16,RW,1970
35875,12,24,Tony Featherstone,9,54,21,RW,1973
35876,0,19,Tony Feltrin,0,2,0,D,1980
35877,0,20,Tony Feltrin,0,4,0,D,1981
35878,3,21,Tony Feltrin,3,32,6,D,1982
35879,0,24,Tony Feltrin,0,10,0,D,1985
35880,27,24,Tony Granato,36,78,63,LW,1988
35881,24,25,Tony Granato,12,56,36,RW,1989
35882,34,26,Tony Granato,30,68,64,LW,1990
35883,29,27,Tony Granato,39,80,68,LW,1991
35884,45,28,Tony Granato,37,81,82,RW,1992
35885,14,29,Tony Granato,7,50,21,RW,1993
35886,11,30,Tony Granato,13,33,24,LW,1994
35887,18,31,Tony Granato,17,49,35,RW,1995
35888,15,32,Tony Granato,25,76,40,RW,1996
35889,9,33,Tony Granato,16,59,25,RW,1997
35890,6,34,Tony Granato,6,35,12,RW,1998
35891,7,35,Tony Granato,6,48,13,RW,1999
35892,5,36,Tony Granato,4,60,9,RW,2000
35893,5,22,Tony Horacek,5,48,10,LW,1989
35894,6,23,Tony Horacek,3,34,9,LW,1990
35895,7,24,Tony Horacek,2,46,9,LW,1991
35896,0,26,Tony Horacek,0,7,0,LW,1993
35897,1,27,Tony Horacek,0,19,1,LW,1994
35898,37,21,Tony Hrkac,11,67,48,C,1987
35899,28,22,Tony Hrkac,17,70,45,LW,1988
35900,20,23,Tony Hrkac,9,50,29,C,1989
35901,32,24,Tony Hrkac,16,70,48,LW,1990
35902,12,25,Tony Hrkac,3,40,15,C,1991
35903,5,27,Tony Hrkac,6,36,11,C,1993
35904,14,31,Tony Hrkac,13,49,27,C,1997
35905,14,32,Tony Hrkac,13,69,27,C,1998
35906,9,33,Tony Hrkac,4,67,13,C,1999
35907,25,34,Tony Hrkac,13,80,38,C,2000
35908,26,35,Tony Hrkac,18,80,44,LW,2001
35909,17,36,Tony Hrkac,9,80,26,C,2002
35910,0,19,Tony Joseph,1,2,1,RW,1988
35911,1,23,Tony Martensson,1,6,2,C,2003
35912,14,20,Tony McKegney,8,52,22,LW,1978
35913,29,21,Tony McKegney,23,80,52,LW,1979
35914,32,22,Tony McKegney,37,80,69,LW,1980
35915,29,23,Tony McKegney,23,73,52,LW,1981
35916,37,24,Tony McKegney,36,78,73,LW,1982
35917,27,25,Tony McKegney,24,75,51,LW,1983
35918,22,26,Tony McKegney,23,57,45,LW,1984
35919,25,27,Tony McKegney,15,70,40,LW,1985
35920,20,28,Tony McKegney,31,75,51,LW,1986
35921,38,29,Tony McKegney,40,80,78,LW,1987
35922,17,30,Tony McKegney,25,71,42,RW,1988
35923,12,31,Tony McKegney,18,62,30,RW,1989
35924,17,32,Tony McKegney,17,59,34,LW,1990
35925,1,22,Tony Salmelainen,0,13,1,LW,2003
35926,11,25,Tony Salmelainen,6,57,17,LW,2006
35927,7,24,Tony Stiles,2,30,9,D,1983
35928,0,18,Tony Tanti,0,2,0,RW,1981
35929,8,19,Tony Tanti,9,40,17,RW,1982
35930,41,20,Tony Tanti,45,79,86,RW,1983
35931,20,21,Tony Tanti,39,68,59,RW,1984
35932,33,22,Tony Tanti,39,77,72,RW,1985
35933,38,23,Tony Tanti,41,77,79,RW,1986
35934,37,24,Tony Tanti,40,73,77,RW,1987
35935,25,25,Tony Tanti,24,77,49,LW,1988
35936,36,26,Tony Tanti,28,78,64,RW,1989
35937,19,27,Tony Tanti,7,56,26,RW,1990
35938,16,28,Tony Tanti,15,70,31,RW,1991
35939,0,22,Tony Tuzzolino,0,1,0,RW,1997
35940,0,25,Tony Tuzzolino,0,6,0,RW,2000
35941,0,26,Tony Tuzzolino,0,2,0,C,2001
35942,0,21,Tony Twist,0,28,0,D,1989
35943,0,22,Tony Twist,0,24,0,D,1990
35944,1,23,Tony Twist,0,44,1,D,1991
35945,2,24,Tony Twist,0,34,2,LW,1992
35946,4,25,Tony Twist,0,49,4,LW,1993
35947,0,26,Tony Twist,3,28,3,LW,1994
35948,2,27,Tony Twist,3,51,5,LW,1995
35949,2,28,Tony Twist,1,64,3,LW,1996
35950,1,29,Tony Twist,1,60,2,LW,1997
35951,6,30,Tony Twist,2,63,8,LW,1998
35952,3,29,Tony Virta,2,8,5,RW,2001
35953,2,20,Tony White,0,5,2,LW,1974
35954,17,21,Tony White,25,80,42,LW,1975
35955,9,22,Tony White,12,72,21,LW,1976
35956,0,23,Tony White,0,1,0,LW,1977
35957,0,25,Tony White,0,6,0,LW,1979
35958,1,28,Tord Lundstrom,1,11,2,LW,1973
35959,1,20,Torey Krug,0,2,1,D,2011
35960,1,21,Torey Krug,0,1,1,D,2012
35961,26,22,Torey Krug,14,79,40,D,2013
35962,27,23,Torey Krug,12,78,39,D,2014
35963,40,24,Torey Krug,4,81,44,D,2015
35964,43,25,Torey Krug,8,81,51,D,2016
35965,45,26,Torey Krug,14,76,59,D,2017
35966,10,23,Torrey Mitchell,10,82,20,C,2007
35967,9,25,Torrey Mitchell,2,56,11,C,2009
35968,14,26,Torrey Mitchell,9,66,23,C,2010
35969,10,27,Torrey Mitchell,9,76,19,C,2011
35970,4,28,Torrey Mitchell,4,45,8,C,2012
35971,8,29,Torrey Mitchell,2,67,10,C,2013
35972,8,30,Torrey Mitchell,6,65,14,C,2014
35973,8,31,Torrey Mitchell,11,71,19,C,2015
35974,9,32,Torrey Mitchell,8,78,17,C,2016
35975,0,33,Torrey Mitchell,0,11,0,C,2017
35976,0,19,Torrie Robertson,0,3,0,LW,1980
35977,13,20,Torrie Robertson,8,54,21,LW,1981
35978,0,21,Torrie Robertson,2,5,2,LW,1982
35979,13,22,Torrie Robertson,7,66,20,LW,1983
35980,30,23,Torrie Robertson,11,74,41,LW,1984
35981,24,24,Torrie Robertson,13,76,37,LW,1985
35982,0,25,Torrie Robertson,1,20,1,LW,1986
35983,8,26,Torrie Robertson,2,63,10,LW,1987
35984,6,27,Torrie Robertson,4,39,10,LW,1988
35985,5,28,Torrie Robertson,1,42,6,LW,1989
35986,5,24,Tracy Pratt,0,34,5,D,1967
35987,5,25,Tracy Pratt,0,18,5,D,1968
35988,7,26,Tracy Pratt,5,65,12,D,1969
35989,7,27,Tracy Pratt,1,76,8,D,1970
35990,10,28,Tracy Pratt,0,27,10,D,1971
35991,15,29,Tracy Pratt,1,74,16,D,1972
35992,15,30,Tracy Pratt,3,78,18,D,1973
35993,17,31,Tracy Pratt,5,79,22,D,1974
35994,5,32,Tracy Pratt,1,52,6,D,1975
35995,11,33,Tracy Pratt,1,77,12,D,1976
35996,1,24,Travis Boyd,0,8,1,C,2017
35997,0,20,Travis Brigley,0,2,0,LW,1997
35998,2,22,Travis Brigley,0,17,2,LW,1999
35999,4,26,Travis Brigley,3,36,7,LW,2003
36000,12,21,Travis Dermott,1,37,13,D,2017
36001,18,22,Travis Green,7,61,25,C,1992
36002,22,23,Travis Green,18,83,40,C,1993
36003,7,24,Travis Green,5,42,12,C,1994
36004,45,25,Travis Green,25,69,70,C,1995
36005,41,26,Travis Green,23,79,64,C,1996
36006,23,27,Travis Green,19,76,42,C,1997
36007,17,28,Travis Green,13,79,30,C,1998
36008,21,29,Travis Green,25,78,46,C,1999
36009,15,30,Travis Green,13,69,28,C,2000
36010,23,31,Travis Green,11,82,34,RW,2001
36011,12,32,Travis Green,12,75,24,C,2002
36012,5,33,Travis Green,11,64,16,RW,2003
36013,12,35,Travis Green,10,82,22,C,2005
36014,1,36,Travis Green,1,31,2,C,2006
36015,21,20,Travis Hamonic,5,62,26,D,2010
36016,22,21,Travis Hamonic,2,73,24,D,2011
36017,7,22,Travis Hamonic,3,48,10,D,2012
36018,15,23,Travis Hamonic,3,69,18,D,2013
36019,28,24,Travis Hamonic,5,71,33,D,2014
36020,16,25,Travis Hamonic,5,72,21,D,2015
36021,11,26,Travis Hamonic,3,49,14,D,2016
36022,10,27,Travis Hamonic,1,74,11,D,2017
36023,17,19,Travis Konecny,11,70,28,C,2016
36024,23,20,Travis Konecny,24,81,47,C,2017
36025,2,21,Travis Moen,4,82,6,LW,2003
36026,1,23,Travis Moen,4,39,5,LW,2005
36027,10,24,Travis Moen,11,82,21,LW,2006
36028,5,25,Travis Moen,3,77,8,LW,2007
36029,9,26,Travis Moen,7,82,16,LW,2008
36030,11,27,Travis Moen,8,81,19,LW,2009
36031,10,28,Travis Moen,6,79,16,LW,2010
36032,7,29,Travis Moen,9,48,16,LW,2011
36033,4,30,Travis Moen,2,45,6,LW,2012
36034,10,31,Travis Moen,2,65,12,LW,2013
36035,6,32,Travis Moen,3,44,9,LW,2014
36036,2,33,Travis Moen,0,23,2,LW,2015
36037,0,27,Travis Morin,0,3,0,C,2010
36038,1,30,Travis Morin,0,4,1,C,2013
36039,0,31,Travis Morin,0,6,0,C,2014
36040,0,24,Travis Richards,0,2,0,D,1994
36041,0,25,Travis Richards,0,1,0,D,1995
36042,0,22,Travis Roche,0,1,0,D,2000
36043,0,23,Travis Roche,0,4,0,D,2001
36044,1,25,Travis Roche,0,5,1,D,2003
36045,13,28,Travis Roche,6,50,19,D,2006
36046,8,21,Travis Sanheim,2,49,10,D,2017
36047,0,25,Travis Turnbull,1,3,1,C,2011
36048,25,21,Travis Zajac,17,80,42,C,2006
36049,20,22,Travis Zajac,14,82,34,C,2007
36050,42,23,Travis Zajac,20,82,62,C,2008
36051,42,24,Travis Zajac,25,82,67,C,2009
36052,31,25,Travis Zajac,13,82,44,C,2010
36053,4,26,Travis Zajac,2,15,6,C,2011
36054,13,27,Travis Zajac,7,48,20,C,2012
36055,30,28,Travis Zajac,18,80,48,C,2013
36056,14,29,Travis Zajac,11,74,25,C,2014
36057,28,30,Travis Zajac,14,74,42,C,2015
36058,31,31,Travis Zajac,14,80,45,C,2016
36059,14,32,Travis Zajac,12,63,26,C,2017
36060,4,22,Trent Hunter,0,8,4,RW,2002
36061,26,23,Trent Hunter,25,77,51,RW,2003
36062,19,25,Trent Hunter,16,82,35,RW,2005
36063,15,26,Trent Hunter,20,77,35,RW,2006
36064,29,27,Trent Hunter,12,82,41,RW,2007
36065,17,28,Trent Hunter,14,55,31,RW,2008
36066,17,29,Trent Hunter,11,61,28,RW,2009
36067,3,30,Trent Hunter,1,17,4,RW,2010
36068,5,31,Trent Hunter,2,38,7,RW,2011
36069,0,21,Trent Kaese,0,1,0,RW,1988
36070,0,21,Trent Klatt,0,1,0,C,1991
36071,19,22,Trent Klatt,4,47,23,RW,1992
36072,24,23,Trent Klatt,14,61,38,LW,1993
36073,10,24,Trent Klatt,12,47,22,RW,1994
36074,12,25,Trent Klatt,7,71,19,RW,1995
36075,21,26,Trent Klatt,24,76,45,RW,1996
36076,28,27,Trent Klatt,14,82,42,RW,1997
36077,10,28,Trent Klatt,4,75,14,RW,1998
36078,10,29,Trent Klatt,10,47,20,RW,1999
36079,20,30,Trent Klatt,13,77,33,RW,2000
36080,7,31,Trent Klatt,8,34,15,RW,2001
36081,13,32,Trent Klatt,16,82,29,RW,2002
36082,26,33,Trent Klatt,17,82,43,RW,2003
36083,10,23,Trent McCleary,4,75,14,RW,1995
36084,5,24,Trent McCleary,3,59,8,C,1996
36085,0,26,Trent McCleary,0,46,0,RW,1998
36086,0,27,Trent McCleary,1,12,1,C,1999
36087,4,23,Trent Whitfield,2,61,6,C,2000
36088,1,24,Trent Whitfield,0,25,1,C,2001
36089,1,25,Trent Whitfield,1,14,2,C,2002
36090,5,26,Trent Whitfield,6,44,11,C,2003
36091,5,28,Trent Whitfield,2,30,7,C,2005
36092,1,31,Trent Whitfield,0,3,1,C,2008
36093,1,32,Trent Whitfield,0,16,1,C,2009
36094,0,34,Trent Whitfield,0,1,0,C,2011
36095,8,22,Trent Yawney,2,15,10,D,1987
36096,19,23,Trent Yawney,5,69,24,D,1988
36097,15,24,Trent Yawney,5,70,20,D,1989
36098,13,25,Trent Yawney,3,61,16,D,1990
36099,9,26,Trent Yawney,4,47,13,D,1991
36100,16,27,Trent Yawney,1,63,17,D,1992
36101,15,28,Trent Yawney,6,58,21,D,1993
36102,2,29,Trent Yawney,0,37,2,D,1994
36103,3,30,Trent Yawney,0,69,3,D,1995
36104,2,31,Trent Yawney,0,39,2,D,1996
36105,0,32,Trent Yawney,1,45,1,D,1997
36106,0,33,Trent Yawney,0,20,0,D,1998
36107,0,21,Trevor Carrick,0,2,0,D,2015
36108,0,23,Trevor Carrick,0,1,0,D,2017
36109,5,20,Trevor Daley,1,27,6,D,2003
36110,11,22,Trevor Daley,3,81,14,D,2005
36111,8,23,Trevor Daley,4,74,12,D,2006
36112,19,24,Trevor Daley,5,82,24,D,2007
36113,18,25,Trevor Daley,7,75,25,D,2008
36114,16,26,Trevor Daley,6,77,22,D,2009
36115,19,27,Trevor Daley,8,82,27,D,2010
36116,21,28,Trevor Daley,4,79,25,D,2011
36117,9,29,Trevor Daley,4,44,13,D,2012
36118,16,30,Trevor Daley,9,67,25,D,2013
36119,22,31,Trevor Daley,16,68,38,D,2014
36120,22,32,Trevor Daley,6,82,28,D,2015
36121,14,33,Trevor Daley,5,56,19,D,2016
36122,7,34,Trevor Daley,9,77,16,D,2017
36123,0,28,Trevor Frischmon,0,3,0,C,2009
36124,0,27,Trevor Gillies,0,1,0,LW,2005
36125,1,31,Trevor Gillies,0,14,1,LW,2009
36126,0,32,Trevor Gillies,2,39,2,LW,2010
36127,0,33,Trevor Gillies,0,3,0,LW,2011
36128,4,27,Trevor Halverson,0,17,4,LW,1998
36129,14,20,Trevor Johansen,2,79,16,D,1977
36130,7,21,Trevor Johansen,2,51,9,D,1978
36131,8,22,Trevor Johansen,3,62,11,D,1979
36132,7,23,Trevor Johansen,0,35,7,D,1980
36133,10,24,Trevor Johansen,4,59,14,D,1981
36134,2,21,Trevor Letowski,2,14,4,C,1998
36135,20,22,Trevor Letowski,19,82,39,C,1999
36136,15,23,Trevor Letowski,7,77,22,C,2000
36137,16,24,Trevor Letowski,9,75,25,RW,2001
36138,14,25,Trevor Letowski,11,78,25,RW,2002
36139,17,26,Trevor Letowski,15,73,32,RW,2003
36140,18,28,Trevor Letowski,10,81,28,RW,2005
36141,6,29,Trevor Letowski,2,61,8,RW,2006
36142,9,30,Trevor Letowski,9,75,18,RW,2007
36143,2,22,Trevor Lewis,1,6,3,C,2008
36144,0,23,Trevor Lewis,0,5,0,C,2009
36145,10,24,Trevor Lewis,3,72,13,C,2010
36146,4,25,Trevor Lewis,3,72,7,C,2011
36147,9,26,Trevor Lewis,5,48,14,C,2012
36148,5,27,Trevor Lewis,6,73,11,C,2013
36149,16,28,Trevor Lewis,9,73,25,C,2014
36150,8,29,Trevor Lewis,8,75,16,C,2015
36151,12,30,Trevor Lewis,12,82,24,C,2016
36152,12,31,Trevor Lewis,14,68,26,C,2017
36153,29,18,Trevor Linden,30,80,59,RW,1988
36154,30,19,Trevor Linden,21,73,51,RW,1989
36155,37,20,Trevor Linden,33,80,70,RW,1990
36156,44,21,Trevor Linden,31,80,75,RW,1991
36157,39,22,Trevor Linden,33,84,72,RW,1992
36158,29,23,Trevor Linden,32,84,61,RW,1993
36159,22,24,Trevor Linden,18,48,40,C,1994
36160,47,25,Trevor Linden,33,82,80,C,1995
36161,31,26,Trevor Linden,9,49,40,C,1996
36162,21,27,Trevor Linden,17,67,38,RW,1997
36163,29,28,Trevor Linden,18,82,47,C,1998
36164,17,29,Trevor Linden,13,50,30,C,1999
36165,22,30,Trevor Linden,15,69,37,C,2000
36166,24,31,Trevor Linden,13,80,37,C,2001
36167,22,32,Trevor Linden,19,71,41,C,2002
36168,22,33,Trevor Linden,14,82,36,C,2003
36169,9,35,Trevor Linden,7,82,16,C,2005
36170,13,36,Trevor Linden,12,80,25,C,2006
36171,5,37,Trevor Linden,7,59,12,C,2007
36172,2,22,Trevor Murphy,1,8,3,D,2017
36173,1,19,Trevor Sim,0,3,1,RW,1989
36174,0,23,Trevor Smith,1,7,1,C,2008
36175,3,26,Trevor Smith,2,16,5,LW,2011
36176,0,27,Trevor Smith,0,1,0,LW,2012
36177,5,28,Trevor Smith,4,28,9,C,2013
36178,3,29,Trevor Smith,2,54,5,C,2014
36179,0,31,Trevor Smith,0,1,0,C,2016
36180,0,19,Trevor Stienburg,1,2,1,RW,1985
36181,0,20,Trevor Stienburg,1,6,1,RW,1986
36182,1,21,Trevor Stienburg,0,8,1,RW,1987
36183,3,22,Trevor Stienburg,6,55,9,RW,1988
36184,1,23,Trevor van Riemsdyk,0,18,1,D,2014
36185,11,24,Trevor van Riemsdyk,3,82,14,D,2015
36186,11,25,Trevor van Riemsdyk,5,58,16,D,2016
36187,13,26,Trevor van Riemsdyk,3,79,16,D,2017
36188,1,22,Triston Grant,0,8,1,LW,2006
36189,0,25,Triston Grant,0,3,0,LW,2009
36190,0,24,Troy Bodie,0,4,0,RW,2008
36191,2,25,Troy Bodie,5,44,7,RW,2009
36192,3,26,Troy Bodie,1,59,4,RW,2010
36193,7,29,Troy Bodie,3,47,10,RW,2013
36194,0,30,Troy Bodie,0,5,0,RW,2014
36195,0,21,Troy Brouwer,0,10,0,RW,2006
36196,1,22,Troy Brouwer,0,2,1,RW,2007
36197,16,23,Troy Brouwer,10,69,26,RW,2008
36198,18,24,Troy Brouwer,22,78,40,RW,2009
36199,19,25,Troy Brouwer,17,79,36,RW,2010
36200,15,26,Troy Brouwer,18,82,33,RW,2011
36201,14,27,Troy Brouwer,19,47,33,RW,2012
36202,18,28,Troy Brouwer,25,82,43,RW,2013
36203,22,29,Troy Brouwer,21,82,43,RW,2014
36204,21,30,Troy Brouwer,18,82,39,RW,2015
36205,12,31,Troy Brouwer,13,74,25,RW,2016
36206,16,32,Troy Brouwer,6,76,22,RW,2017
36207,0,21,Troy Crowder,0,10,0,RW,1989
36208,3,22,Troy Crowder,6,59,9,RW,1990
36209,0,23,Troy Crowder,0,7,0,RW,1991
36210,2,26,Troy Crowder,1,29,3,RW,1994
36211,0,27,Troy Crowder,1,15,1,RW,1995
36212,2,28,Troy Crowder,1,30,3,RW,1996
36213,0,20,Troy Loney,0,13,0,LW,1983
36214,8,21,Troy Loney,10,46,18,LW,1984
36215,9,22,Troy Loney,3,47,12,LW,1985
36216,7,23,Troy Loney,8,23,15,LW,1986
36217,13,24,Troy Loney,5,65,18,RW,1987
36218,6,25,Troy Loney,10,69,16,RW,1988
36219,16,26,Troy Loney,11,67,27,LW,1989
36220,9,27,Troy Loney,7,44,16,LW,1990
36221,16,28,Troy Loney,10,76,26,LW,1991
36222,16,29,Troy Loney,5,82,21,LW,1992
36223,6,30,Troy Loney,13,62,19,LW,1993
36224,4,31,Troy Loney,5,30,9,LW,1994
36225,16,19,Troy Mallette,13,79,29,RW,1989
36226,10,20,Troy Mallette,12,71,22,LW,1990
36227,7,21,Troy Mallette,4,32,11,LW,1991
36228,3,22,Troy Mallette,4,34,7,LW,1992
36229,16,23,Troy Mallette,7,82,23,LW,1993
36230,5,24,Troy Mallette,3,23,8,LW,1994
36231,3,25,Troy Mallette,2,64,5,LW,1995
36232,8,26,Troy Mallette,6,68,14,LW,1996
36233,0,27,Troy Mallette,0,3,0,LW,1997
36234,0,19,Troy Murray,0,1,0,C,1981
36235,8,20,Troy Murray,8,54,16,C,1982
36236,15,21,Troy Murray,15,61,30,C,1983
36237,40,22,Troy Murray,26,80,66,C,1984
36238,54,23,Troy Murray,45,80,99,C,1985
36239,43,24,Troy Murray,28,77,71,C,1986
36240,36,25,Troy Murray,22,79,58,C,1987
36241,30,26,Troy Murray,21,79,51,C,1988
36242,38,27,Troy Murray,17,68,55,C,1989
36243,23,28,Troy Murray,14,75,37,C,1990
36244,30,29,Troy Murray,17,74,47,C,1991
36245,7,30,Troy Murray,4,51,11,C,1992
36246,4,31,Troy Murray,2,27,6,C,1993
36247,12,32,Troy Murray,4,46,16,C,1994
36248,14,33,Troy Murray,7,63,21,C,1995
36249,21,22,Troy Stecher,3,71,24,D,2016
36250,10,23,Troy Stecher,1,68,11,D,2017
36251,0,20,Troy Terry,0,2,0,RW,2017
36252,1,24,Tucker Poolman,1,24,2,D,2017
36253,1,22,Tuomas Gronman,0,16,1,D,1996
36254,2,23,Tuomas Gronman,1,22,3,D,1997
36255,0,21,Tuomas Pihlman,0,2,0,LW,2003
36256,1,23,Tuomas Pihlman,1,11,2,LW,2005
36257,0,24,Tuomas Pihlman,0,2,0,LW,2006
36258,21,20,Tuomo Ruutu,23,82,44,LW,2003
36259,3,22,Tuomo Ruutu,2,15,5,C,2005
36260,21,23,Tuomo Ruutu,17,71,38,C,2006
36261,22,24,Tuomo Ruutu,10,77,32,LW,2007
36262,28,25,Tuomo Ruutu,26,79,54,LW,2008
36263,21,26,Tuomo Ruutu,14,54,35,C,2009
36264,38,27,Tuomo Ruutu,19,82,57,C,2010
36265,16,28,Tuomo Ruutu,18,72,34,C,2011
36266,5,29,Tuomo Ruutu,4,17,9,C,2012
36267,16,30,Tuomo Ruutu,8,76,24,RW,2013
36268,6,31,Tuomo Ruutu,7,77,13,LW,2014
36269,1,32,Tuomo Ruutu,0,33,1,LW,2015
36270,1,23,Turner Elson,0,1,1,LW,2015
36271,0,20,Turner Stevenson,0,1,0,RW,1992
36272,0,21,Turner Stevenson,0,2,0,RW,1993
36273,1,22,Turner Stevenson,6,41,7,RW,1994
36274,16,23,Turner Stevenson,9,80,25,RW,1995
36275,13,24,Turner Stevenson,8,65,21,RW,1996
36276,6,25,Turner Stevenson,4,63,10,RW,1997
36277,17,26,Turner Stevenson,10,69,27,RW,1998
36278,13,27,Turner Stevenson,8,64,21,RW,1999
36279,18,28,Turner Stevenson,8,69,26,RW,2000
36280,2,29,Turner Stevenson,0,21,2,RW,2001
36281,13,30,Turner Stevenson,7,77,20,RW,2002
36282,13,31,Turner Stevenson,14,61,27,RW,2003
36283,3,33,Turner Stevenson,1,31,4,RW,2005
36284,0,19,Ty Jones,0,8,0,RW,1998
36285,0,24,Ty Jones,0,6,0,RW,2003
36286,0,20,Ty Rattie,0,2,0,RW,2013
36287,2,21,Ty Rattie,0,11,2,RW,2014
36288,2,22,Ty Rattie,4,13,6,RW,2015
36289,0,23,Ty Rattie,0,4,0,RW,2016
36290,4,24,Ty Rattie,5,14,9,RW,2017
36291,1,20,Ty Wishart,0,5,1,D,2008
36292,4,22,Ty Wishart,1,20,5,D,2010
36293,0,23,Ty Wishart,0,1,0,D,2011
36294,2,22,Tye McGinn,3,18,5,LW,2012
36295,1,23,Tye McGinn,4,18,5,LW,2013
36296,5,24,Tye McGinn,2,51,7,LW,2014
36297,0,25,Tye McGinn,0,2,0,LW,2015
36298,1,22,Tyler Arnason,3,21,4,C,2001
36299,20,23,Tyler Arnason,19,82,39,C,2002
36300,33,24,Tyler Arnason,22,82,55,C,2003
36301,32,26,Tyler Arnason,13,79,45,C,2005
36302,33,27,Tyler Arnason,16,82,49,C,2006
36303,21,28,Tyler Arnason,10,70,31,C,2007
36304,17,29,Tyler Arnason,5,71,22,C,2008
36305,0,21,Tyler Bertuzzi,0,7,0,LW,2016
36306,17,22,Tyler Bertuzzi,7,48,24,LW,2017
36307,5,21,Tyler Bouck,2,48,7,LW,2000
36308,0,22,Tyler Bouck,0,7,0,LW,2001
36309,2,24,Tyler Bouck,1,18,3,C,2003
36310,1,26,Tyler Bouck,1,12,2,RW,2005
36311,0,27,Tyler Bouck,0,6,0,LW,2006
36312,19,23,Tyler Bozak,8,37,27,C,2009
36313,17,24,Tyler Bozak,15,82,32,C,2010
36314,29,25,Tyler Bozak,18,73,47,C,2011
36315,16,26,Tyler Bozak,12,46,28,C,2012
36316,30,27,Tyler Bozak,19,58,49,C,2013
36317,26,28,Tyler Bozak,23,82,49,C,2014
36318,23,29,Tyler Bozak,12,57,35,C,2015
36319,37,30,Tyler Bozak,18,78,55,C,2016
36320,32,31,Tyler Bozak,11,81,43,C,2017
36321,0,22,Tyler Cuma,0,1,0,D,2011
36322,1,24,Tyler Eckford,0,3,1,D,2009
36323,0,25,Tyler Eckford,0,4,0,D,2010
36324,6,20,Tyler Ennis,3,10,9,C,2009
36325,29,21,Tyler Ennis,20,82,49,C,2010
36326,19,22,Tyler Ennis,15,48,34,C,2011
36327,21,23,Tyler Ennis,10,47,31,C,2012
36328,22,24,Tyler Ennis,21,80,43,C,2013
36329,26,25,Tyler Ennis,20,78,46,C,2014
36330,8,26,Tyler Ennis,3,23,11,C,2015
36331,8,27,Tyler Ennis,5,51,13,LW,2016
36332,14,28,Tyler Ennis,8,73,22,LW,2017
36333,0,21,Tyler Gaudet,0,2,0,C,2014
36334,2,22,Tyler Gaudet,1,14,3,C,2015
36335,1,23,Tyler Gaudet,0,4,1,C,2016
36336,0,21,Tyler Graovac,0,3,0,C,2014
36337,0,22,Tyler Graovac,0,2,0,C,2015
36338,2,23,Tyler Graovac,7,52,9,C,2016
36339,0,24,Tyler Graovac,0,5,0,C,2017
36340,3,22,Tyler Johnson,3,14,6,C,2012
36341,26,23,Tyler Johnson,24,82,50,C,2013
36342,43,24,Tyler Johnson,29,77,72,C,2014
36343,24,25,Tyler Johnson,14,69,38,C,2015
36344,26,26,Tyler Johnson,19,66,45,C,2016
36345,29,27,Tyler Johnson,21,81,50,C,2017
36346,9,21,Tyler Kennedy,10,55,19,C,2007
36347,20,22,Tyler Kennedy,15,67,35,C,2008
36348,12,23,Tyler Kennedy,13,64,25,C,2009
36349,24,24,Tyler Kennedy,21,80,45,C,2010
36350,22,25,Tyler Kennedy,11,60,33,C,2011
36351,5,26,Tyler Kennedy,6,46,11,C,2012
36352,13,27,Tyler Kennedy,4,67,17,RW,2013
36353,8,28,Tyler Kennedy,6,38,14,C,2014
36354,13,29,Tyler Kennedy,3,50,16,C,2015
36355,0,21,Tyler Larter,0,1,0,C,1989
36356,3,21,Tyler Motte,4,33,7,LW,2016
36357,0,22,Tyler Motte,2,15,2,LW,2017
36358,37,19,Tyler Myers,11,82,48,D,2009
36359,27,20,Tyler Myers,10,80,37,D,2010
36360,15,21,Tyler Myers,8,55,23,D,2011
36361,5,22,Tyler Myers,3,39,8,D,2012
36362,13,23,Tyler Myers,9,62,22,D,2013
36363,21,24,Tyler Myers,7,71,28,D,2014
36364,18,25,Tyler Myers,9,73,27,D,2015
36365,3,26,Tyler Myers,2,11,5,D,2016
36366,30,27,Tyler Myers,6,82,36,D,2017
36367,0,22,Tyler Pitlick,1,10,1,C,2013
36368,0,23,Tyler Pitlick,2,17,2,RW,2014
36369,3,25,Tyler Pitlick,8,31,11,RW,2016
36370,13,26,Tyler Pitlick,14,80,27,C,2017
36371,0,24,Tyler Randell,6,27,6,RW,2015
36372,11,19,Tyler Seguin,11,74,22,C,2010
36373,38,20,Tyler Seguin,29,81,67,C,2011
36374,16,21,Tyler Seguin,16,48,32,C,2012
36375,47,22,Tyler Seguin,37,80,84,C,2013
36376,40,23,Tyler Seguin,37,71,77,C,2014
36377,40,24,Tyler Seguin,33,72,73,C,2015
36378,46,25,Tyler Seguin,26,82,72,C,2016
36379,38,26,Tyler Seguin,40,82,78,C,2017
36380,4,27,Tyler Sloan,1,26,5,D,2008
36381,4,28,Tyler Sloan,2,40,6,D,2009
36382,5,29,Tyler Sloan,1,33,6,D,2010
36383,3,20,Tyler Toffoli,2,10,5,C,2012
36384,17,21,Tyler Toffoli,12,62,29,C,2013
36385,26,22,Tyler Toffoli,23,76,49,C,2014
36386,27,23,Tyler Toffoli,31,82,58,C,2015
36387,18,24,Tyler Toffoli,16,63,34,C,2016
36388,23,25,Tyler Toffoli,24,82,47,C,2017
36389,4,20,Tyler Wotherspoon,0,14,4,D,2013
36390,0,21,Tyler Wotherspoon,0,1,0,D,2014
36391,1,22,Tyler Wotherspoon,0,11,1,D,2015
36392,0,23,Tyler Wotherspoon,0,4,0,D,2016
36393,1,19,Tyler Wright,1,7,2,C,1992
36394,0,20,Tyler Wright,0,5,0,C,1993
36395,0,21,Tyler Wright,1,6,1,C,1994
36396,0,22,Tyler Wright,1,23,1,C,1995
36397,2,23,Tyler Wright,2,45,4,C,1996
36398,4,24,Tyler Wright,3,82,7,C,1997
36399,0,25,Tyler Wright,0,61,0,C,1998
36400,10,26,Tyler Wright,12,50,22,C,1999
36401,16,27,Tyler Wright,16,76,32,C,2000
36402,11,28,Tyler Wright,13,77,24,C,2001
36403,11,29,Tyler Wright,19,70,30,C,2002
36404,9,30,Tyler Wright,9,68,18,RW,2003
36405,6,32,Tyler Wright,2,43,8,C,2005
36406,0,24,Tyrell Goulbourne,0,9,0,LW,2017
36407,0,20,Tyson Barrie,0,10,0,D,2011
36408,11,21,Tyson Barrie,2,32,13,D,2012
36409,25,22,Tyson Barrie,13,64,38,D,2013
36410,41,23,Tyson Barrie,12,80,53,D,2014
36411,36,24,Tyson Barrie,13,78,49,D,2015
36412,31,25,Tyson Barrie,7,74,38,D,2016
36413,43,26,Tyson Barrie,14,68,57,D,2017
36414,0,18,Tyson Jost,1,6,1,C,2016
36415,10,19,Tyson Jost,12,65,22,C,2017
36416,0,23,Tyson Nash,0,2,0,LW,1998
36417,9,24,Tyson Nash,4,66,13,LW,1999
36418,7,25,Tyson Nash,8,57,15,LW,2000
36419,7,26,Tyson Nash,6,64,13,LW,2001
36420,3,27,Tyson Nash,6,66,9,LW,2002
36421,5,28,Tyson Nash,3,69,8,LW,2003
36422,6,30,Tyson Nash,0,50,6,LW,2005
36423,3,24,Tyson Strachan,0,30,3,D,2008
36424,2,25,Tyson Strachan,0,8,2,RW,2009
36425,1,26,Tyson Strachan,0,29,1,RW,2010
36426,2,27,Tyson Strachan,1,15,3,RW,2011
36427,4,28,Tyson Strachan,0,38,4,RW,2012
36428,2,29,Tyson Strachan,0,18,2,D,2013
36429,5,30,Tyson Strachan,0,46,5,D,2014
36430,0,31,Tyson Strachan,0,2,0,D,2015
36431,0,26,Udo Kiessling,0,1,0,D,1981
36432,23,21,Ulf Dahlen,29,70,52,RW,1987
36433,19,22,Ulf Dahlen,24,56,43,RW,1988
36434,22,23,Ulf Dahlen,20,76,42,RW,1989
36435,18,24,Ulf Dahlen,21,66,39,RW,1990
36436,30,25,Ulf Dahlen,36,79,66,RW,1991
36437,39,26,Ulf Dahlen,35,83,74,RW,1992
36438,44,27,Ulf Dahlen,25,78,69,RW,1993
36439,23,28,Ulf Dahlen,11,46,34,RW,1994
36440,12,29,Ulf Dahlen,16,59,28,RW,1995
36441,19,30,Ulf Dahlen,14,73,33,LW,1996
36442,23,33,Ulf Dahlen,15,75,38,RW,1999
36443,33,34,Ulf Dahlen,15,73,48,RW,2000
36444,29,35,Ulf Dahlen,23,69,52,LW,2001
36445,20,36,Ulf Dahlen,17,63,37,LW,2002
36446,15,28,Ulf Isaksson,7,50,22,LW,1982
36447,39,28,Ulf Nilsson,27,59,66,C,1978
36448,44,29,Ulf Nilsson,14,50,58,C,1979
36449,25,30,Ulf Nilsson,14,51,39,C,1980
36450,4,32,Ulf Nilsson,2,10,6,C,1982
36451,6,20,Ulf Samuelsson,2,41,8,D,1984
36452,19,21,Ulf Samuelsson,5,80,24,D,1985
36453,31,22,Ulf Samuelsson,2,78,33,D,1986
36454,33,23,Ulf Samuelsson,8,76,41,D,1987
36455,26,24,Ulf Samuelsson,9,71,35,D,1988
36456,11,25,Ulf Samuelsson,2,55,13,D,1989
36457,22,26,Ulf Samuelsson,4,76,26,D,1990
36458,14,27,Ulf Samuelsson,1,62,15,D,1991
36459,26,28,Ulf Samuelsson,3,77,29,D,1992
36460,24,29,Ulf Samuelsson,5,80,29,D,1993
36461,15,30,Ulf Samuelsson,1,44,16,D,1994
36462,18,31,Ulf Samuelsson,1,74,19,D,1995
36463,11,32,Ulf Samuelsson,6,73,17,D,1996
36464,9,33,Ulf Samuelsson,3,73,12,D,1997
36465,8,34,Ulf Samuelsson,4,71,12,D,1998
36466,2,35,Ulf Samuelsson,1,49,3,D,1999
36467,24,22,Uli Hiemer,5,53,29,D,1984
36468,16,23,Uli Hiemer,8,50,24,D,1985
36469,14,24,Uli Hiemer,6,40,20,D,1986
36470,4,21,Uwe Krupp,1,26,5,D,1986
36471,9,22,Uwe Krupp,2,75,11,D,1987
36472,13,23,Uwe Krupp,5,70,18,D,1988
36473,20,24,Uwe Krupp,3,74,23,D,1989
36474,32,25,Uwe Krupp,12,74,44,D,1990
36475,29,26,Uwe Krupp,8,67,37,D,1991
36476,29,27,Uwe Krupp,9,80,38,D,1992
36477,14,28,Uwe Krupp,7,41,21,D,1993
36478,17,29,Uwe Krupp,6,44,23,D,1994
36479,3,30,Uwe Krupp,0,6,3,D,1995
36480,17,31,Uwe Krupp,4,60,21,D,1996
36481,22,32,Uwe Krupp,9,78,31,D,1997
36482,2,33,Uwe Krupp,3,22,5,D,1998
36483,1,36,Uwe Krupp,0,8,1,D,2001
36484,0,37,Uwe Krupp,0,4,0,D,2002
36485,17,33,Vaclav Nedomansky,11,63,28,RW,1977
36486,35,34,Vaclav Nedomansky,38,80,73,RW,1978
36487,39,35,Vaclav Nedomansky,35,79,74,RW,1979
36488,20,36,Vaclav Nedomansky,12,74,32,RW,1980
36489,28,37,Vaclav Nedomansky,12,68,40,RW,1981
36490,17,38,Vaclav Nedomansky,14,57,31,RW,1982
36491,2,19,Vaclav Nedorost,2,25,4,LW,2001
36492,5,20,Vaclav Nedorost,4,42,9,LW,2002
36493,3,21,Vaclav Nedorost,4,32,7,C,2003
36494,0,22,Vaclav Pletka,0,1,0,LW,2001
36495,0,19,Vaclav Varada,0,1,0,LW,1995
36496,0,20,Vaclav Varada,0,5,0,LW,1996
36497,6,21,Vaclav Varada,5,27,11,RW,1997
36498,24,22,Vaclav Varada,7,72,31,RW,1998
36499,27,23,Vaclav Varada,10,76,37,RW,1999
36500,21,24,Vaclav Varada,10,75,31,RW,2000
36501,16,25,Vaclav Varada,7,76,23,RW,2001
36502,10,26,Vaclav Varada,9,55,19,RW,2002
36503,5,27,Vaclav Varada,5,30,10,LW,2003
36504,16,29,Vaclav Varada,5,76,21,RW,2005
36505,0,21,Vadim Sharifijanov,0,2,0,RW,1996
36506,16,23,Vadim Sharifijanov,11,53,27,RW,1998
36507,5,24,Vadim Sharifijanov,5,37,10,RW,1999
36508,0,30,Vadim Shipachyov,1,3,1,LW,2017
36509,28,34,Val Fonteyne,6,69,34,LW,1967
36510,17,35,Val Fonteyne,12,74,29,LW,1968
36511,15,36,Val Fonteyne,11,68,26,LW,1969
36512,9,37,Val Fonteyne,4,70,13,LW,1970
36513,13,38,Val Fonteyne,6,68,19,LW,1971
36514,0,24,Val James,0,7,0,LW,1981
36515,0,29,Val James,0,4,0,LW,1986
36516,0,21,Valentin Zykov,1,2,1,LW,2016
36517,0,21,Valentin Zykov,1,2,1,LW,2016
36518,4,22,Valentin Zykov,3,10,7,LW,2017
36519,1,20,Valeri Bure,3,24,4,RW,1994
36520,20,21,Valeri Bure,22,77,42,RW,1995
36521,21,22,Valeri Bure,14,64,35,RW,1996
36522,26,23,Valeri Bure,12,66,38,RW,1997
36523,27,24,Valeri Bure,26,80,53,RW,1998
36524,40,25,Valeri Bure,35,82,75,RW,1999
36525,28,26,Valeri Bure,27,78,55,RW,2000
36526,10,27,Valeri Bure,8,31,18,RW,2001
36527,23,28,Valeri Bure,5,51,28,RW,2002
36528,30,29,Valeri Bure,22,68,52,RW,2003
36529,14,25,Valeri Kamensky,7,23,21,LW,1991
36530,22,26,Valeri Kamensky,15,32,37,LW,1992
36531,37,27,Valeri Kamensky,28,76,65,LW,1993
36532,20,28,Valeri Kamensky,10,40,30,LW,1994
36533,47,29,Valeri Kamensky,38,81,85,LW,1995
36534,38,30,Valeri Kamensky,28,68,66,LW,1996
36535,40,31,Valeri Kamensky,26,75,66,LW,1997
36536,30,32,Valeri Kamensky,14,65,44,LW,1998
36537,19,33,Valeri Kamensky,13,58,32,LW,1999
36538,20,34,Valeri Kamensky,14,65,34,LW,2000
36539,14,35,Valeri Kamensky,7,54,21,LW,2001
36540,7,23,Valeri Karpov,4,30,11,RW,1994
36541,8,24,Valeri Karpov,9,37,17,LW,1995
36542,0,25,Valeri Karpov,1,9,1,RW,1996
36543,20,18,Valeri Nichushkin,14,79,34,RW,2013
36544,1,19,Valeri Nichushkin,0,8,1,RW,2014
36545,20,20,Valeri Nichushkin,9,79,29,RW,2015
36546,18,23,Valeri Zelepukin,13,44,31,LW,1991
36547,41,24,Valeri Zelepukin,23,78,64,LW,1992
36548,31,25,Valeri Zelepukin,26,82,57,LW,1993
36549,2,26,Valeri Zelepukin,1,4,3,LW,1994
36550,9,27,Valeri Zelepukin,6,61,15,LW,1995
36551,24,28,Valeri Zelepukin,14,71,38,LW,1996
36552,18,29,Valeri Zelepukin,4,68,22,LW,1997
36553,9,30,Valeri Zelepukin,16,74,25,LW,1998
36554,21,31,Valeri Zelepukin,11,77,32,LW,1999
36555,4,32,Valeri Zelepukin,3,36,7,LW,2000
36556,1,21,Valtteri Filppula,0,4,1,C,2005
36557,7,22,Valtteri Filppula,10,73,17,C,2006
36558,17,23,Valtteri Filppula,19,78,36,C,2007
36559,28,24,Valtteri Filppula,12,80,40,C,2008
36560,24,25,Valtteri Filppula,11,55,35,C,2009
36561,23,26,Valtteri Filppula,16,71,39,C,2010
36562,43,27,Valtteri Filppula,23,81,66,C,2011
36563,8,28,Valtteri Filppula,9,41,17,C,2012
36564,33,29,Valtteri Filppula,25,75,58,C,2013
36565,36,30,Valtteri Filppula,12,82,48,C,2014
36566,23,31,Valtteri Filppula,8,76,31,C,2015
36567,3,32,Valtteri Filppula,5,20,8,C,2016
36568,22,33,Valtteri Filppula,11,81,33,C,2017
36569,5,33,Veli-Pekka Ketola,9,44,14,C,1981
36570,0,20,Vern Smith,0,1,0,D,1984
36571,0,20,Vern Stenlund,0,4,0,C,1976
36572,2,22,Vernon Fiddler,4,19,6,C,2002
36573,0,23,Vernon Fiddler,0,17,0,C,2003
36574,4,25,Vernon Fiddler,8,40,12,C,2005
36575,15,26,Vernon Fiddler,11,72,26,C,2006
36576,21,27,Vernon Fiddler,11,79,32,LW,2007
36577,6,28,Vernon Fiddler,11,78,17,LW,2008
36578,22,29,Vernon Fiddler,8,76,30,C,2009
36579,16,30,Vernon Fiddler,6,71,22,C,2010
36580,13,31,Vernon Fiddler,8,82,21,C,2011
36581,13,32,Vernon Fiddler,4,46,17,C,2012
36582,17,33,Vernon Fiddler,6,76,23,C,2013
36583,16,34,Vernon Fiddler,13,80,29,C,2014
36584,10,35,Vernon Fiddler,12,82,22,C,2015
36585,0,36,Vernon Fiddler,1,20,1,LW,2016
36586,2,22,Vesa Viitakoski,1,8,3,LW,1993
36587,2,23,Vesa Viitakoski,1,10,3,LW,1994
36588,0,24,Vesa Viitakoski,0,5,0,LW,1995
36589,14,22,Viacheslav Butsayev,2,52,16,C,1992
36590,11,23,Viacheslav Butsayev,12,59,23,C,1993
36591,0,24,Viacheslav Butsayev,2,6,2,C,1994
36592,0,25,Viacheslav Butsayev,1,7,1,C,1995
36593,1,28,Viacheslav Butsayev,0,3,1,C,1998
36594,0,29,Viacheslav Butsayev,0,5,0,C,1999
36595,34,31,Viacheslav Fetisov,8,72,42,D,1989
36596,16,32,Viacheslav Fetisov,3,67,19,D,1990
36597,23,33,Viacheslav Fetisov,3,70,26,D,1991
36598,23,34,Viacheslav Fetisov,4,76,27,D,1992
36599,14,35,Viacheslav Fetisov,1,52,15,D,1993
36600,12,36,Viacheslav Fetisov,3,18,15,D,1994
36601,35,37,Viacheslav Fetisov,7,69,42,D,1995
36602,23,38,Viacheslav Fetisov,5,64,28,D,1996
36603,12,39,Viacheslav Fetisov,2,58,14,D,1997
36604,19,27,Vic Hadfield,20,59,39,LW,1967
36605,40,28,Vic Hadfield,26,73,66,LW,1968
36606,34,29,Vic Hadfield,20,71,54,LW,1969
36607,22,30,Vic Hadfield,22,63,44,LW,1970
36608,56,31,Vic Hadfield,50,78,106,LW,1971
36609,34,32,Vic Hadfield,28,63,62,LW,1972
36610,28,33,Vic Hadfield,27,77,55,LW,1973
36611,42,34,Vic Hadfield,31,78,73,LW,1974
36612,35,35,Vic Hadfield,30,76,65,LW,1975
36613,2,36,Vic Hadfield,0,9,2,LW,1976
36614,0,21,Vic Mercredi,0,2,0,C,1974
36615,0,24,Vic Teal,0,1,0,RW,1973
36616,19,21,Vic Venasky,15,77,34,LW,1972
36617,5,22,Vic Venasky,6,32,11,C,1973
36618,2,23,Vic Venasky,1,17,3,C,1974
36619,26,24,Vic Venasky,18,80,44,C,1975
36620,26,25,Vic Venasky,14,80,40,C,1976
36621,10,26,Vic Venasky,3,71,13,C,1977
36622,13,27,Vic Venasky,4,73,17,C,1978
36623,10,25,Victor Antipin,0,47,10,D,2017
36624,7,24,Victor Bartley,0,24,7,D,2012
36625,5,25,Victor Bartley,1,50,6,D,2013
36626,10,26,Victor Bartley,0,37,10,D,2014
36627,0,27,Victor Bartley,0,10,0,D,2015
36628,1,22,Victor Ejdsell,0,6,1,C,2017
36629,16,19,Victor Hedman,4,74,20,D,2009
36630,23,20,Victor Hedman,3,79,26,D,2010
36631,18,21,Victor Hedman,5,61,23,D,2011
36632,16,22,Victor Hedman,4,44,20,D,2012
36633,42,23,Victor Hedman,13,75,55,D,2013
36634,28,24,Victor Hedman,10,59,38,D,2014
36635,37,25,Victor Hedman,10,78,47,D,2015
36636,56,26,Victor Hedman,16,79,72,D,2016
36637,46,27,Victor Hedman,17,77,63,D,2017
36638,1,28,Victor Ignatjev,0,11,1,D,1998
36639,7,19,Victor Mete,0,49,7,D,2017
36640,4,23,Victor Oreskovich,2,50,6,D,2009
36641,3,24,Victor Oreskovich,0,16,3,D,2010
36642,0,25,Victor Oreskovich,0,1,0,D,2011
36643,0,19,Victor Posa,0,2,0,LW,1985
36644,22,21,Victor Rask,11,80,33,C,2014
36645,27,22,Victor Rask,21,80,48,C,2015
36646,29,23,Victor Rask,16,82,45,C,2016
36647,17,24,Victor Rask,14,71,31,C,2017
36648,0,21,Viktor Arvidsson,0,6,0,LW,2014
36649,8,22,Viktor Arvidsson,8,56,16,LW,2015
36650,30,23,Viktor Arvidsson,31,80,61,LW,2016
36651,32,24,Viktor Arvidsson,29,78,61,LW,2017
36652,6,22,Viktor Gordiouk,3,16,9,RW,1992
36653,2,24,Viktor Gordiouk,0,10,2,RW,1994
36654,0,19,Viktor Kozlov,2,16,2,RW,1994
36655,13,20,Viktor Kozlov,6,62,19,C,1995
36656,25,21,Viktor Kozlov,16,78,41,C,1996
36657,13,22,Viktor Kozlov,17,64,30,C,1997
36658,35,23,Viktor Kozlov,16,65,51,C,1998
36659,53,24,Viktor Kozlov,17,80,70,C,1999
36660,23,25,Viktor Kozlov,14,51,37,C,2000
36661,18,26,Viktor Kozlov,9,50,27,C,2001
36662,34,27,Viktor Kozlov,22,74,56,C,2002
36663,20,28,Viktor Kozlov,13,59,33,RW,2003
36664,13,30,Viktor Kozlov,12,69,25,LW,2005
36665,26,31,Viktor Kozlov,25,81,51,C,2006
36666,38,32,Viktor Kozlov,16,81,54,C,2007
36667,28,33,Viktor Kozlov,13,67,41,C,2008
36668,2,23,Viktor Loov,0,4,2,D,2015
36669,0,28,Viktor Nechayev,1,3,1,C,1982
36670,5,24,Viktor Stalberg,9,40,14,LW,2009
36671,12,25,Viktor Stalberg,12,77,24,LW,2010
36672,21,26,Viktor Stalberg,22,79,43,LW,2011
36673,14,27,Viktor Stalberg,9,47,23,LW,2012
36674,11,28,Viktor Stalberg,8,70,19,LW,2013
36675,8,29,Viktor Stalberg,2,25,10,LW,2014
36676,11,30,Viktor Stalberg,9,75,20,LW,2015
36677,2,31,Viktor Stalberg,2,18,4,LW,2016
36678,2,24,Viktor Svedberg,2,27,4,D,2015
36679,8,20,Viktor Tikhonov,8,61,16,RW,2008
36680,3,27,Viktor Tikhonov,3,50,6,RW,2015
36681,13,25,Ville Koistinen,4,48,17,D,2007
36682,8,26,Ville Koistinen,3,38,11,D,2008
36683,3,27,Ville Koistinen,1,17,4,D,2009
36684,4,25,Ville Leino,5,13,9,LW,2008
36685,5,26,Ville Leino,6,55,11,LW,2009
36686,34,27,Ville Leino,19,81,53,LW,2010
36687,17,28,Ville Leino,8,71,25,LW,2011
36688,4,29,Ville Leino,2,8,6,LW,2012
36689,15,30,Ville Leino,0,58,15,LW,2013
36690,0,22,Ville Nieminen,0,1,0,LW,1999
36691,8,23,Ville Nieminen,14,50,22,LW,2000
36692,16,24,Ville Nieminen,11,66,27,RW,2001
36693,12,25,Ville Nieminen,9,75,21,RW,2002
36694,16,26,Ville Nieminen,5,79,21,RW,2003
36695,16,28,Ville Nieminen,8,70,24,LW,2005
36696,1,29,Ville Nieminen,1,44,2,LW,2006
36697,11,22,Ville Peltonen,2,31,13,LW,1995
36698,3,23,Ville Peltonen,2,28,5,LW,1996
36699,5,25,Ville Peltonen,5,14,10,LW,1998
36700,22,26,Ville Peltonen,6,79,28,LW,1999
36701,1,27,Ville Peltonen,3,23,4,LW,2000
36702,20,33,Ville Peltonen,17,72,37,LW,2006
36703,15,34,Ville Peltonen,5,56,20,LW,2007
36704,19,35,Ville Peltonen,12,79,31,LW,2008
36705,8,21,Ville Siren,4,60,12,D,1985
36706,17,22,Ville Siren,5,69,22,D,1986
36707,20,23,Ville Siren,1,58,21,D,1987
36708,10,24,Ville Siren,3,50,13,D,1988
36709,13,25,Ville Siren,1,53,14,D,1989
36710,19,21,Vince Dunn,5,75,24,D,2017
36711,25,19,Vincent Damphousse,21,80,46,C,1986
36712,36,20,Vincent Damphousse,12,75,48,LW,1987
36713,42,21,Vincent Damphousse,26,80,68,LW,1988
36714,61,22,Vincent Damphousse,33,80,94,LW,1989
36715,47,23,Vincent Damphousse,26,79,73,LW,1990
36716,51,24,Vincent Damphousse,38,80,89,LW,1991
36717,58,25,Vincent Damphousse,39,84,97,LW,1992
36718,51,26,Vincent Damphousse,40,84,91,LW,1993
36719,30,27,Vincent Damphousse,10,48,40,LW,1994
36720,56,28,Vincent Damphousse,38,80,94,C,1995
36721,54,29,Vincent Damphousse,27,82,81,C,1996
36722,41,30,Vincent Damphousse,18,76,59,C,1997
36723,30,31,Vincent Damphousse,19,77,49,C,1998
36724,49,32,Vincent Damphousse,21,82,70,C,1999
36725,37,33,Vincent Damphousse,9,45,46,C,2000
36726,38,34,Vincent Damphousse,20,82,58,C,2001
36727,38,35,Vincent Damphousse,23,82,61,C,2002
36728,29,36,Vincent Damphousse,12,82,41,LW,2003
36729,0,21,Vincent Hinostroza,0,7,0,C,2015
36730,15,18,Vincent Lecavalier,13,82,28,C,1998
36731,42,19,Vincent Lecavalier,25,80,67,C,1999
36732,28,20,Vincent Lecavalier,23,68,51,C,2000
36733,17,21,Vincent Lecavalier,20,76,37,C,2001
36734,45,22,Vincent Lecavalier,33,80,78,C,2002
36735,34,23,Vincent Lecavalier,32,81,66,C,2003
36736,40,25,Vincent Lecavalier,35,80,75,C,2005
36737,56,26,Vincent Lecavalier,52,82,108,C,2006
36738,52,27,Vincent Lecavalier,40,81,92,C,2007
36739,38,28,Vincent Lecavalier,29,77,67,C,2008
36740,46,29,Vincent Lecavalier,24,82,70,C,2009
36741,29,30,Vincent Lecavalier,25,65,54,C,2010
36742,27,31,Vincent Lecavalier,22,64,49,C,2011
36743,22,32,Vincent Lecavalier,10,39,32,C,2012
36744,17,33,Vincent Lecavalier,20,69,37,C,2013
36745,12,34,Vincent Lecavalier,8,57,20,C,2014
36746,8,35,Vincent Lecavalier,10,49,18,C,2015
36747,3,20,Vincent Trocheck,5,20,8,C,2013
36748,15,21,Vincent Trocheck,7,50,22,C,2014
36749,28,22,Vincent Trocheck,25,76,53,C,2015
36750,31,23,Vincent Trocheck,23,82,54,C,2016
36751,44,24,Vincent Trocheck,31,82,75,C,2017
36752,4,22,Vinni Lettieri,1,19,5,C,2017
36753,8,22,Vinnie Hinostroza,6,49,14,LW,2016
36754,18,23,Vinnie Hinostroza,7,50,25,LW,2017
36755,10,21,Vinny Prospal,5,18,15,C,1996
36756,19,22,Vinny Prospal,6,56,25,C,1997
36757,26,23,Vinny Prospal,10,79,36,C,1998
36758,33,24,Vinny Prospal,22,79,55,C,1999
36759,24,25,Vinny Prospal,5,74,29,C,2000
36760,37,26,Vinny Prospal,18,81,55,C,2001
36761,57,27,Vinny Prospal,22,80,79,LW,2002
36762,35,28,Vinny Prospal,19,82,54,LW,2003
36763,55,30,Vinny Prospal,25,81,80,LW,2005
36764,41,31,Vinny Prospal,14,82,55,C,2006
36765,38,32,Vinny Prospal,33,80,71,LW,2007
36766,26,33,Vinny Prospal,19,82,45,LW,2008
36767,38,34,Vinny Prospal,20,75,58,C,2009
36768,14,35,Vinny Prospal,9,29,23,C,2010
36769,39,36,Vinny Prospal,16,82,55,C,2011
36770,18,37,Vinny Prospal,12,48,30,C,2012
36771,1,24,Vitali Karamnov,0,7,1,LW,1992
36772,12,25,Vitali Karamnov,9,59,21,LW,1993
36773,7,26,Vitali Karamnov,3,26,10,RW,1994
36774,1,26,Vitali Prokhorov,4,26,5,RW,1992
36775,10,27,Vitali Prokhorov,15,55,25,LW,1993
36776,0,28,Vitali Prokhorov,0,2,0,LW,1994
36777,34,21,Vitali Yachmenev,19,80,53,RW,1995
36778,22,22,Vitali Yachmenev,10,65,32,LW,1996
36779,1,23,Vitali Yachmenev,0,4,1,RW,1997
36780,10,24,Vitali Yachmenev,7,55,17,RW,1998
36781,16,25,Vitali Yachmenev,16,68,32,RW,1999
36782,19,26,Vitali Yachmenev,15,78,34,LW,2000
36783,16,27,Vitali Yachmenev,11,75,27,LW,2001
36784,15,28,Vitali Yachmenev,5,62,20,LW,2002
36785,1,19,Vitaly Vishnevski,1,31,2,D,1999
36786,10,20,Vitaly Vishnevski,1,76,11,D,2000
36787,3,21,Vitaly Vishnevski,0,74,3,D,2001
36788,6,22,Vitaly Vishnevski,2,80,8,D,2002
36789,10,23,Vitaly Vishnevski,6,73,16,D,2003
36790,7,25,Vitaly Vishnevski,1,82,8,D,2005
36791,10,26,Vitaly Vishnevski,3,67,13,D,2006
36792,5,27,Vitaly Vishnevski,2,69,7,D,2007
36793,12,27,Vitezslav Duris,1,57,13,D,1980
36794,8,29,Vitezslav Duris,2,32,10,D,1982
36795,2,22,Vladimir Chebaturkin,0,2,2,D,1997
36796,0,23,Vladimir Chebaturkin,0,8,0,D,1998
36797,1,24,Vladimir Chebaturkin,1,17,2,D,1999
36798,2,25,Vladimir Chebaturkin,1,22,3,D,2000
36799,2,26,Vladimir Chebaturkin,0,13,2,D,2001
36800,26,24,Vladimir Konstantinov,8,79,34,D,1991
36801,17,25,Vladimir Konstantinov,5,82,22,D,1992
36802,21,26,Vladimir Konstantinov,12,80,33,D,1993
36803,11,27,Vladimir Konstantinov,3,47,14,D,1994
36804,20,28,Vladimir Konstantinov,14,81,34,D,1995
36805,33,29,Vladimir Konstantinov,5,77,38,D,1996
36806,23,29,Vladimir Krutov,11,61,34,LW,1989
36807,38,24,Vladimir Malakhov,14,64,52,D,1992
36808,47,25,Vladimir Malakhov,10,76,57,D,1993
36809,17,26,Vladimir Malakhov,4,40,21,D,1994
36810,23,27,Vladimir Malakhov,5,61,28,D,1995
36811,20,28,Vladimir Malakhov,10,65,30,D,1996
36812,31,29,Vladimir Malakhov,13,74,44,D,1997
36813,21,30,Vladimir Malakhov,13,62,34,D,1998
36814,4,31,Vladimir Malakhov,1,24,5,D,1999
36815,2,32,Vladimir Malakhov,0,3,2,D,2000
36816,22,33,Vladimir Malakhov,6,81,28,D,2001
36817,14,34,Vladimir Malakhov,3,71,17,D,2002
36818,16,35,Vladimir Malakhov,3,62,19,D,2003
36819,5,37,Vladimir Malakhov,4,29,9,D,2005
36820,3,22,Vladimir Mihalik,0,11,3,D,2008
36821,0,23,Vladimir Mihalik,0,4,0,D,2009
36822,1,20,Vladimir Orszagh,0,11,1,RW,1997
36823,0,21,Vladimir Orszagh,1,12,1,RW,1998
36824,1,22,Vladimir Orszagh,2,11,3,RW,1999
36825,21,24,Vladimir Orszagh,15,79,36,RW,2001
36826,16,25,Vladimir Orszagh,16,78,32,RW,2002
36827,21,26,Vladimir Orszagh,16,82,37,RW,2003
36828,5,28,Vladimir Orszagh,4,16,9,RW,2005
36829,6,26,Vladimir Ruzicka,11,25,17,C,1989
36830,8,27,Vladimir Ruzicka,8,29,16,C,1990
36831,36,28,Vladimir Ruzicka,39,77,75,LW,1991
36832,22,29,Vladimir Ruzicka,19,60,41,C,1992
36833,13,30,Vladimir Ruzicka,5,42,18,C,1993
36834,6,20,Vladimir Sobotka,1,48,7,C,2007
36835,4,21,Vladimir Sobotka,1,25,5,C,2008
36836,6,22,Vladimir Sobotka,4,61,10,C,2009
36837,22,23,Vladimir Sobotka,7,65,29,C,2010
36838,15,24,Vladimir Sobotka,5,73,20,C,2011
36839,11,25,Vladimir Sobotka,8,48,19,C,2012
36840,24,26,Vladimir Sobotka,9,61,33,C,2013
36841,0,29,Vladimir Sobotka,1,1,1,LW,2016
36842,20,30,Vladimir Sobotka,11,81,31,LW,2017
36843,11,21,Vladimir Tarasenko,8,38,19,RW,2012
36844,22,22,Vladimir Tarasenko,21,64,43,RW,2013
36845,36,23,Vladimir Tarasenko,37,77,73,RW,2014
36846,34,24,Vladimir Tarasenko,40,80,74,RW,2015
36847,36,25,Vladimir Tarasenko,39,82,75,RW,2016
36848,33,26,Vladimir Tarasenko,33,80,66,RW,2017
36849,5,26,Vladimir Tsyplakov,5,23,10,LW,1995
36850,23,27,Vladimir Tsyplakov,16,67,39,LW,1996
36851,34,28,Vladimir Tsyplakov,18,73,52,LW,1997
36852,12,29,Vladimir Tsyplakov,11,69,23,LW,1998
36853,20,30,Vladimir Tsyplakov,12,63,32,LW,1999
36854,7,31,Vladimir Tsyplakov,7,36,14,LW,2000
36855,5,24,Vladimir Vorobiev,5,16,10,RW,1996
36856,2,25,Vladimir Vorobiev,2,15,4,RW,1997
36857,0,26,Vladimir Vorobiev,2,2,2,RW,1998
36858,0,19,Vladimir Vujtek,0,2,0,LW,1991
36859,10,20,Vladimir Vujtek,1,30,11,LW,1992
36860,15,21,Vladimir Vujtek,4,40,19,C,1993
36861,4,25,Vladimir Vujtek,2,30,6,C,1997
36862,0,27,Vladimir Vujtek,0,3,0,LW,1999
36863,1,30,Vladimir Vujtek,0,5,1,LW,2002
36864,10,22,Vladimir Zharkov,0,40,10,RW,2009
36865,2,23,Vladimir Zharkov,2,38,4,RW,2010
36866,0,24,Vladimir Zharkov,0,4,0,RW,2011
36867,0,20,Vladislav Kamenev,0,2,0,LW,2016
36868,0,21,Vladislav Kamenev,0,3,0,C,2017
36869,0,21,Vladislav Namestnikov,0,4,0,C,2013
36870,7,22,Vladislav Namestnikov,9,43,16,C,2014
36871,21,23,Vladislav Namestnikov,14,80,35,C,2015
36872,18,24,Vladislav Namestnikov,10,74,28,C,2016
36873,2,25,Vladislav Namestnikov,2,19,4,C,2017
36874,3,18,Vlastimil Kroupa,1,27,4,D,1993
36875,2,19,Vlastimil Kroupa,0,14,2,D,1994
36876,7,20,Vlastimil Kroupa,1,27,8,D,1995
36877,6,21,Vlastimil Kroupa,2,35,8,D,1996
36878,1,22,Vlastimil Kroupa,0,2,1,D,1997
36879,0,23,Vojtech Mozik,0,7,0,D,2015
36880,0,20,Vojtech Polak,0,3,0,LW,2005
36881,0,21,Vojtech Polak,0,2,0,LW,2006
36882,2,19,Vyacheslav Kozlov,0,7,2,C,1991
36883,1,20,Vyacheslav Kozlov,4,17,5,C,1992
36884,39,21,Vyacheslav Kozlov,34,77,73,LW,1993
36885,20,22,Vyacheslav Kozlov,13,46,33,LW,1994
36886,37,23,Vyacheslav Kozlov,36,82,73,LW,1995
36887,22,24,Vyacheslav Kozlov,23,75,45,C,1996
36888,27,25,Vyacheslav Kozlov,25,80,52,LW,1997
36889,29,26,Vyacheslav Kozlov,29,79,58,C,1998
36890,18,27,Vyacheslav Kozlov,18,72,36,LW,1999
36891,18,28,Vyacheslav Kozlov,20,72,38,LW,2000
36892,13,29,Vyacheslav Kozlov,9,38,22,LW,2001
36893,49,30,Vyacheslav Kozlov,21,79,70,RW,2002
36894,32,31,Vyacheslav Kozlov,20,76,52,C,2003
36895,46,33,Vyacheslav Kozlov,25,82,71,LW,2005
36896,52,34,Vyacheslav Kozlov,28,81,80,LW,2006
36897,24,35,Vyacheslav Kozlov,17,82,41,LW,2007
36898,50,36,Vyacheslav Kozlov,26,82,76,LW,2008
36899,18,37,Vyacheslav Kozlov,8,55,26,LW,2009
36900,0,20,Wade Belak,0,5,0,D,1996
36901,1,21,Wade Belak,1,8,2,D,1997
36902,1,22,Wade Belak,0,31,1,D,1998
36903,2,23,Wade Belak,0,40,2,D,1999
36904,1,24,Wade Belak,1,39,2,D,2000
36905,3,25,Wade Belak,1,63,4,D,2001
36906,6,26,Wade Belak,3,55,9,D,2002
36907,1,27,Wade Belak,1,34,2,D,2003
36908,3,29,Wade Belak,0,55,3,D,2005
36909,3,30,Wade Belak,0,65,3,D,2006
36910,0,31,Wade Belak,1,47,1,RW,2007
36911,2,32,Wade Belak,0,53,2,RW,2008
36912,2,33,Wade Belak,0,39,2,D,2009
36913,0,34,Wade Belak,0,15,0,D,2010
36914,0,26,Wade Brookbank,2,29,2,D,2003
36915,2,28,Wade Brookbank,1,32,3,D,2005
36916,0,29,Wade Brookbank,1,7,1,D,2006
36917,1,30,Wade Brookbank,1,32,2,LW,2007
36918,0,31,Wade Brookbank,1,27,1,LW,2008
36919,2,22,Wade Campbell,1,42,3,D,1982
36920,14,23,Wade Campbell,7,79,21,D,1983
36921,6,24,Wade Campbell,1,40,7,D,1984
36922,1,25,Wade Campbell,0,32,1,D,1985
36923,3,26,Wade Campbell,0,14,3,D,1986
36924,1,27,Wade Campbell,0,6,1,D,1987
36925,0,26,Wade Megan,1,3,1,C,2016
36926,0,27,Wade Megan,0,1,0,C,2017
36927,24,19,Wade Redden,6,82,30,D,1996
36928,14,20,Wade Redden,8,80,22,D,1997
36929,21,21,Wade Redden,8,72,29,D,1998
36930,26,22,Wade Redden,10,81,36,D,1999
36931,37,23,Wade Redden,10,78,47,D,2000
36932,25,24,Wade Redden,9,79,34,D,2001
36933,35,25,Wade Redden,10,76,45,D,2002
36934,26,26,Wade Redden,17,81,43,D,2003
36935,40,28,Wade Redden,10,65,50,D,2005
36936,29,29,Wade Redden,7,64,36,D,2006
36937,32,30,Wade Redden,6,80,38,D,2007
36938,23,31,Wade Redden,3,81,26,D,2008
36939,12,32,Wade Redden,2,75,14,D,2009
36940,4,35,Wade Redden,3,29,7,D,2012
36941,0,24,Wade Skolney,0,1,0,D,2005
36942,20,30,Wally Boyer,13,74,33,LW,1967
36943,19,31,Wally Boyer,10,62,29,C,1968
36944,12,32,Wally Boyer,11,72,23,C,1969
36945,30,33,Wally Boyer,11,68,41,C,1970
36946,1,34,Wally Boyer,0,1,1,C,1971
36947,5,25,Wally Schreiber,6,16,11,RW,1987
36948,5,26,Wally Schreiber,2,25,7,RW,1988
36949,12,25,Wally Weir,3,73,15,D,1979
36950,8,26,Wally Weir,6,54,14,D,1980
36951,5,27,Wally Weir,3,62,8,D,1981
36952,11,28,Wally Weir,5,58,16,D,1982
36953,3,29,Wally Weir,2,25,5,D,1983
36954,6,30,Wally Weir,2,48,8,D,1984
36955,1,22,Walt Ledingham,0,9,1,LW,1972
36956,1,24,Walt Ledingham,0,2,1,LW,1974
36957,0,26,Walt Ledingham,0,4,0,LW,1976
36958,0,20,Walt McKechnie,0,4,0,C,1967
36959,9,21,Walt McKechnie,5,58,14,C,1968
36960,3,22,Walt McKechnie,1,20,4,C,1969
36961,1,23,Walt McKechnie,3,30,4,C,1970
36962,20,24,Walt McKechnie,11,56,31,C,1971
36963,38,25,Walt McKechnie,16,78,54,C,1972
36964,29,26,Walt McKechnie,23,63,52,C,1973
36965,14,27,Walt McKechnie,9,76,23,C,1974
36966,56,28,Walt McKechnie,26,80,82,C,1975
36967,34,29,Walt McKechnie,25,80,59,C,1976
36968,23,30,Walt McKechnie,16,69,39,C,1977
36969,36,31,Walt McKechnie,25,79,61,C,1978
36970,40,32,Walt McKechnie,7,71,47,C,1979
36971,23,33,Walt McKechnie,15,53,38,C,1980
36972,37,34,Walt McKechnie,18,74,55,C,1981
36973,29,35,Walt McKechnie,14,64,43,C,1982
36974,4,21,Walt Poddubny,3,15,7,C,1981
36975,31,22,Walt Poddubny,28,72,59,C,1982
36976,14,23,Walt Poddubny,11,38,25,LW,1983
36977,15,24,Walt Poddubny,5,32,20,LW,1984
36978,22,25,Walt Poddubny,12,33,34,LW,1985
36979,47,26,Walt Poddubny,40,75,87,C,1986
36980,50,27,Walt Poddubny,38,77,88,C,1987
36981,37,28,Walt Poddubny,38,72,75,RW,1988
36982,10,29,Walt Poddubny,4,33,14,LW,1989
36983,6,30,Walt Poddubny,4,14,10,LW,1990
36984,2,31,Walt Poddubny,1,7,3,LW,1991
36985,0,20,Walt Tkaczuk,0,2,0,C,1967
36986,24,21,Walt Tkaczuk,12,71,36,C,1968
36987,50,22,Walt Tkaczuk,27,76,77,C,1969
36988,49,23,Walt Tkaczuk,26,77,75,C,1970
36989,42,24,Walt Tkaczuk,24,76,66,C,1971
36990,39,25,Walt Tkaczuk,27,76,66,C,1972
36991,42,26,Walt Tkaczuk,21,71,63,C,1973
36992,25,27,Walt Tkaczuk,11,62,36,C,1974
36993,28,28,Walt Tkaczuk,8,78,36,C,1975
36994,38,29,Walt Tkaczuk,12,80,50,C,1976
36995,40,30,Walt Tkaczuk,26,80,66,C,1977
36996,27,31,Walt Tkaczuk,15,77,42,C,1978
36997,25,32,Walt Tkaczuk,12,76,37,C,1979
36998,22,33,Walt Tkaczuk,6,43,28,C,1980
36999,1,19,Warren Babe,0,6,1,LW,1987
37000,3,20,Warren Babe,2,14,5,LW,1988
37001,1,22,Warren Babe,0,1,1,LW,1990
37002,1,21,Warren Foegele,2,2,3,LW,2017
37003,1,36,Warren Godfrey,0,12,1,D,1967
37004,2,24,Warren Holmes,0,3,2,C,1981
37005,16,25,Warren Holmes,8,39,24,C,1982
37006,0,26,Warren Holmes,0,3,0,C,1983
37007,0,22,Warren Luhning,0,8,0,RW,1997
37008,0,23,Warren Luhning,0,11,0,RW,1998
37009,1,24,Warren Luhning,0,10,1,RW,1999
37010,6,26,Warren Miller,7,55,13,RW,1979
37011,22,27,Warren Miller,22,77,44,RW,1980
37012,12,28,Warren Miller,10,74,22,RW,1981
37013,10,29,Warren Miller,1,56,11,RW,1982
37014,0,26,Warren Peters,1,16,1,C,2008
37015,0,27,Warren Peters,1,11,1,LW,2009
37016,0,28,Warren Peters,1,11,1,LW,2010
37017,4,29,Warren Peters,1,58,5,LW,2011
37018,0,21,Warren Rychel,0,2,0,LW,1988
37019,7,25,Warren Rychel,6,70,13,LW,1992
37020,9,26,Warren Rychel,10,80,19,LW,1993
37021,6,27,Warren Rychel,1,33,7,LW,1994
37022,2,28,Warren Rychel,6,52,8,LW,1995
37023,7,29,Warren Rychel,10,70,17,RW,1996
37024,6,30,Warren Rychel,5,71,11,LW,1997
37025,2,31,Warren Rychel,0,28,2,LW,1998
37026,0,26,Warren Young,0,1,0,C,1981
37027,1,27,Warren Young,1,4,2,C,1982
37028,7,28,Warren Young,1,15,8,C,1983
37029,32,29,Warren Young,40,80,72,LW,1984
37030,24,30,Warren Young,22,79,46,LW,1985
37031,13,31,Warren Young,8,50,21,LW,1986
37032,0,32,Warren Young,0,7,0,LW,1987
37033,36,20,Wayne Babych,27,67,63,RW,1978
37034,35,21,Wayne Babych,26,59,61,RW,1979
37035,42,22,Wayne Babych,54,78,96,RW,1980
37036,25,23,Wayne Babych,19,51,44,RW,1981
37037,23,24,Wayne Babych,16,71,39,RW,1982
37038,29,25,Wayne Babych,13,70,42,RW,1983
37039,34,26,Wayne Babych,20,65,54,RW,1984
37040,22,27,Wayne Babych,17,54,39,RW,1985
37041,0,28,Wayne Babych,0,4,0,RW,1986
37042,13,20,Wayne Bianchin,12,69,25,LW,1973
37043,0,21,Wayne Bianchin,0,2,0,LW,1974
37044,5,22,Wayne Bianchin,1,14,6,LW,1975
37045,6,23,Wayne Bianchin,28,79,34,LW,1976
37046,13,24,Wayne Bianchin,20,61,33,LW,1977
37047,4,25,Wayne Bianchin,7,40,11,LW,1978
37048,0,26,Wayne Bianchin,0,11,0,LW,1979
37049,11,21,Wayne Carleton,8,65,19,LW,1967
37050,3,22,Wayne Carleton,1,12,4,LW,1968
37051,20,23,Wayne Carleton,6,49,26,LW,1969
37052,24,24,Wayne Carleton,22,69,46,LW,1970
37053,14,25,Wayne Carleton,17,76,31,C,1971
37054,4,22,Wayne Cashman,0,12,4,LW,1967
37055,23,23,Wayne Cashman,8,51,31,LW,1968
37056,26,24,Wayne Cashman,9,70,35,LW,1969
37057,58,25,Wayne Cashman,21,77,79,LW,1970
37058,29,26,Wayne Cashman,23,74,52,LW,1971
37059,39,27,Wayne Cashman,29,76,68,LW,1972
37060,59,28,Wayne Cashman,30,78,89,LW,1973
37061,22,29,Wayne Cashman,11,42,33,LW,1974
37062,43,30,Wayne Cashman,28,80,71,LW,1975
37063,37,31,Wayne Cashman,15,65,52,LW,1976
37064,38,32,Wayne Cashman,24,76,62,LW,1977
37065,40,33,Wayne Cashman,27,75,67,LW,1978
37066,21,34,Wayne Cashman,11,44,32,LW,1979
37067,35,35,Wayne Cashman,25,77,60,LW,1980
37068,31,36,Wayne Cashman,12,64,43,LW,1981
37069,11,37,Wayne Cashman,4,65,15,LW,1982
37070,21,28,Wayne Connelly,35,74,56,RW,1967
37071,25,29,Wayne Connelly,18,74,43,RW,1968
37072,36,30,Wayne Connelly,23,76,59,RW,1969
37073,29,31,Wayne Connelly,13,79,42,RW,1970
37074,25,32,Wayne Connelly,19,68,44,RW,1971
37075,24,20,Wayne Dillon,21,79,45,C,1975
37076,29,21,Wayne Dillon,17,78,46,C,1976
37077,13,22,Wayne Dillon,5,59,18,C,1977
37078,0,24,Wayne Dillon,0,13,0,C,1979
37079,86,19,Wayne Gretzky,51,79,137,C,1979
37080,109,20,Wayne Gretzky,55,80,164,C,1980
37081,120,21,Wayne Gretzky,92,80,212,C,1981
37082,125,22,Wayne Gretzky,71,80,196,C,1982
37083,118,23,Wayne Gretzky,87,74,205,C,1983
37084,135,24,Wayne Gretzky,73,80,208,C,1984
37085,163,25,Wayne Gretzky,52,80,215,C,1985
37086,121,26,Wayne Gretzky,62,79,183,C,1986
37087,109,27,Wayne Gretzky,40,64,149,C,1987
37088,114,28,Wayne Gretzky,54,78,168,C,1988
37089,102,29,Wayne Gretzky,40,73,142,C,1989
37090,122,30,Wayne Gretzky,41,78,163,C,1990
37091,90,31,Wayne Gretzky,31,74,121,C,1991
37092,49,32,Wayne Gretzky,16,45,65,C,1992
37093,92,33,Wayne Gretzky,38,81,130,C,1993
37094,37,34,Wayne Gretzky,11,48,48,C,1994
37095,79,35,Wayne Gretzky,23,80,102,C,1995
37096,72,36,Wayne Gretzky,25,82,97,C,1996
37097,67,37,Wayne Gretzky,23,82,90,C,1997
37098,53,38,Wayne Gretzky,9,70,62,C,1998
37099,0,19,Wayne Groulx,0,1,0,C,1984
37100,14,30,Wayne Hicks,6,47,20,RW,1967
37101,5,29,Wayne Hillman,0,62,5,D,1967
37102,8,30,Wayne Hillman,0,50,8,D,1968
37103,5,31,Wayne Hillman,3,68,8,D,1969
37104,7,32,Wayne Hillman,5,69,12,D,1970
37105,3,33,Wayne Hillman,0,47,3,D,1971
37106,10,34,Wayne Hillman,0,74,10,D,1972
37107,0,22,Wayne King,0,2,0,C,1973
37108,7,23,Wayne King,4,25,11,C,1974
37109,11,24,Wayne King,1,46,12,C,1975
37110,5,23,Wayne Maki,5,49,10,LW,1967
37111,0,24,Wayne Maki,0,1,0,LW,1968
37112,1,25,Wayne Maki,2,16,3,LW,1969
37113,38,26,Wayne Maki,25,78,63,LW,1970
37114,25,27,Wayne Maki,22,76,47,LW,1971
37115,10,28,Wayne Maki,3,26,13,LW,1972
37116,1,18,Wayne McBean,0,27,1,D,1987
37117,6,19,Wayne McBean,0,52,6,D,1988
37118,1,20,Wayne McBean,0,5,1,D,1989
37119,14,21,Wayne McBean,5,52,19,D,1990
37120,4,22,Wayne McBean,2,25,6,D,1991
37121,13,24,Wayne McBean,3,50,16,D,1993
37122,11,20,Wayne Merrick,10,50,21,C,1972
37123,23,21,Wayne Merrick,20,64,43,C,1973
37124,37,22,Wayne Merrick,28,76,65,C,1974
37125,35,23,Wayne Merrick,32,75,67,C,1975
37126,38,24,Wayne Merrick,18,80,56,C,1976
37127,19,25,Wayne Merrick,12,55,31,C,1977
37128,21,26,Wayne Merrick,20,75,41,C,1978
37129,22,27,Wayne Merrick,13,70,35,C,1979
37130,15,28,Wayne Merrick,16,71,31,C,1980
37131,27,29,Wayne Merrick,12,68,39,C,1981
37132,12,30,Wayne Merrick,4,59,16,C,1982
37133,5,31,Wayne Merrick,6,31,11,C,1983
37134,6,28,Wayne Muloin,3,71,9,D,1969
37135,14,29,Wayne Muloin,0,73,14,D,1970
37136,1,19,Wayne Presley,0,3,1,RW,1984
37137,8,20,Wayne Presley,7,38,15,RW,1985
37138,29,21,Wayne Presley,32,80,61,RW,1986
37139,10,22,Wayne Presley,12,42,22,RW,1987
37140,19,23,Wayne Presley,21,72,40,RW,1988
37141,7,24,Wayne Presley,6,49,13,RW,1989
37142,19,25,Wayne Presley,15,71,34,RW,1990
37143,16,26,Wayne Presley,10,59,26,RW,1991
37144,17,27,Wayne Presley,15,79,32,RW,1992
37145,8,28,Wayne Presley,17,65,25,RW,1993
37146,5,29,Wayne Presley,14,46,19,RW,1994
37147,8,30,Wayne Presley,6,80,14,RW,1995
37148,0,18,Wayne Primeau,1,1,1,C,1994
37149,0,19,Wayne Primeau,0,2,0,C,1995
37150,4,20,Wayne Primeau,2,45,6,C,1996
37151,6,21,Wayne Primeau,6,69,12,C,1997
37152,8,22,Wayne Primeau,5,67,13,C,1998
37153,10,23,Wayne Primeau,7,58,17,C,1999
37154,19,24,Wayne Primeau,3,75,22,C,2000
37155,7,25,Wayne Primeau,3,33,10,C,2001
37156,12,26,Wayne Primeau,6,77,18,C,2002
37157,20,27,Wayne Primeau,9,72,29,LW,2003
37158,11,29,Wayne Primeau,11,71,22,C,2005
37159,12,30,Wayne Primeau,10,78,22,C,2006
37160,7,31,Wayne Primeau,3,43,10,C,2007
37161,4,32,Wayne Primeau,0,24,4,C,2008
37162,5,33,Wayne Primeau,3,59,8,C,2009
37163,0,21,Wayne Ramsey,0,2,0,D,1977
37164,4,25,Wayne Rivers,4,22,8,RW,1967
37165,0,26,Wayne Rivers,0,4,0,RW,1968
37166,14,20,Wayne Simmonds,9,82,23,RW,2008
37167,24,21,Wayne Simmonds,16,78,40,RW,2009
37168,16,22,Wayne Simmonds,14,80,30,RW,2010
37169,21,23,Wayne Simmonds,28,82,49,RW,2011
37170,17,24,Wayne Simmonds,15,45,32,RW,2012
37171,31,25,Wayne Simmonds,29,82,60,RW,2013
37172,22,26,Wayne Simmonds,28,75,50,RW,2014
37173,28,27,Wayne Simmonds,32,81,60,RW,2015
37174,23,28,Wayne Simmonds,31,82,54,RW,2016
37175,22,29,Wayne Simmonds,24,75,46,RW,2017
37176,0,25,Wayne Van Dorp,0,3,0,LW,1986
37177,3,26,Wayne Van Dorp,1,25,4,LW,1987
37178,0,27,Wayne Van Dorp,0,8,0,LW,1988
37179,4,28,Wayne Van Dorp,7,61,11,LW,1989
37180,0,29,Wayne Van Dorp,1,4,1,LW,1990
37181,5,30,Wayne Van Dorp,3,24,8,LW,1991
37182,11,19,Wendel Clark,34,66,45,LW,1985
37183,23,20,Wendel Clark,37,80,60,LW,1986
37184,11,21,Wendel Clark,12,28,23,LW,1987
37185,4,22,Wendel Clark,7,15,11,LW,1988
37186,8,23,Wendel Clark,18,38,26,LW,1989
37187,16,24,Wendel Clark,18,63,34,LW,1990
37188,21,25,Wendel Clark,19,43,40,LW,1991
37189,22,26,Wendel Clark,17,66,39,LW,1992
37190,30,27,Wendel Clark,46,64,76,LW,1993
37191,18,28,Wendel Clark,12,37,30,LW,1994
37192,26,29,Wendel Clark,32,71,58,LW,1995
37193,19,30,Wendel Clark,30,65,49,LW,1996
37194,7,31,Wendel Clark,12,47,19,LW,1997
37195,16,32,Wendel Clark,32,77,48,LW,1998
37196,2,33,Wendel Clark,4,33,6,LW,1999
37197,15,21,Wes Jarvis,11,63,26,C,1979
37198,14,22,Wes Jarvis,9,55,23,C,1980
37199,12,23,Wes Jarvis,1,26,13,C,1981
37200,0,24,Wes Jarvis,0,3,0,C,1982
37201,13,25,Wes Jarvis,9,61,22,C,1983
37202,1,26,Wes Jarvis,0,26,1,C,1984
37203,0,27,Wes Jarvis,1,2,1,C,1985
37204,0,29,Wes Jarvis,0,1,0,C,1987
37205,0,22,Wes O'Neill,0,3,0,D,2008
37206,0,23,Wes O'Neill,0,2,0,D,2009
37207,1,19,Wes Walz,1,2,2,C,1989
37208,8,20,Wes Walz,8,56,16,C,1990
37209,3,21,Wes Walz,1,17,4,C,1991
37210,27,23,Wes Walz,11,53,38,RW,1993
37211,12,24,Wes Walz,6,39,18,RW,1994
37212,0,25,Wes Walz,0,2,0,C,1995
37213,12,30,Wes Walz,18,82,30,C,2000
37214,20,31,Wes Walz,10,64,30,C,2001
37215,19,32,Wes Walz,13,80,32,C,2002
37216,13,33,Wes Walz,12,57,25,C,2003
37217,18,35,Wes Walz,19,82,37,C,2005
37218,15,36,Wes Walz,9,62,24,C,2006
37219,3,37,Wes Walz,1,11,4,C,2007
37220,13,19,Wilf Paiement,26,78,39,RW,1974
37221,22,20,Wilf Paiement,21,57,43,RW,1975
37222,40,21,Wilf Paiement,41,78,81,RW,1976
37223,56,22,Wilf Paiement,31,80,87,RW,1977
37224,36,23,Wilf Paiement,24,65,60,RW,1978
37225,44,24,Wilf Paiement,30,75,74,RW,1979
37226,57,25,Wilf Paiement,40,77,97,RW,1980
37227,46,26,Wilf Paiement,25,77,71,RW,1981
37228,38,27,Wilf Paiement,26,80,64,RW,1982
37229,37,28,Wilf Paiement,39,80,76,RW,1983
37230,28,29,Wilf Paiement,23,68,51,RW,1984
37231,18,30,Wilf Paiement,8,52,26,RW,1985
37232,17,31,Wilf Paiement,20,56,37,RW,1986
37233,6,32,Wilf Paiement,2,23,8,RW,1987
37234,2,26,Will Acton,3,30,5,C,2013
37235,0,27,Will Acton,0,3,0,C,2014
37236,39,23,Will Butcher,5,81,44,D,2017
37237,0,29,Will O'Neill,0,1,0,D,2017
37238,0,20,Willi Plett,0,4,0,RW,1975
37239,23,21,Willi Plett,33,64,56,RW,1976
37240,21,22,Willi Plett,22,78,43,RW,1977
37241,20,23,Willi Plett,23,74,43,RW,1978
37242,19,24,Willi Plett,13,76,32,RW,1979
37243,30,25,Willi Plett,38,78,68,RW,1980
37244,36,26,Willi Plett,21,78,57,RW,1981
37245,14,27,Willi Plett,25,71,39,RW,1982
37246,23,28,Willi Plett,15,73,38,RW,1983
37247,14,29,Willi Plett,14,47,28,RW,1984
37248,7,30,Willi Plett,10,59,17,RW,1985
37249,5,31,Willi Plett,6,67,11,RW,1986
37250,3,32,Willi Plett,2,65,5,RW,1987
37251,3,22,William Carrier,5,41,8,LW,2016
37252,2,23,William Carrier,1,37,3,LW,2017
37253,17,32,William Harris,12,62,29,C,1967
37254,17,33,William Harris,7,73,24,C,1968
37255,2,22,William Karlsson,3,21,5,C,2014
37256,11,23,William Karlsson,9,81,20,C,2015
37257,19,24,William Karlsson,6,81,25,C,2016
37258,35,25,William Karlsson,43,82,78,C,2017
37259,7,19,William Nylander,6,22,13,C,2015
37260,39,20,William Nylander,22,81,61,C,2016
37261,41,21,William Nylander,20,82,61,C,2017
37262,0,21,Willie Brossart,0,1,0,D,1970
37263,4,22,Willie Brossart,0,42,4,D,1971
37264,1,23,Willie Brossart,0,4,1,D,1972
37265,1,24,Willie Brossart,0,17,1,D,1973
37266,0,25,Willie Brossart,1,16,1,D,1974
37267,8,26,Willie Brossart,0,49,8,D,1975
37268,24,21,Willie Huber,7,68,31,D,1978
37269,23,22,Willie Huber,17,76,40,D,1979
37270,34,23,Willie Huber,15,80,49,D,1980
37271,30,24,Willie Huber,15,74,45,D,1981
37272,29,25,Willie Huber,14,74,43,D,1982
37273,14,26,Willie Huber,9,42,23,D,1983
37274,11,27,Willie Huber,3,49,14,D,1984
37275,8,28,Willie Huber,7,70,15,D,1985
37276,22,29,Willie Huber,8,66,30,D,1986
37277,22,30,Willie Huber,9,56,31,D,1987
37278,0,22,Willie Mitchell,0,2,0,D,1999
37279,9,23,Willie Mitchell,1,33,10,D,2000
37280,10,24,Willie Mitchell,3,68,13,D,2001
37281,12,25,Willie Mitchell,2,69,14,D,2002
37282,13,26,Willie Mitchell,1,70,14,D,2003
37283,8,28,Willie Mitchell,2,80,10,D,2005
37284,10,29,Willie Mitchell,1,62,11,D,2006
37285,10,30,Willie Mitchell,2,72,12,D,2007
37286,20,31,Willie Mitchell,3,82,23,D,2008
37287,8,32,Willie Mitchell,4,48,12,D,2009
37288,5,33,Willie Mitchell,5,57,10,D,2010
37289,19,34,Willie Mitchell,5,76,24,D,2011
37290,11,36,Willie Mitchell,1,76,12,D,2013
37291,5,37,Willie Mitchell,3,66,8,D,2014
37292,6,38,Willie Mitchell,1,46,7,D,2015
37293,26,28,Willy Lindstrom,23,79,49,RW,1979
37294,13,29,Willy Lindstrom,22,72,35,RW,1980
37295,27,30,Willy Lindstrom,32,74,59,RW,1981
37296,30,31,Willy Lindstrom,26,73,56,RW,1982
37297,16,32,Willy Lindstrom,22,73,38,RW,1983
37298,20,33,Willy Lindstrom,12,80,32,LW,1984
37299,17,34,Willy Lindstrom,14,71,31,RW,1985
37300,13,35,Willy Lindstrom,10,60,23,RW,1986
37301,4,19,Wojtek Wolski,2,9,6,LW,2005
37302,28,20,Wojtek Wolski,22,76,50,LW,2006
37303,30,21,Wojtek Wolski,18,77,48,LW,2007
37304,28,22,Wojtek Wolski,14,78,42,LW,2008
37305,42,23,Wojtek Wolski,23,80,65,LW,2009
37306,23,24,Wojtek Wolski,12,73,35,LW,2010
37307,8,25,Wojtek Wolski,4,31,12,LW,2011
37308,5,26,Wojtek Wolski,4,27,9,LW,2012
37309,0,22,Wyatt Smith,0,2,0,C,1999
37310,7,23,Wyatt Smith,3,42,10,C,2000
37311,0,24,Wyatt Smith,0,10,0,LW,2001
37312,0,25,Wyatt Smith,1,11,1,C,2002
37313,1,26,Wyatt Smith,3,18,4,C,2003
37314,8,28,Wyatt Smith,0,42,8,C,2005
37315,3,29,Wyatt Smith,3,61,6,C,2006
37316,3,30,Wyatt Smith,0,25,3,C,2007
37317,0,21,Xavier Delisle,0,2,0,C,1998
37318,2,23,Xavier Delisle,3,14,5,C,2000
37319,0,20,Xavier Ouellet,0,4,0,D,2013
37320,1,21,Xavier Ouellet,2,21,3,D,2014
37321,1,22,Xavier Ouellet,0,5,1,D,2015
37322,9,23,Xavier Ouellet,3,66,12,D,2016
37323,7,24,Xavier Ouellet,0,45,7,D,2017
37324,2,21,Yan Golubovsky,0,12,2,D,1997
37325,1,22,Yan Golubovsky,0,17,1,D,1998
37326,2,23,Yan Golubovsky,1,21,3,D,1999
37327,2,24,Yan Golubovsky,0,6,2,D,2000
37328,1,22,Yan Kaminsky,2,24,3,RW,1993
37329,1,23,Yan Kaminsky,1,2,2,LW,1994
37330,3,23,Yan Stastny,1,20,4,C,2005
37331,2,24,Yan Stastny,0,21,2,C,2006
37332,1,25,Yan Stastny,1,12,2,C,2007
37333,4,26,Yan Stastny,3,34,7,C,2008
37334,0,27,Yan Stastny,1,4,1,C,2009
37335,3,22,Yanic Perreault,3,13,6,C,1993
37336,5,23,Yanic Perreault,2,26,7,C,1994
37337,24,24,Yanic Perreault,25,78,49,C,1995
37338,14,25,Yanic Perreault,11,41,25,C,1996
37339,20,26,Yanic Perreault,28,79,48,C,1997
37340,25,27,Yanic Perreault,17,76,42,C,1998
37341,27,28,Yanic Perreault,18,58,45,C,1999
37342,28,29,Yanic Perreault,24,76,52,C,2000
37343,29,30,Yanic Perreault,27,82,56,C,2001
37344,22,31,Yanic Perreault,24,73,46,C,2002
37345,15,32,Yanic Perreault,16,69,31,C,2003
37346,35,34,Yanic Perreault,22,69,57,C,2005
37347,17,35,Yanic Perreault,21,66,38,C,2006
37348,5,36,Yanic Perreault,9,53,14,C,2007
37349,0,19,Yanick Dupre,0,1,0,LW,1991
37350,0,22,Yanick Dupre,0,22,0,LW,1994
37351,0,23,Yanick Dupre,2,12,2,LW,1995
37352,0,23,Yanick Lehoux,1,3,1,C,2005
37353,2,24,Yanick Lehoux,1,7,3,C,2006
37354,0,20,Yann Sauve,0,5,0,D,2010
37355,0,23,Yann Sauve,0,3,0,D,2013
37356,1,24,Yanni Gourde,0,2,1,C,2015
37357,2,25,Yanni Gourde,6,20,8,C,2016
37358,39,26,Yanni Gourde,25,82,64,C,2017
37359,0,21,Yannick Tremblay,0,5,0,D,1996
37360,4,22,Yannick Tremblay,2,38,6,D,1997
37361,7,23,Yannick Tremblay,2,35,9,D,1998
37362,21,24,Yannick Tremblay,10,75,31,D,1999
37363,8,25,Yannick Tremblay,4,46,12,D,2000
37364,15,26,Yannick Tremblay,9,66,24,D,2001
37365,22,27,Yannick Tremblay,8,75,30,D,2002
37366,8,28,Yannick Tremblay,2,38,10,D,2003
37367,2,31,Yannick Tremblay,1,12,3,D,2006
37368,1,20,Yannick Weber,0,3,1,D,2008
37369,0,21,Yannick Weber,0,5,0,D,2009
37370,10,22,Yannick Weber,1,41,11,D,2010
37371,14,23,Yannick Weber,4,60,18,D,2011
37372,2,24,Yannick Weber,0,6,2,D,2012
37373,4,25,Yannick Weber,6,49,10,D,2013
37374,10,26,Yannick Weber,11,65,21,D,2014
37375,7,27,Yannick Weber,0,45,7,D,2015
37376,7,28,Yannick Weber,1,73,8,D,2016
37377,3,29,Yannick Weber,2,47,5,D,2017
37378,0,21,Yevgeny Shaldybin,1,3,1,D,1996
37379,2,27,Yohann Auvitu,2,25,4,D,2016
37380,6,28,Yohann Auvitu,3,33,9,D,2017
37381,0,23,Yuri Babenko,0,3,0,C,2000
37382,3,21,Yuri Butsayev,5,57,8,C,1999
37383,1,22,Yuri Butsayev,1,15,2,C,2000
37384,0,23,Yuri Butsayev,2,11,2,C,2001
37385,0,24,Yuri Butsayev,2,16,2,LW,2002
37386,19,28,Yuri Khmylev,20,68,39,LW,1992
37387,31,29,Yuri Khmylev,27,72,58,LW,1993
37388,17,30,Yuri Khmylev,8,48,25,LW,1994
37389,21,31,Yuri Khmylev,8,73,29,LW,1995
37390,0,32,Yuri Khmylev,1,2,1,LW,1996
37391,32,24,Yvan Cournoyer,28,64,60,RW,1967
37392,44,25,Yvan Cournoyer,43,76,87,RW,1968
37393,36,26,Yvan Cournoyer,27,72,63,RW,1969
37394,36,27,Yvan Cournoyer,37,65,73,RW,1970
37395,36,28,Yvan Cournoyer,47,73,83,RW,1971
37396,39,29,Yvan Cournoyer,40,67,79,RW,1972
37397,33,30,Yvan Cournoyer,40,67,73,RW,1973
37398,45,31,Yvan Cournoyer,29,76,74,RW,1974
37399,36,32,Yvan Cournoyer,32,71,68,RW,1975
37400,28,33,Yvan Cournoyer,25,60,53,RW,1976
37401,29,34,Yvan Cournoyer,24,68,53,RW,1977
37402,5,35,Yvan Cournoyer,2,15,7,RW,1978
37403,0,20,Yvan Joly,0,1,0,RW,1980
37404,0,22,Yvan Joly,0,1,0,RW,1982
37405,0,21,Yves Beaudoin,0,4,0,D,1985
37406,0,22,Yves Beaudoin,0,6,0,D,1986
37407,0,23,Yves Beaudoin,0,1,0,D,1987
37408,0,23,Yves Bergeron,0,2,0,RW,1974
37409,0,25,Yves Bergeron,0,1,0,RW,1976
37410,4,20,Yves Courteau,1,14,5,RW,1984
37411,1,21,Yves Courteau,1,4,2,RW,1985
37412,0,22,Yves Courteau,0,4,0,RW,1986
37413,0,21,Yves Heroux,0,1,0,RW,1986
37414,1,22,Yves Preston,3,9,4,LW,1978
37415,2,24,Yves Preston,4,19,6,LW,1980
37416,9,20,Yves Racine,4,28,13,D,1989
37417,40,21,Yves Racine,7,62,47,D,1990
37418,22,22,Yves Racine,2,61,24,D,1991
37419,31,23,Yves Racine,9,80,40,D,1992
37420,43,24,Yves Racine,9,67,52,D,1993
37421,7,25,Yves Racine,4,47,11,D,1994
37422,19,26,Yves Racine,1,57,20,D,1995
37423,15,27,Yves Racine,1,46,16,D,1996
37424,8,28,Yves Racine,0,60,8,D,1997
37425,1,22,Yves Sarault,0,8,1,LW,1994
37426,1,23,Yves Sarault,2,25,3,LW,1995
37427,1,24,Yves Sarault,2,28,3,LW,1996
37428,0,25,Yves Sarault,1,2,1,LW,1997
37429,1,26,Yves Sarault,0,11,1,LW,1998
37430,2,27,Yves Sarault,0,11,2,LW,1999
37431,4,28,Yves Sarault,5,20,9,LW,2000
37432,0,29,Yves Sarault,0,1,0,LW,2001
37433,0,18,Yvon Corriveau,0,2,0,LW,1985
37434,1,19,Yvon Corriveau,1,17,2,LW,1986
37435,9,20,Yvon Corriveau,10,44,19,LW,1987
37436,2,21,Yvon Corriveau,3,33,5,LW,1988
37437,7,22,Yvon Corriveau,13,63,20,RW,1989
37438,1,23,Yvon Corriveau,1,23,2,LW,1990
37439,8,24,Yvon Corriveau,12,38,20,LW,1991
37440,12,25,Yvon Corriveau,8,57,20,RW,1992
37441,0,26,Yvon Corriveau,0,3,0,RW,1993
37442,1,21,Yvon Labre,1,21,2,D,1970
37443,2,24,Yvon Labre,1,16,3,D,1973
37444,23,25,Yvon Labre,4,76,27,D,1974
37445,20,26,Yvon Labre,2,80,22,D,1975
37446,11,27,Yvon Labre,3,62,14,D,1976
37447,8,28,Yvon Labre,0,22,8,D,1977
37448,13,29,Yvon Labre,1,51,14,D,1978
37449,5,30,Yvon Labre,0,18,5,D,1979
37450,4,31,Yvon Labre,2,25,6,D,1980
37451,0,22,Yvon Lambert,0,1,0,LW,1972
37452,10,23,Yvon Lambert,6,60,16,LW,1973
37453,35,24,Yvon Lambert,32,80,67,LW,1974
37454,35,25,Yvon Lambert,32,80,67,LW,1975
37455,28,26,Yvon Lambert,24,79,52,LW,1976
37456,22,27,Yvon Lambert,18,77,40,LW,1977
37457,40,28,Yvon Lambert,26,79,66,LW,1978
37458,32,29,Yvon Lambert,21,77,53,LW,1979
37459,32,30,Yvon Lambert,22,73,54,LW,1980
37460,39,31,Yvon Lambert,25,77,64,LW,1981
37461,1,23,Yvon Vautour,3,17,4,RW,1979
37462,19,24,Yvon Vautour,15,74,34,RW,1980
37463,2,25,Yvon Vautour,1,14,3,RW,1981
37464,7,26,Yvon Vautour,4,52,11,RW,1982
37465,4,27,Yvon Vautour,3,42,7,RW,1983
37466,0,28,Yvon Vautour,0,5,0,RW,1984
37467,0,23,Zac Boyer,0,1,0,RW,1994
37468,0,24,Zac Boyer,0,2,0,RW,1995
37469,1,21,Zac Dalpe,3,15,4,C,2010
37470,2,22,Zac Dalpe,1,16,3,C,2011
37471,2,23,Zac Dalpe,1,10,3,C,2012
37472,3,24,Zac Dalpe,4,55,7,C,2013
37473,2,25,Zac Dalpe,1,21,3,C,2014
37474,0,26,Zac Dalpe,1,2,1,C,2015
37475,2,27,Zac Dalpe,1,9,3,C,2016
37476,0,28,Zac Dalpe,0,12,0,C,2017
37477,7,21,Zac Rinaldo,2,66,9,C,2011
37478,2,22,Zac Rinaldo,3,32,5,C,2012
37479,2,23,Zac Rinaldo,2,67,4,C,2013
37480,5,24,Zac Rinaldo,1,58,6,C,2014
37481,2,25,Zac Rinaldo,1,52,3,C,2015
37482,2,27,Zac Rinaldo,5,53,7,LW,2017
37483,2,23,Zach Aston-Reese,4,16,6,C,2017
37484,10,18,Zach Bogosian,9,47,19,D,2008
37485,13,19,Zach Bogosian,10,81,23,D,2009
37486,12,20,Zach Bogosian,5,71,17,D,2010
37487,25,21,Zach Bogosian,5,65,30,D,2011
37488,9,22,Zach Bogosian,5,33,14,D,2012
37489,8,23,Zach Bogosian,3,55,11,D,2013
37490,17,24,Zach Bogosian,3,62,20,D,2014
37491,17,25,Zach Bogosian,7,64,24,D,2015
37492,9,26,Zach Bogosian,2,56,11,D,2016
37493,1,27,Zach Bogosian,0,18,1,D,2017
37494,0,19,Zach Boychuk,0,2,0,C,2008
37495,6,20,Zach Boychuk,3,31,9,C,2009
37496,3,21,Zach Boychuk,4,23,7,C,2010
37497,2,22,Zach Boychuk,0,16,2,C,2011
37498,1,23,Zach Boychuk,1,13,2,C,2012
37499,3,24,Zach Boychuk,1,11,4,LW,2013
37500,3,25,Zach Boychuk,3,31,6,LW,2014
37501,1,21,Zach Hamill,0,1,1,C,2009
37502,1,22,Zach Hamill,0,3,1,C,2010
37503,2,23,Zach Hamill,0,16,2,C,2011
37504,2,23,Zach Hyman,4,16,6,C,2015
37505,18,24,Zach Hyman,10,82,28,C,2016
37506,25,25,Zach Hyman,15,82,40,C,2017
37507,18,21,Zach Parise,14,81,32,C,2005
37508,31,22,Zach Parise,31,82,62,LW,2006
37509,33,23,Zach Parise,32,81,65,LW,2007
37510,49,24,Zach Parise,45,82,94,LW,2008
37511,44,25,Zach Parise,38,81,82,C,2009
37512,3,26,Zach Parise,3,13,6,C,2010
37513,38,27,Zach Parise,31,82,69,C,2011
37514,20,28,Zach Parise,18,48,38,C,2012
37515,27,29,Zach Parise,29,67,56,LW,2013
37516,29,30,Zach Parise,33,74,62,LW,2014
37517,28,31,Zach Parise,25,70,53,LW,2015
37518,23,32,Zach Parise,19,69,42,LW,2016
37519,9,33,Zach Parise,15,42,24,LW,2017
37520,3,24,Zach Redmond,1,8,4,D,2012
37521,2,25,Zach Redmond,1,10,3,D,2013
37522,15,26,Zach Redmond,5,59,20,D,2014
37523,4,27,Zach Redmond,2,37,6,D,2015
37524,5,28,Zach Redmond,0,16,5,D,2016
37525,0,29,Zach Redmond,0,3,0,D,2017
37526,0,25,Zach Sill,0,20,0,C,2013
37527,3,26,Zach Sill,1,63,4,C,2014
37528,0,27,Zach Sill,1,10,1,C,2015
37529,0,23,Zach Trotman,0,2,0,D,2013
37530,4,24,Zach Trotman,1,27,5,D,2014
37531,5,25,Zach Trotman,2,38,7,D,2015
37532,0,27,Zach Trotman,0,3,0,D,2017
37533,36,19,Zach Werenski,11,78,47,D,2016
37534,21,20,Zach Werenski,16,77,37,D,2017
37535,0,21,Zach Whitecloud,0,1,0,D,2017
37536,3,22,Zachary Sanford,2,13,5,LW,2016
37537,0,22,Zack Fitzgerald,0,1,0,D,2007
37538,6,21,Zack Kassian,4,44,10,RW,2011
37539,4,22,Zack Kassian,7,39,11,RW,2012
37540,15,23,Zack Kassian,14,73,29,RW,2013
37541,6,24,Zack Kassian,10,42,16,RW,2014
37542,5,25,Zack Kassian,3,36,8,RW,2015
37543,17,26,Zack Kassian,7,79,24,RW,2016
37544,12,27,Zack Kassian,7,74,19,RW,2017
37545,0,24,Zack Mitchell,0,11,0,RW,2016
37546,2,25,Zack Mitchell,3,23,5,RW,2017
37547,0,20,Zack Smith,0,1,0,C,2008
37548,1,21,Zack Smith,2,15,3,C,2009
37549,5,22,Zack Smith,4,55,9,C,2010
37550,12,23,Zack Smith,14,81,26,C,2011
37551,11,24,Zack Smith,4,48,15,C,2012
37552,9,25,Zack Smith,13,82,22,C,2013
37553,1,26,Zack Smith,2,37,3,C,2014
37554,11,27,Zack Smith,25,81,36,C,2015
37555,16,28,Zack Smith,16,74,32,C,2016
37556,14,29,Zack Smith,5,68,19,LW,2017
37557,0,21,Zack Stortini,1,29,1,RW,2006
37558,9,22,Zack Stortini,3,66,12,RW,2007
37559,5,23,Zack Stortini,6,52,11,RW,2008
37560,9,24,Zack Stortini,4,77,13,RW,2009
37561,4,25,Zack Stortini,0,32,4,RW,2010
37562,0,26,Zack Stortini,0,1,0,RW,2011
37563,8,19,Zarley Zalapski,3,15,11,D,1987
37564,33,20,Zarley Zalapski,12,58,45,D,1988
37565,25,21,Zarley Zalapski,6,51,31,D,1989
37566,39,22,Zarley Zalapski,15,77,54,D,1990
37567,37,23,Zarley Zalapski,20,79,57,D,1991
37568,51,24,Zarley Zalapski,14,83,65,D,1992
37569,37,25,Zarley Zalapski,10,69,47,D,1993
37570,24,26,Zarley Zalapski,4,48,28,D,1994
37571,17,27,Zarley Zalapski,12,80,29,D,1995
37572,0,28,Zarley Zalapski,0,2,0,D,1996
37573,12,29,Zarley Zalapski,3,63,15,D,1997
37574,2,31,Zarley Zalapski,0,12,2,D,1999
37575,1,21,Zbynek Michalek,1,22,2,D,2003
37576,15,23,Zbynek Michalek,9,82,24,D,2005
37577,24,24,Zbynek Michalek,4,82,28,D,2006
37578,13,25,Zbynek Michalek,4,75,17,D,2007
37579,21,26,Zbynek Michalek,6,82,27,D,2008
37580,14,27,Zbynek Michalek,3,72,17,D,2009
37581,14,28,Zbynek Michalek,5,73,19,D,2010
37582,11,29,Zbynek Michalek,2,62,13,D,2011
37583,2,30,Zbynek Michalek,0,34,2,D,2012
37584,8,31,Zbynek Michalek,2,59,10,D,2013
37585,8,32,Zbynek Michalek,4,68,12,D,2014
37586,5,33,Zbynek Michalek,2,70,7,D,2015
37587,0,34,Zbynek Michalek,0,3,0,D,2016
37588,0,22,Zdenek Blatny,0,4,0,LW,2002
37589,0,23,Zdenek Blatny,3,16,3,LW,2003
37590,0,25,Zdenek Blatny,0,5,0,LW,2005
37591,2,20,Zdenek Kutlak,0,10,2,D,2000
37592,0,22,Zdenek Kutlak,1,4,1,D,2002
37593,0,23,Zdenek Kutlak,0,2,0,D,2003
37594,0,19,Zdenek Nedved,0,1,0,RW,1994
37595,1,20,Zdenek Nedved,1,7,2,RW,1995
37596,5,21,Zdenek Nedved,3,23,8,RW,1996
37597,1,20,Zdeno Chara,0,25,1,D,1997
37598,6,21,Zdeno Chara,2,59,8,D,1998
37599,9,22,Zdeno Chara,2,65,11,D,1999
37600,7,23,Zdeno Chara,2,82,9,D,2000
37601,13,24,Zdeno Chara,10,75,23,D,2001
37602,30,25,Zdeno Chara,9,74,39,D,2002
37603,25,26,Zdeno Chara,16,79,41,D,2003
37604,27,28,Zdeno Chara,16,71,43,D,2005
37605,32,29,Zdeno Chara,11,80,43,D,2006
37606,34,30,Zdeno Chara,17,77,51,D,2007
37607,31,31,Zdeno Chara,19,80,50,D,2008
37608,37,32,Zdeno Chara,7,80,44,D,2009
37609,30,33,Zdeno Chara,14,81,44,D,2010
37610,40,34,Zdeno Chara,12,79,52,D,2011
37611,12,35,Zdeno Chara,7,48,19,D,2012
37612,23,36,Zdeno Chara,17,77,40,D,2013
37613,12,37,Zdeno Chara,8,63,20,D,2014
37614,28,38,Zdeno Chara,9,80,37,D,2015
37615,19,39,Zdeno Chara,10,75,29,D,2016
37616,17,40,Zdeno Chara,7,73,24,D,2017
37617,17,21,Zdeno Ciger,8,45,25,LW,1990
37618,5,22,Zdeno Ciger,6,20,11,LW,1991
37619,23,23,Zdeno Ciger,13,64,36,RW,1992
37620,35,24,Zdeno Ciger,22,84,57,RW,1993
37621,2,25,Zdeno Ciger,2,5,4,LW,1994
37622,39,26,Zdeno Ciger,31,78,70,LW,1995
37623,13,32,Zdeno Ciger,12,56,25,LW,2001
37624,14,20,Zemgus Girgensons,8,70,22,C,2013
37625,15,21,Zemgus Girgensons,15,61,30,C,2014
37626,11,22,Zemgus Girgensons,7,71,18,C,2015
37627,9,23,Zemgus Girgensons,7,75,16,C,2016
37628,8,24,Zemgus Girgensons,7,71,15,C,2017
37629,1,21,Zenith Komarniski,1,18,2,D,1999
37630,0,24,Zenith Komarniski,0,1,0,LW,2002
37631,0,25,Zenith Komarniski,0,2,0,D,2003
37632,3,25,Zenon Konopka,4,23,7,C,2005
37633,0,26,Zenon Konopka,0,6,0,C,2006
37634,0,27,Zenon Konopka,0,3,0,C,2007
37635,1,28,Zenon Konopka,0,7,1,C,2008
37636,3,29,Zenon Konopka,2,74,5,C,2009
37637,7,30,Zenon Konopka,2,82,9,C,2010
37638,2,31,Zenon Konopka,3,55,5,C,2011
37639,0,32,Zenon Konopka,0,37,0,C,2012
37640,2,33,Zenon Konopka,1,59,3,C,2013
37641,0,21,Ziggy Palffy,0,5,0,LW,1993
37642,7,22,Ziggy Palffy,10,33,17,LW,1994
37643,44,23,Ziggy Palffy,43,81,87,RW,1995
37644,42,24,Ziggy Palffy,48,80,90,RW,1996
37645,42,25,Ziggy Palffy,45,82,87,RW,1997
37646,28,26,Ziggy Palffy,22,50,50,RW,1998
37647,39,27,Ziggy Palffy,27,64,66,RW,1999
37648,51,28,Ziggy Palffy,38,73,89,RW,2000
37649,27,29,Ziggy Palffy,32,63,59,RW,2001
37650,48,30,Ziggy Palffy,37,76,85,RW,2002
37651,25,31,Ziggy Palffy,16,35,41,RW,2003
37652,31,33,Ziggy Palffy,11,42,42,RW,2005