,A,Age,Full_Name,G,GP,PTS,Pos,Season,Team
29,0,25.0,Aaron Gagnon,0,7,0,C,2011-12,WPG
30,0,26.0,Aaron Gagnon,3,10,3,C,2012-13,WPG
122,0,22.0,Adam Almqvist,1,2,1,D,2013-14,DET
248,12,21.0,Adam Lowry,11,80,23,LW,2014-15,WPG
249,10,22.0,Adam Lowry,7,74,17,C,2015-16,WPG
250,14,23.0,Adam Lowry,15,82,29,C,2016-17,WPG
251,13,24.0,Adam Lowry,8,45,21,C,2017-18,WPG
296,6,29.0,Adam Pardy,0,60,6,D,2013-14,WPG
297,9,30.0,Adam Pardy,0,55,9,D,2014-15,WPG
802,15,20.0,Alexander Burmistrov,13,76,28,C,2011-12,WPG
803,6,21.0,Alexander Burmistrov,4,44,10,C,2012-13,WPG
804,14,24.0,Alexander Burmistrov,7,81,21,C,2015-16,WPG
805,2,25.0,Alexander Burmistrov,0,23,2,C,2016-17,WPG
1065,0,22.0,Alexey Marchenko,0,1,0,D,2013-14,DET
1066,1,23.0,Alexey Marchenko,1,13,2,D,2014-15,DET
1067,9,24.0,Alexey Marchenko,2,66,11,D,2015-16,DET
1291,5,21.0,Andreas Athanasiou,9,37,14,C,2015-16,DET
1292,11,22.0,Andreas Athanasiou,18,64,29,C,2016-17,DET
1293,17,23.0,Andreas Athanasiou,16,71,33,LW,2017-18,DET
1329,1,34.0,Andreas Lilja,1,20,2,D,2009-10,DET
1525,1,20.0,Andrew Copp,0,1,1,C,2014-15,WPG
1526,6,21.0,Andrew Copp,7,77,13,C,2015-16,WPG
1527,8,22.0,Andrew Copp,9,64,17,C,2016-17,WPG
1528,19,23.0,Andrew Copp,9,82,28,C,2017-18,WPG
1578,22,26.0,Andrew Ladd,28,82,50,LW,2011-12,WPG
1579,28,27.0,Andrew Ladd,18,48,46,LW,2012-13,WPG
1580,31,28.0,Andrew Ladd,23,78,54,LW,2013-14,WPG
1581,38,29.0,Andrew Ladd,24,81,62,LW,2014-15,WPG
1752,1,21.0,Anthony Mantha,2,10,3,RW,2015-16,DET
1753,19,22.0,Anthony Mantha,17,60,36,RW,2016-17,DET
1754,24,23.0,Anthony Mantha,24,80,48,RW,2017-18,DET
1755,2,23.0,Anthony Peluso,0,5,2,RW,2012-13,WPG
1756,3,24.0,Anthony Peluso,2,53,5,RW,2013-14,WPG
1757,1,25.0,Anthony Peluso,1,49,2,RW,2014-15,WPG
1758,4,26.0,Anthony Peluso,1,35,5,RW,2015-16,WPG
1860,8,31.0,Antti Miettinen,5,45,13,RW,2011-12,WPG
1861,2,32.0,Antti Miettinen,3,22,5,RW,2012-13,WPG
1942,0,23.0,Arturs Kulda,0,9,0,D,2011-12,WPG
2152,0,22.0,Ben Chiarot,0,1,0,D,2013-14,WPG
2153,6,23.0,Ben Chiarot,2,40,8,D,2014-15,WPG
2154,9,24.0,Ben Chiarot,1,70,10,D,2015-16,WPG
2155,10,25.0,Ben Chiarot,2,59,12,D,2016-17,WPG
2156,12,26.0,Ben Chiarot,2,57,14,D,2017-18,WPG
2225,1,29.0,Ben Street,0,6,1,C,2016-17,DET
2872,47,25.0,Blake Wheeler,17,80,64,RW,2011-12,WPG
2873,22,26.0,Blake Wheeler,19,48,41,RW,2012-13,WPG
2874,41,27.0,Blake Wheeler,28,82,69,RW,2013-14,WPG
2875,35,28.0,Blake Wheeler,26,79,61,RW,2014-15,WPG
2876,52,29.0,Blake Wheeler,26,82,78,RW,2015-16,WPG
2877,48,30.0,Blake Wheeler,26,82,74,RW,2016-17,WPG
2878,68,31.0,Blake Wheeler,23,81,91,RW,2017-18,WPG
3879,1,38.0,Brad May,0,40,1,LW,2009-10,DET
3952,18,35.0,Brad Richards,10,68,28,C,2015-16,DET
4019,16,30.0,Brad Stuart,4,82,20,D,2009-10,DET
4020,17,31.0,Brad Stuart,3,67,20,D,2010-11,DET
4021,15,32.0,Brad Stuart,6,81,21,D,2011-12,DET
4154,0,24.0,Brandon Tanev,0,3,0,LW,2015-16,WPG
4155,2,25.0,Brandon Tanev,2,51,4,LW,2016-17,WPG
4156,10,26.0,Brandon Tanev,8,61,18,LW,2017-18,WPG
4232,0,21.0,Brendan Lemieux,1,9,1,LW,2017-18,WPG
4277,6,22.0,Brendan Smith,1,14,7,D,2011-12,DET
4278,8,23.0,Brendan Smith,0,34,8,D,2012-13,DET
4279,14,24.0,Brendan Smith,5,71,19,D,2013-14,DET
4280,9,25.0,Brendan Smith,4,76,13,D,2014-15,DET
4281,12,26.0,Brendan Smith,3,63,15,D,2015-16,DET
4538,0,25.0,Brett Festerling,0,5,0,D,2011-12,WPG
4574,7,28.0,Brett Lebda,1,63,8,D,2009-10,DET
4585,2,23.0,Brett Maclean,0,5,2,LW,2011-12,WPG
4798,4,22.0,Brian Lashoff,1,31,5,D,2012-13,DET
4799,5,23.0,Brian Lashoff,1,75,6,D,2013-14,DET
4800,2,24.0,Brian Lashoff,0,11,2,D,2014-15,DET
4801,0,26.0,Brian Lashoff,0,5,0,D,2016-17,DET
4802,0,27.0,Brian Lashoff,0,1,0,D,2017-18,DET
4954,34,36.0,Brian Rafalski,8,78,42,D,2009-10,DET
4955,44,37.0,Brian Rafalski,4,63,48,D,2010-11,DET
5021,2,29.0,Brian Strait,0,5,2,D,2016-17,WPG
5298,22,24.0,Bryan Little,24,74,46,C,2011-12,WPG
5299,25,25.0,Bryan Little,7,48,32,C,2012-13,WPG
5300,41,26.0,Bryan Little,23,82,64,RW,2013-14,WPG
5301,28,27.0,Bryan Little,24,70,52,C,2014-15,WPG
5302,25,28.0,Bryan Little,17,57,42,C,2015-16,WPG
5303,26,29.0,Bryan Little,21,59,47,C,2016-17,WPG
5304,27,30.0,Bryan Little,16,82,43,C,2017-18,WPG
5693,0,21.0,Carl Klingberg,0,6,0,LW,2011-12,WPG
5694,0,23.0,Carl Klingberg,1,3,1,LW,2013-14,WPG
5695,0,24.0,Carl Klingberg,0,2,0,LW,2014-15,WPG
5718,1,30.0,Carlo Colaiacovo,0,6,1,D,2012-13,DET
5880,0,20.0,Chase De Leo,0,2,0,C,2015-16,WPG
5974,2,28.0,Chris Conner,1,8,3,RW,2011-12,DET
6373,7,28.0,Chris Thorburn,4,72,11,C,2011-12,WPG
6374,2,29.0,Chris Thorburn,2,42,4,C,2012-13,WPG
6375,9,30.0,Chris Thorburn,2,55,11,RW,2013-14,WPG
6376,7,31.0,Chris Thorburn,7,81,14,RW,2014-15,WPG
6377,6,32.0,Chris Thorburn,6,82,12,RW,2015-16,WPG
6378,1,33.0,Chris Thorburn,3,64,4,RW,2016-17,WPG
7019,0,22.0,Cory Emmerton,1,2,1,C,2010-11,DET
7020,4,23.0,Cory Emmerton,6,71,10,C,2011-12,DET
7021,3,24.0,Cory Emmerton,5,48,8,C,2012-13,DET
7022,2,25.0,Cory Emmerton,0,18,2,C,2013-14,DET
7642,14,26.0,Damien Brunner,12,44,26,C,2012-13,DET
7697,19,31.0,Dan Cleary,15,64,34,LW,2009-10,DET
7698,20,32.0,Dan Cleary,26,68,46,LW,2010-11,DET
7699,21,33.0,Dan Cleary,12,75,33,LW,2011-12,DET
7700,6,34.0,Dan Cleary,9,48,15,LW,2012-13,DET
7701,4,35.0,Dan Cleary,4,52,8,RW,2013-14,DET
7867,0,22.0,Dan Renouf,0,1,0,D,2016-17,DET
7936,31,41.0,Daniel Alfredsson,18,68,49,RW,2013-14,DET
7970,1,36.0,Daniel Cleary,1,17,2,RW,2014-15,DET
8069,1,22.0,Danny DeKeyser,0,11,1,D,2012-13,DET
8070,19,23.0,Danny DeKeyser,4,65,23,D,2013-14,DET
8071,29,24.0,Danny DeKeyser,2,80,31,D,2014-15,DET
8072,12,25.0,Danny DeKeyser,8,78,20,D,2015-16,DET
8073,8,26.0,Danny DeKeyser,4,82,12,D,2016-17,DET
8074,6,27.0,Danny DeKeyser,6,65,12,D,2017-18,DET
8275,13,23.0,Darren Helm,11,75,24,C,2009-10,DET
8276,20,24.0,Darren Helm,12,82,32,C,2010-11,DET
8277,17,25.0,Darren Helm,9,68,26,C,2011-12,DET
8278,0,26.0,Darren Helm,0,1,0,C,2012-13,DET
8279,8,27.0,Darren Helm,12,42,20,C,2013-14,DET
8280,18,28.0,Darren Helm,15,75,33,C,2014-15,DET
8281,13,29.0,Darren Helm,13,77,26,C,2015-16,DET
8282,9,30.0,Darren Helm,8,50,17,C,2016-17,DET
8283,18,31.0,Darren Helm,13,75,31,LW,2017-18,DET
9104,1,33.0,David Booth,4,28,5,LW,2017-18,DET
9884,4,25.0,Derek Meech,2,49,6,D,2009-10,DET
9885,0,27.0,Derek Meech,0,2,0,D,2011-12,WPG
9886,1,28.0,Derek Meech,0,16,1,D,2012-13,WPG
10032,16,27.0,Devin Setoguchi,11,75,27,RW,2013-14,WPG
10210,8,27.0,Dmitry Kulikov,3,62,11,D,2017-18,WPG
10261,0,21.0,Dominic Turgeon,0,5,0,C,2017-18,DET
10666,2,29.0,Doug Janik,0,13,2,D,2009-10,DET
10667,0,30.0,Doug Janik,0,7,0,D,2010-11,DET
10668,1,31.0,Doug Janik,0,9,1,D,2011-12,DET
10937,8,26.0,Drew Miller,10,67,18,LW,2010-11,DET
10938,11,27.0,Drew Miller,14,80,25,LW,2011-12,DET
10939,4,28.0,Drew Miller,4,44,8,LW,2012-13,DET
10940,8,29.0,Drew Miller,7,82,15,LW,2013-14,DET
10941,8,30.0,Drew Miller,5,82,13,LW,2014-15,DET
10942,1,31.0,Drew Miller,1,28,2,LW,2015-16,DET
10943,2,32.0,Drew Miller,5,55,7,LW,2016-17,DET
10957,25,29.0,Drew Stafford,18,76,43,RW,2014-15,WPG
10958,17,30.0,Drew Stafford,21,78,38,RW,2015-16,WPG
11040,41,26.0,Dustin Byfuglien,12,66,53,D,2011-12,WPG
11041,20,27.0,Dustin Byfuglien,8,43,28,D,2012-13,WPG
11042,36,28.0,Dustin Byfuglien,20,78,56,D,2013-14,WPG
11043,27,29.0,Dustin Byfuglien,18,69,45,D,2014-15,WPG
11044,34,30.0,Dustin Byfuglien,19,81,53,D,2015-16,WPG
11045,39,31.0,Dustin Byfuglien,13,80,52,D,2016-17,WPG
11046,37,32.0,Dustin Byfuglien,8,69,45,D,2017-18,WPG
11118,22,19.0,Dylan Larkin,23,80,45,C,2015-16,DET
11119,15,20.0,Dylan Larkin,17,80,32,C,2016-17,DET
11120,47,21.0,Dylan Larkin,16,82,63,C,2017-18,DET
11448,1,26.0,Eric Fehr,2,35,3,RW,2011-12,WPG
11543,4,23.0,Eric O'Dell,3,30,7,C,2013-14,WPG
11544,1,24.0,Eric O'Dell,0,11,1,C,2014-15,WPG
11570,3,24.0,Eric Tangradi,3,55,6,LW,2013-14,WPG
11572,0,26.0,Eric Tangradi,0,1,0,LW,2015-16,DET
11625,18,36.0,Erik Cole,21,68,39,LW,2014-15,DET
11758,27,20.0,Evander Kane,30,74,57,C,2011-12,WPG
11759,16,21.0,Evander Kane,17,48,33,C,2012-13,WPG
11760,22,22.0,Evander Kane,19,63,41,LW,2013-14,WPG
11761,12,23.0,Evander Kane,10,37,22,LW,2014-15,WPG
11804,0,20.0,Evgeny Svechnikov,0,2,0,RW,2016-17,DET
11805,2,21.0,Evgeny Svechnikov,2,14,4,RW,2017-18,DET
11808,1,26.0,Fabian Brunnstrom,0,5,1,LW,2011-12,DET
12043,24,32.0,Frans Nielsen,17,79,41,C,2016-17,DET
12044,17,33.0,Frans Nielsen,16,79,33,C,2017-18,DET
13299,12,27.0,Grant Clitsome,4,44,16,D,2012-13,WPG
13300,10,28.0,Grant Clitsome,2,32,12,D,2013-14,WPG
13301,4,29.0,Grant Clitsome,0,24,4,D,2014-15,WPG
13669,6,22.0,Gustav Nyquist,1,18,7,LW,2011-12,DET
13670,3,23.0,Gustav Nyquist,3,22,6,LW,2012-13,DET
13671,20,24.0,Gustav Nyquist,28,57,48,RW,2013-14,DET
13672,27,25.0,Gustav Nyquist,27,82,54,RW/C,2014-15,DET
13673,26,26.0,Gustav Nyquist,17,82,43,RW,2015-16,DET
13674,36,27.0,Gustav Nyquist,12,76,48,RW,2016-17,DET
13675,19,28.0,Gustav Nyquist,21,82,40,RW,2017-18,DET
13944,47,29.0,Henrik Zetterberg,23,74,70,LW,2009-10,DET
13945,56,30.0,Henrik Zetterberg,24,80,80,LW,2010-11,DET
13946,47,31.0,Henrik Zetterberg,22,82,69,LW,2011-12,DET
13947,37,32.0,Henrik Zetterberg,11,46,48,LW,2012-13,DET
13948,32,33.0,Henrik Zetterberg,16,45,48,LW,2013-14,DET
13949,49,34.0,Henrik Zetterberg,17,77,66,LW/C,2014-15,DET
13950,37,35.0,Henrik Zetterberg,13,82,50,LW,2015-16,DET
13951,51,36.0,Henrik Zetterberg,17,82,68,LW,2016-17,DET
13952,45,37.0,Henrik Zetterberg,11,82,56,LW,2017-18,DET
14101,25,27.0,Ian White,7,77,32,D,2011-12,DET
14102,2,28.0,Ian White,2,25,4,D,2012-13,DET
14248,1,22.0,J.C. Lipon,0,9,1,RW,2015-16,WPG
14430,0,20.0,Jack Roslovic,0,1,0,C,2016-17,WPG
14431,9,21.0,Jack Roslovic,5,31,14,C,2017-18,WPG
14461,19,19.0,Jacob Trouba,10,65,29,D,2013-14,WPG
14462,15,20.0,Jacob Trouba,7,65,22,D,2014-15,WPG
14463,15,21.0,Jacob Trouba,6,81,21,D,2015-16,WPG
14464,25,22.0,Jacob Trouba,8,60,33,D,2016-17,WPG
14465,21,23.0,Jacob Trouba,3,55,24,D,2017-18,WPG
14570,0,22.0,Jakub Kindl,0,3,0,D,2009-10,DET
14571,2,23.0,Jakub Kindl,2,48,4,D,2010-11,DET
14572,12,24.0,Jakub Kindl,1,55,13,D,2011-12,DET
14573,9,25.0,Jakub Kindl,4,41,13,D,2012-13,DET
14574,17,26.0,Jakub Kindl,2,66,19,D,2013-14,DET
14575,8,27.0,Jakub Kindl,5,35,13,D,2014-15,DET
14675,3,22.0,James Wright,2,38,5,C,2012-13,WPG
14676,2,23.0,James Wright,0,59,2,C,2013-14,WPG
14907,0,23.0,Jan Mursak,1,19,1,LW,2010-11,DET
14908,2,24.0,Jan Mursak,1,25,3,LW,2011-12,DET
14909,0,25.0,Jan Mursak,0,2,0,LW,2012-13,DET
15304,1,30.0,Jason Jaffray,0,13,1,RW,2011-12,WPG
15443,9,29.0,Jason Williams,6,44,15,C,2009-10,DET
15538,6,32.0,Jay Harrison,3,55,9,D,2014-15,WPG
16710,8,29.0,Jim Slater,13,78,21,C,2011-12,WPG
16711,1,30.0,Jim Slater,1,26,2,C,2012-13,WPG
16712,1,31.0,Jim Slater,1,27,2,C,2013-14,WPG
16713,8,32.0,Jim Slater,5,82,13,C,2014-15,WPG
16875,27,27.0,Jiri Hudler,10,73,37,C,2010-11,DET
16876,25,28.0,Jiri Hudler,25,81,50,C,2011-12,DET
16911,17,26.0,Jiri Tlusty,14,72,31,C/LW,2014-15,WPG
16913,0,22.0,Joakim Andersson,0,5,0,C,2011-12,DET
16914,5,23.0,Joakim Andersson,3,38,8,C,2012-13,DET
16915,9,24.0,Joakim Andersson,8,65,17,C,2013-14,DET
16916,5,25.0,Joakim Andersson,3,68,8,C,2014-15,DET
16917,2,26.0,Joakim Andersson,1,29,3,C,2015-16,DET
17067,3,21.0,Joe Hicketts,0,5,3,D,2017-18,DET
17307,6,22.0,Joel Armia,4,43,10,RW,2015-16,WPG
17308,9,23.0,Joel Armia,10,57,19,RW,2016-17,WPG
17309,17,24.0,Joel Armia,12,79,29,RW,2017-18,WPG
17431,11,30.0,Johan Franzen,10,27,21,C,2009-10,DET
17432,27,31.0,Johan Franzen,28,76,55,C,2010-11,DET
17433,27,32.0,Johan Franzen,29,77,56,C,2011-12,DET
17434,17,33.0,Johan Franzen,14,41,31,C,2012-13,DET
17435,25,34.0,Johan Franzen,16,54,41,RW,2013-14,DET
17436,15,35.0,Johan Franzen,7,33,22,RW/C,2014-15,DET
17437,1,36.0,Johan Franzen,0,2,1,RW,2015-16,DET
17470,0,25.0,John Albert,1,9,1,C,2013-14,WPG
18113,9,25.0,Jonathan Ericsson,4,62,13,D,2009-10,DET
18114,12,26.0,Jonathan Ericsson,3,74,15,D,2010-11,DET
18115,10,27.0,Jonathan Ericsson,1,69,11,D,2011-12,DET
18116,10,28.0,Jonathan Ericsson,3,45,13,D,2012-13,DET
18117,10,29.0,Jonathan Ericsson,1,48,11,D,2013-14,DET
18118,12,30.0,Jonathan Ericsson,3,82,15,D,2014-15,DET
18119,12,31.0,Jonathan Ericsson,3,71,15,D,2015-16,DET
18120,8,32.0,Jonathan Ericsson,1,51,9,D,2016-17,DET
18121,10,33.0,Jonathan Ericsson,3,81,13,D,2017-18,DET
18269,5,29.0,Jordin Tootoo,3,42,8,RW,2012-13,DET
18270,1,30.0,Jordin Tootoo,0,11,1,RW,2013-14,DET
18337,4,25.0,Joseph Morrow,1,18,5,D,2017-18,WPG
18411,0,20.0,Josh Morrissey,0,1,0,D,2015-16,WPG
18412,14,21.0,Josh Morrissey,6,82,20,D,2016-17,WPG
18413,19,22.0,Josh Morrissey,7,81,26,D,2017-18,WPG
18480,0,22.0,Julian Melchiori,0,1,0,D,2013-14,WPG
18481,0,24.0,Julian Melchiori,0,11,0,D,2015-16,WPG
18482,2,25.0,Julian Melchiori,0,18,2,D,2016-17,WPG
18484,0,28.0,Julien Brouillette,0,1,0,D,2014-15,WPG
18513,3,22.0,Justin Abdelkader,3,50,6,LW,2009-10,DET
18514,12,23.0,Justin Abdelkader,7,74,19,LW,2010-11,DET
18515,14,24.0,Justin Abdelkader,8,81,22,LW,2011-12,DET
18516,3,25.0,Justin Abdelkader,10,48,13,LW,2012-13,DET
18517,18,26.0,Justin Abdelkader,10,70,28,LW,2013-14,DET
18518,21,27.0,Justin Abdelkader,23,71,44,LW,2014-15,DET
18519,23,28.0,Justin Abdelkader,19,82,42,LW,2015-16,DET
18520,14,29.0,Justin Abdelkader,7,64,21,LW,2016-17,DET
18521,22,30.0,Justin Abdelkader,13,75,35,LW,2017-18,DET
18702,4,25.0,Keaton Ellerby,2,51,6,D,2013-14,WPG
18703,1,26.0,Keaton Ellerby,0,1,1,D,2014-15,WPG
19157,0,25.0,Kenndal McArdle,0,9,0,LW,2011-12,WPG
19636,2,37.0,Kirk Maltby,4,52,6,LW,2009-10,DET
19720,15,38.0,Kris Draper,7,81,22,C,2009-10,DET
19721,5,39.0,Kris Draper,6,47,11,C,2010-11,DET
19757,0,27.0,Kris Newbury,1,4,1,C,2009-10,DET
19889,3,20.0,Kyle Connor,2,20,5,LW,2016-17,WPG
19890,26,21.0,Kyle Connor,31,76,57,LW,2017-18,WPG
19940,2,27.0,Kyle Quincey,1,36,3,D,2012-13,DET
19941,9,28.0,Kyle Quincey,4,82,13,D,2013-14,DET
19942,15,29.0,Kyle Quincey,3,73,18,D,2014-15,DET
19943,7,30.0,Kyle Quincey,4,47,11,D,2015-16,DET
19974,29,28.0,Kyle Wellwood,18,77,47,C,2011-12,WPG
19975,9,29.0,Kyle Wellwood,6,39,15,C,2012-13,WPG
20031,0,22.0,Landon Ferraro,0,4,0,C,2013-14,DET
20032,0,23.0,Landon Ferraro,1,3,1,C,2014-15,DET
20432,13,31.0,Lee Stempniak,15,71,28,RW,2014-15,WPG
20776,6,24.0,Luke Glendening,1,56,7,C,2013-14,DET
20777,6,25.0,Luke Glendening,12,82,18,C,2014-15,DET
20778,13,26.0,Luke Glendening,8,81,21,C,2015-16,DET
20779,11,27.0,Luke Glendening,3,74,14,C,2016-17,DET
20780,8,28.0,Luke Glendening,11,69,19,RW,2017-18,DET
20817,3,27.0,Luke Witkowski,1,31,4,RW,2017-18,DET
21227,27,37.0,Marek Zidlicky,7,84,34,D,2014-15,DET
21425,4,27.0,Mark Flood,3,33,7,D,2011-12,WPG
21762,0,18.0,Mark Scheifele,1,7,1,C,2011-12,WPG
21763,0,19.0,Mark Scheifele,0,4,0,C,2012-13,WPG
21764,21,20.0,Mark Scheifele,13,63,34,C,2013-14,WPG
21765,34,21.0,Mark Scheifele,15,82,49,C,2014-15,WPG
21766,32,22.0,Mark Scheifele,29,71,61,C,2015-16,WPG
21767,50,23.0,Mark Scheifele,32,79,82,C,2016-17,WPG
21768,37,24.0,Mark Scheifele,23,60,60,C,2017-18,WPG
21800,11,27.0,Mark Stuart,3,80,14,D,2011-12,WPG
21801,2,28.0,Mark Stuart,2,42,4,D,2012-13,WPG
21802,11,29.0,Mark Stuart,2,69,13,D,2013-14,WPG
21803,12,30.0,Mark Stuart,2,70,14,D,2014-15,WPG
21804,2,31.0,Mark Stuart,1,64,3,D,2015-16,WPG
21805,2,32.0,Mark Stuart,2,42,4,D,2016-17,WPG
21839,7,22.0,Marko Dano,4,38,11,C,2016-17,WPG
21840,1,23.0,Marko Dano,2,23,3,C,2017-18,WPG
21901,14,24.0,Martin Frk,11,68,25,RW,2017-18,DET
22183,23,27.0,Mathieu Perreault,18,62,41,C,2014-15,WPG
22184,32,28.0,Mathieu Perreault,9,71,41,C,2015-16,WPG
22185,32,29.0,Mathieu Perreault,13,65,45,C,2016-17,WPG
22186,22,30.0,Mathieu Perreault,17,70,39,C,2017-18,WPG
22440,5,25.0,Matt Halischuk,5,46,10,RW,2013-14,WPG
22441,5,26.0,Matt Halischuk,3,47,8,RW,2014-15,WPG
22442,3,27.0,Matt Halischuk,0,30,3,RW,2015-16,WPG
22454,8,36.0,Matt Hendricks,5,60,13,LW,2017-18,WPG
22645,1,26.0,Matthew Lorito,0,2,1,LW,2016-17,DET
22702,0,22.0,Mattias Ritola,0,5,0,C,2009-10,DET
22859,27,25.0,Michael Frolik,15,81,42,RW,2013-14,WPG
22860,23,26.0,Michael Frolik,19,82,42,RW,2014-15,WPG
23234,1,36.0,Mikael Samuelsson,0,4,1,RW,2012-13,DET
23235,2,37.0,Mikael Samuelsson,1,26,3,RW,2013-14,DET
23448,28,30.0,Mike Green,7,74,35,D,2015-16,DET
23599,22,31.0,Mike Green,14,72,36,D,2016-17,DET
23600,25,32.0,Mike Green,8,66,33,D,2017-18,DET
23908,11,40.0,Mike Modano,4,40,15,C,2010-11,DET
24462,0,22.0,Mitch Callahan,0,1,0,RW,2013-14,DET
24463,0,25.0,Mitch Callahan,0,4,0,RW,2016-17,DET
24820,0,20.0,Nelson Nogier,0,10,0,D,2016-17,WPG
24839,4,20.0,Nic Petan,2,26,6,LW,2015-16,WPG
24840,12,21.0,Nic Petan,1,54,13,LW,2016-17,WPG
24841,0,22.0,Nic Petan,2,15,2,LW,2017-18,WPG
24930,9,26.0,Nick Jensen,4,49,13,D,2016-17,DET
24931,15,27.0,Nick Jensen,0,81,15,D,2017-18,DET
25060,40,39.0,Nicklas Lidstrom,9,82,49,D,2009-10,DET
25061,46,40.0,Nicklas Lidstrom,16,82,62,D,2010-11,DET
25062,23,41.0,Nicklas Lidstrom,11,70,34,D,2011-12,DET
25116,20,31.0,Nik Antropov,15,69,35,C,2011-12,WPG
25117,12,32.0,Nik Antropov,6,40,18,C,2012-13,WPG
25185,15,29.0,Niklas Kronwall,7,48,22,D,2009-10,DET
25186,26,30.0,Niklas Kronwall,11,77,37,D,2010-11,DET
25187,21,31.0,Niklas Kronwall,15,82,36,D,2011-12,DET
25188,24,32.0,Niklas Kronwall,5,48,29,D,2012-13,DET
25189,41,33.0,Niklas Kronwall,8,79,49,D,2013-14,DET
25190,35,34.0,Niklas Kronwall,9,80,44,D,2014-15,DET
25191,23,35.0,Niklas Kronwall,3,64,26,D,2015-16,DET
25192,11,36.0,Niklas Kronwall,2,57,13,D,2016-17,DET
25193,23,37.0,Niklas Kronwall,4,79,27,D,2017-18,DET
25236,23,19.0,Nikolaj Ehlers,15,72,38,RW,2015-16,WPG
25237,39,20.0,Nikolaj Ehlers,25,82,64,LW,2016-17,WPG
25238,31,21.0,Nikolaj Ehlers,29,82,60,LW,2017-18,WPG
25493,7,34.0,Olli Jokinen,7,45,14,C,2012-13,WPG
25494,25,35.0,Olli Jokinen,18,82,43,C,2013-14,WPG
25882,0,21.0,Patrice Cormier,0,9,0,C,2011-12,WPG
25883,0,22.0,Patrice Cormier,0,10,0,C,2012-13,WPG
25884,3,23.0,Patrice Cormier,0,9,3,C,2013-14,WPG
25885,0,24.0,Patrice Cormier,0,1,0,C,2014-15,WPG
25886,0,25.0,Patrice Cormier,0,2,0,C,2015-16,WPG
25922,10,25.0,Patrick Eaves,12,65,22,RW,2009-10,DET
25923,7,26.0,Patrick Eaves,13,63,20,RW,2010-11,DET
25924,1,27.0,Patrick Eaves,0,10,1,RW,2011-12,DET
25925,6,28.0,Patrick Eaves,2,34,8,RW,2012-13,DET
26082,28,18.0,Patrik Laine,36,73,64,RW,2016-17,WPG
26083,26,19.0,Patrik Laine,44,82,70,RW,2017-18,WPG
26444,0,22.0,Paul Postma,0,3,0,D,2011-12,WPG
26445,5,23.0,Paul Postma,4,34,9,D,2012-13,WPG
26446,2,24.0,Paul Postma,1,20,3,D,2013-14,WPG
26447,4,25.0,Paul Postma,2,42,6,D,2014-15,WPG
26448,0,26.0,Paul Postma,2,26,2,D,2015-16,WPG
26449,13,27.0,Paul Postma,1,65,14,D,2016-17,WPG
26514,9,32.0,Paul Stastny,4,19,13,C,2017-18,WPG
26583,43,31.0,Pavel Datsyuk,27,80,70,C,2009-10,DET
26584,36,32.0,Pavel Datsyuk,23,56,59,C,2010-11,DET
26585,48,33.0,Pavel Datsyuk,19,70,67,C,2011-12,DET
26586,34,34.0,Pavel Datsyuk,15,47,49,C,2012-13,DET
26587,20,35.0,Pavel Datsyuk,17,45,37,C,2013-14,DET
26588,39,36.0,Pavel Datsyuk,26,63,65,C,2014-15,DET
26589,33,37.0,Pavel Datsyuk,16,66,49,C,2015-16,DET
27494,0,25.0,Quinton Howden,0,5,0,C,2016-17,WPG
27778,1,30.0,Randy Jones,1,39,2,D,2011-12,WPG
28880,0,20.0,Riley Sheahan,0,1,0,C,2011-12,DET
28881,0,21.0,Riley Sheahan,0,1,0,C,2012-13,DET
28882,15,22.0,Riley Sheahan,9,42,24,C,2013-14,DET
28883,23,23.0,Riley Sheahan,13,79,36,C,2014-15,DET
28884,11,24.0,Riley Sheahan,14,81,25,C,2015-16,DET
28885,11,25.0,Riley Sheahan,2,80,13,C,2016-17,DET
28886,0,26.0,Riley Sheahan,0,8,0,C,2017-18,DET
29148,0,23.0,Robbie Russo,0,19,0,D,2016-17,DET
29642,10,30.0,Ron Hainsey,0,56,10,D,2011-12,WPG
29643,13,31.0,Ron Hainsey,0,47,13,D,2012-13,WPG
29945,8,36.0,Ruslan Salei,2,75,10,D,2010-11,DET
30245,0,21.0,Ryan Sproul,0,1,0,D,2013-14,DET
30246,6,24.0,Ryan Sproul,1,27,7,D,2016-17,DET
30404,0,21.0,Sami Niku,1,1,1,D,2017-18,WPG
30597,3,22.0,Scott Kosmachuk,0,8,3,RW,2015-16,WPG
31395,4,28.0,Shawn Matthias,8,45,12,LW,2016-17,WPG
31396,2,29.0,Shawn Matthias,1,27,3,LW,2017-18,WPG
31615,7,23.0,Spencer Machacek,2,13,9,RW,2011-12,WPG
31878,2,30.0,Stephen Weiss,2,26,4,C,2013-14,DET
31879,16,31.0,Stephen Weiss,9,52,25,C,2014-15,DET
32706,0,26.0,TJ Galiardi,1,38,1,LW,2014-15,WPG
32713,11,28.0,Tanner Glass,5,78,16,LW,2011-12,WPG
32873,0,22.0,Teemu Pulkkinen,0,3,0,RW,2013-14,DET
32874,3,23.0,Teemu Pulkkinen,5,31,8,LW,2014-15,DET
32875,6,24.0,Teemu Pulkkinen,6,36,12,LW,2015-16,DET
33318,16,29.0,Tim Stapleton,11,63,27,C,2011-12,WPG
33404,27,27.0,Toby Enstrom,6,62,33,D,2011-12,WPG
33405,11,28.0,Toby Enstrom,4,22,15,D,2012-13,WPG
33406,20,29.0,Toby Enstrom,10,82,30,D,2013-14,WPG
33407,19,30.0,Toby Enstrom,4,60,23,D,2014-15,WPG
33408,14,31.0,Toby Enstrom,2,72,16,D,2015-16,WPG
33409,13,32.0,Toby Enstrom,1,60,14,D,2016-17,WPG
33410,5,33.0,Toby Enstrom,1,43,6,D,2017-18,WPG
33434,26,34.0,Todd Bertuzzi,18,82,44,RW,2009-10,DET
33435,29,35.0,Todd Bertuzzi,16,81,45,RW,2010-11,DET
33436,24,36.0,Todd Bertuzzi,14,71,38,RW,2011-12,DET
33437,1,37.0,Todd Bertuzzi,2,7,3,RW,2012-13,DET
33438,7,38.0,Todd Bertuzzi,9,59,16,RW,2013-14,DET
33887,20,37.0,Tomas Holmstrom,25,68,45,LW,2009-10,DET
33888,19,38.0,Tomas Holmstrom,18,73,37,LW,2010-11,DET
33889,13,39.0,Tomas Holmstrom,11,74,24,LW,2011-12,DET
33900,7,21.0,Tomas Jurco,8,36,15,RW,2013-14,DET
33901,15,22.0,Tomas Jurco,3,63,18,RW,2014-15,DET
33902,2,23.0,Tomas Jurco,4,44,6,RW,2015-16,DET
33948,0,23.0,Tomas Nosek,0,6,0,C,2015-16,DET
33949,0,24.0,Tomas Nosek,1,11,1,LW,2016-17,DET
33987,0,20.0,Tomas Tatar,1,9,1,C,2010-11,DET
33988,3,22.0,Tomas Tatar,4,18,7,C,2012-13,DET
33989,20,23.0,Tomas Tatar,19,73,39,LW,2013-14,DET
33990,27,24.0,Tomas Tatar,29,82,56,LW/C,2014-15,DET
33991,24,25.0,Tomas Tatar,21,81,45,LW,2015-16,DET
33992,21,26.0,Tomas Tatar,25,82,46,LW,2016-17,DET
34345,7,34.0,Trevor Daley,9,77,16,D,2017-18,DET
34475,1,24.0,Tucker Poolman,1,24,2,D,2017-18,WPG
34528,0,21.0,Tyler Bertuzzi,0,7,0,LW,2016-17,DET
34529,17,22.0,Tyler Bertuzzi,7,48,24,LW,2017-18,DET
34586,21,24.0,Tyler Myers,7,71,28,D,2014-15,WPG
34587,18,25.0,Tyler Myers,9,73,27,D,2015-16,WPG
34588,3,26.0,Tyler Myers,2,11,5,D,2016-17,WPG
34589,30,27.0,Tyler Myers,6,82,36,D,2017-18,WPG
34782,24,25.0,Valtteri Filppula,11,55,35,C,2009-10,DET
34783,23,26.0,Valtteri Filppula,16,71,39,C,2010-11,DET
34784,43,27.0,Valtteri Filppula,23,81,66,C,2011-12,DET
34785,8,28.0,Valtteri Filppula,9,41,17,C,2012-13,DET
35541,0,20.0,Xavier Ouellet,0,4,0,D,2013-14,DET
35542,1,21.0,Xavier Ouellet,2,21,3,D,2014-15,DET
35543,1,22.0,Xavier Ouellet,0,5,1,D,2015-16,DET
35544,9,23.0,Xavier Ouellet,3,66,12,D,2016-17,DET
35545,7,24.0,Xavier Ouellet,0,45,7,D,2017-18,DET
35709,25,21.0,Zach Bogosian,5,65,30,D,2011-12,WPG
35710,9,22.0,Zach Bogosian,5,33,14,D,2012-13,WPG
35711,8,23.0,Zach Bogosian,3,55,11,D,2013-14,WPG
35742,3,24.0,Zach Redmond,1,8,4,D,2012-13,WPG
35743,2,25.0,Zach Redmond,1,10,3,D,2013-14,WPG
